,ZCTA5,urban_rural-population-total_population,urban_rural-population-urban_total_population,urban_rural-population-rural_total_population,urban_rural-percent-urban_population-of-total_population,urban_rural-percent-rural_population-of-total_population
0,601,18570,10679,7891,0.575,0.425
1,602,41520,41520,0,1.0,0.0
2,603,54689,54646,43,0.999,0.001
3,606,6615,2697,3918,0.408,0.592
4,610,29016,25640,3376,0.884,0.116
5,612,67010,62391,4619,0.931,0.069
6,616,11017,10438,579,0.947,0.053
7,617,24597,24161,436,0.982,0.018
8,622,7853,6171,1682,0.786,0.214
9,623,43061,42435,626,0.985,0.015
10,624,26241,22198,4043,0.846,0.154
11,627,35159,30415,4744,0.865,0.135
12,631,1852,0,1852,0.0,1.0
13,637,25287,23163,2124,0.916,0.084
14,638,18941,11839,7102,0.625,0.375
15,641,31191,17647,13544,0.566,0.434
16,646,38199,38199,0,1.0,0.0
17,647,6172,4824,1348,0.782,0.218
18,650,14998,10556,4442,0.704,0.296
19,652,4715,3499,1216,0.742,0.258
20,653,13307,12414,893,0.933,0.067
21,656,21481,18931,2550,0.881,0.119
22,659,41953,37407,4546,0.892,0.108
23,660,17250,17216,34,0.998,0.002
24,662,43282,41045,2237,0.948,0.052
25,664,16784,11300,5484,0.673,0.327
26,667,25968,21332,4636,0.821,0.179
27,669,29744,23005,6739,0.773,0.227
28,670,9807,3214,6593,0.328,0.672
29,674,44457,41451,3006,0.932,0.068
30,676,40316,35279,5037,0.875,0.125
31,677,15272,15272,0,1.0,0.0
32,678,27819,25250,2569,0.908,0.092
33,680,58140,55306,2834,0.951,0.049
34,682,32615,31681,934,0.971,0.029
35,683,33772,30656,3116,0.908,0.092
36,685,42831,37131,5700,0.867,0.133
37,687,32610,29002,3608,0.889,0.111
38,688,13543,11072,2471,0.818,0.182
39,690,6255,6255,0,1.0,0.0
40,692,37511,36811,700,0.981,0.019
41,693,61038,58565,2473,0.959,0.041
42,694,328,328,0,1.0,0.0
43,698,41782,34339,7443,0.822,0.178
44,703,28605,25704,2901,0.899,0.101
45,704,8577,8451,126,0.985,0.015
46,705,25598,22433,3165,0.876,0.124
47,707,12225,9277,2948,0.759,0.241
48,714,19566,18740,826,0.958,0.042
49,715,3656,3445,211,0.942,0.058
50,716,33779,33772,7,1.0,0.0
51,717,18457,18457,0,1.0,0.0
52,718,26606,24447,2159,0.919,0.081
53,719,30990,30990,0,1.0,0.0
54,720,23129,15016,8113,0.649,0.351
55,723,19277,14345,4932,0.744,0.256
56,725,89374,88248,1126,0.987,0.013
57,727,58382,58098,284,0.995,0.005
58,728,44908,44878,30,0.999,0.001
59,729,53750,52665,1085,0.98,0.02
60,730,35742,35602,140,0.996,0.004
61,731,15524,9941,5583,0.64,0.36
62,735,13730,12055,1675,0.878,0.122
63,736,51532,46566,4966,0.904,0.096
64,738,34922,34138,784,0.978,0.022
65,739,39678,38548,1130,0.972,0.028
66,740,2071,2071,0,1.0,0.0
67,741,4971,4971,0,1.0,0.0
68,745,55062,53688,1374,0.975,0.025
69,751,23129,19033,4096,0.823,0.177
70,754,40828,36221,4607,0.887,0.113
71,757,23263,20295,2968,0.872,0.128
72,765,9098,8068,1030,0.887,0.113
73,766,26488,22564,3924,0.852,0.148
74,767,38019,32192,5827,0.847,0.153
75,769,40248,32781,7467,0.814,0.186
76,771,38394,37453,941,0.975,0.025
77,772,23105,22884,221,0.99,0.01
78,773,20068,18289,1779,0.911,0.089
79,775,1786,0,1786,0.0,1.0
80,777,40684,39389,1295,0.968,0.032
81,778,45429,45267,162,0.996,0.004
82,780,13800,12555,1245,0.91,0.09
83,782,19304,16841,2463,0.872,0.128
84,783,36557,34186,2371,0.935,0.065
85,784,44637,40553,4084,0.909,0.091
86,786,357,357,0,1.0,0.0
87,791,53417,53213,204,0.996,0.004
88,794,30585,29472,1113,0.964,0.036
89,795,48736,45396,3340,0.931,0.069
90,901,7080,7080,0,1.0,0.0
91,906,4,4,0,1.0,0.0
92,907,17458,17458,0,1.0,0.0
93,909,6230,6230,0,1.0,0.0
94,911,8623,8623,0,1.0,0.0
95,912,6801,6801,0,1.0,0.0
96,913,9312,9312,0,1.0,0.0
97,915,32820,32820,0,1.0,0.0
98,917,21053,21053,0,1.0,0.0
99,918,18056,18056,0,1.0,0.0
100,920,17893,17893,0,1.0,0.0
101,921,37763,37763,0,1.0,0.0
102,923,29086,29086,0,1.0,0.0
103,924,56691,56691,0,1.0,0.0
104,925,8696,8696,0,1.0,0.0
105,926,108862,108862,0,1.0,0.0
106,927,14936,14936,0,1.0,0.0
107,934,288,288,0,1.0,0.0
108,936,681,681,0,1.0,0.0
109,949,82278,82278,0,1.0,0.0
110,950,9,0,9,0.0,1.0
111,951,35,35,0,1.0,0.0
112,952,10008,10008,0,1.0,0.0
113,953,73014,73014,0,1.0,0.0
114,956,79304,79280,24,1.0,0.0
115,957,45680,45680,0,1.0,0.0
116,959,50560,50560,0,1.0,0.0
117,960,1779,1779,0,1.0,0.0
118,961,32429,32429,0,1.0,0.0
119,962,22491,22487,4,1.0,0.0
120,965,9134,9134,0,1.0,0.0
121,966,16676,16676,0,1.0,0.0
122,968,3478,3478,0,1.0,0.0
123,969,42219,42219,0,1.0,0.0
124,971,30986,30982,4,1.0,0.0
125,976,65136,65136,0,1.0,0.0
126,979,17030,17030,0,1.0,0.0
127,982,16428,16428,0,1.0,0.0
128,983,39234,39234,0,1.0,0.0
129,985,36553,36481,72,0.998,0.002
130,987,63661,63443,218,0.997,0.003
131,1001,16769,16684,85,0.995,0.005
132,1002,29049,25560,3489,0.88,0.12
133,1003,10372,10372,0,1.0,0.0
134,1005,5079,0,5079,0.0,1.0
135,1007,14649,5915,8734,0.404,0.596
136,1008,1263,0,1263,0.0,1.0
137,1009,741,630,111,0.85,0.15
138,1010,3609,0,3609,0.0,1.0
139,1011,1370,0,1370,0.0,1.0
140,1012,661,0,661,0.0,1.0
141,1013,23188,23188,0,1.0,0.0
142,1020,29668,29668,0,1.0,0.0
143,1022,2451,2451,0,1.0,0.0
144,1026,946,0,946,0.0,1.0
145,1027,17660,15417,2243,0.873,0.127
146,1028,15720,15436,284,0.982,0.018
147,1029,789,0,789,0.0,1.0
148,1030,11669,10402,1267,0.891,0.109
149,1031,1308,408,900,0.312,0.688
150,1032,570,0,570,0.0,1.0
151,1033,6227,3380,2847,0.543,0.457
152,1034,2021,0,2021,0.0,1.0
153,1035,5250,3125,2125,0.595,0.405
154,1036,5109,2684,2425,0.525,0.475
155,1037,838,0,838,0.0,1.0
156,1038,2545,0,2545,0.0,1.0
157,1039,1336,395,941,0.296,0.704
158,1040,39880,39444,436,0.989,0.011
159,1050,2530,68,2462,0.027,0.973
160,1053,1685,1254,431,0.744,0.256
161,1054,1851,0,1851,0.0,1.0
162,1056,21103,18627,2476,0.883,0.117
163,1057,8534,2317,6217,0.272,0.728
164,1060,15284,14258,1026,0.933,0.067
165,1062,11150,9975,1175,0.895,0.105
166,1063,430,430,0,1.0,0.0
167,1066,64,0,64,0.0,1.0
168,1068,1902,0,1902,0.0,1.0
169,1069,8469,6428,2041,0.759,0.241
170,1070,629,0,629,0.0,1.0
171,1071,1596,455,1141,0.285,0.715
172,1072,1478,0,1478,0.0,1.0
173,1073,5792,1107,4685,0.191,0.809
174,1074,319,0,319,0.0,1.0
175,1075,17527,16949,578,0.967,0.033
176,1077,9502,5023,4479,0.529,0.471
177,1079,692,426,266,0.616,0.384
178,1080,2334,2334,0,1.0,0.0
179,1081,1698,0,1698,0.0,1.0
180,1082,10322,6560,3762,0.636,0.364
181,1083,2888,1502,1386,0.52,0.48
182,1084,176,0,176,0.0,1.0
183,1085,41117,37649,3468,0.916,0.084
184,1086,687,687,0,1.0,0.0
185,1088,670,0,670,0.0,1.0
186,1089,28391,27877,514,0.982,0.018
187,1092,1394,638,756,0.458,0.542
188,1093,325,0,325,0.0,1.0
189,1094,351,0,351,0.0,1.0
190,1095,14319,12387,1932,0.865,0.135
191,1096,2217,0,2217,0.0,1.0
192,1097,111,65,46,0.586,0.414
193,1098,1101,0,1101,0.0,1.0
194,1103,2479,2479,0,1.0,0.0
195,1104,22865,22865,0,1.0,0.0
196,1105,12350,12350,0,1.0,0.0
197,1106,16021,16021,0,1.0,0.0
198,1107,11611,11611,0,1.0,0.0
199,1108,26688,26688,0,1.0,0.0
200,1109,30250,30250,0,1.0,0.0
201,1118,14071,14071,0,1.0,0.0
202,1119,14152,14152,0,1.0,0.0
203,1128,2631,2631,0,1.0,0.0
204,1129,7019,7019,0,1.0,0.0
205,1151,8698,8698,0,1.0,0.0
206,1199,0,0,0,,
207,1201,46504,43110,3394,0.927,0.073
208,1220,8603,7565,1038,0.879,0.121
209,1222,829,0,829,0.0,1.0
210,1223,2314,0,2314,0.0,1.0
211,1224,182,182,0,1.0,0.0
212,1225,3117,1689,1428,0.542,0.458
213,1226,6945,4892,2053,0.704,0.296
214,1229,95,0,95,0.0,1.0
215,1230,8430,3607,4823,0.428,0.572
216,1235,2766,588,2178,0.213,0.787
217,1236,1509,964,545,0.639,0.361
218,1237,2496,478,2018,0.192,0.808
219,1238,6047,4500,1547,0.744,0.256
220,1240,4534,3084,1450,0.68,0.32
221,1242,476,476,0,1.0,0.0
222,1243,334,0,334,0.0,1.0
223,1244,151,0,151,0.0,1.0
224,1245,985,0,985,0.0,1.0
225,1247,16087,12287,3800,0.764,0.236
226,1253,731,0,731,0.0,1.0
227,1254,972,0,972,0.0,1.0
228,1255,915,0,915,0.0,1.0
229,1256,692,0,692,0.0,1.0
230,1257,2121,0,2121,0.0,1.0
231,1258,374,0,374,0.0,1.0
232,1259,635,0,635,0.0,1.0
233,1260,240,62,178,0.258,0.742
234,1262,1238,535,703,0.432,0.568
235,1264,137,0,137,0.0,1.0
236,1266,1463,0,1463,0.0,1.0
237,1267,7989,5743,2246,0.719,0.281
238,1270,778,0,778,0.0,1.0
239,1301,17700,15544,2156,0.878,0.122
240,1330,1506,0,1506,0.0,1.0
241,1331,13263,7985,5278,0.602,0.398
242,1337,2596,0,2596,0.0,1.0
243,1338,187,0,187,0.0,1.0
244,1339,1438,0,1438,0.0,1.0
245,1340,1701,0,1701,0.0,1.0
246,1341,1833,0,1833,0.0,1.0
247,1342,1492,556,936,0.373,0.627
248,1343,75,0,75,0.0,1.0
249,1344,1498,489,1009,0.326,0.674
250,1346,533,0,533,0.0,1.0
251,1347,166,0,166,0.0,1.0
252,1349,1091,766,325,0.702,0.298
253,1350,121,0,121,0.0,1.0
254,1351,2270,148,2122,0.065,0.935
255,1354,1500,215,1285,0.143,0.857
256,1355,878,0,878,0.0,1.0
257,1360,3032,0,3032,0.0,1.0
258,1364,7969,4849,3120,0.608,0.392
259,1366,1277,0,1277,0.0,1.0
260,1367,522,0,522,0.0,1.0
261,1368,1261,0,1261,0.0,1.0
262,1370,4084,0,4084,0.0,1.0
263,1373,4600,1923,2677,0.418,0.582
264,1375,3684,2786,898,0.756,0.244
265,1376,5247,5247,0,1.0,0.0
266,1378,774,0,774,0.0,1.0
267,1379,813,0,813,0.0,1.0
268,1420,40337,37234,3103,0.923,0.077
269,1430,6089,602,5487,0.099,0.901
270,1431,3074,362,2712,0.118,0.882
271,1432,7089,6790,299,0.958,0.042
272,1434,1795,1795,0,1.0,0.0
273,1436,3336,2626,710,0.787,0.213
274,1438,559,514,45,0.919,0.081
275,1440,20347,19309,1038,0.949,0.051
276,1450,10646,6587,4059,0.619,0.381
277,1451,4747,79,4668,0.017,0.983
278,1452,4382,0,4382,0.0,1.0
279,1453,40883,39504,1379,0.966,0.034
280,1460,8924,8149,775,0.913,0.087
281,1462,10086,7034,3052,0.697,0.303
282,1463,11497,6620,4877,0.576,0.424
283,1464,7211,5287,1924,0.733,0.267
284,1467,316,0,316,0.0,1.0
285,1468,4021,877,3144,0.218,0.782
286,1469,6801,3362,3439,0.494,0.506
287,1473,7277,3224,4053,0.443,0.557
288,1474,2125,935,1190,0.44,0.56
289,1475,10270,5961,4309,0.58,0.42
290,1501,16075,15317,758,0.953,0.047
291,1503,2866,992,1874,0.346,0.654
292,1504,9026,8380,646,0.928,0.072
293,1505,4355,2417,1938,0.555,0.445
294,1506,3390,1132,2258,0.334,0.666
295,1507,12981,3723,9258,0.287,0.713
296,1510,13606,13601,5,1.0,0.0
297,1515,2183,1252,931,0.574,0.426
298,1516,8500,3463,5037,0.407,0.593
299,1518,2974,1919,1055,0.645,0.355
300,1519,6595,6146,449,0.932,0.068
301,1520,13997,12248,1749,0.875,0.125
302,1521,2481,0,2481,0.0,1.0
303,1522,3310,2272,1038,0.686,0.314
304,1523,7582,5175,2407,0.683,0.317
305,1524,6696,4776,1920,0.713,0.287
306,1525,290,290,0,1.0,0.0
307,1527,13246,12041,1205,0.909,0.091
308,1529,3190,2411,779,0.756,0.244
309,1531,999,0,999,0.0,1.0
310,1532,14155,13215,940,0.934,0.066
311,1534,5631,5021,610,0.892,0.108
312,1535,4680,2782,1898,0.594,0.406
313,1536,6888,6567,321,0.953,0.047
314,1537,2248,1724,524,0.767,0.233
315,1540,11291,8618,2673,0.763,0.237
316,1541,3413,0,3413,0.0,1.0
317,1542,2202,1762,440,0.8,0.2
318,1543,7973,3408,4565,0.427,0.573
319,1545,35299,35299,0,1.0,0.0
320,1550,16719,14656,2063,0.877,0.123
321,1560,4527,4527,0,1.0,0.0
322,1561,330,330,0,1.0,0.0
323,1562,11688,7727,3961,0.661,0.339
324,1564,7808,3107,4701,0.398,0.602
325,1566,6294,3212,3082,0.51,0.49
326,1568,7480,4308,3172,0.576,0.424
327,1569,13569,11052,2517,0.815,0.185
328,1570,16767,16276,491,0.971,0.029
329,1571,11390,9015,2375,0.791,0.209
330,1581,18272,17371,901,0.951,0.049
331,1583,7591,6702,889,0.883,0.117
332,1585,4554,1996,2558,0.438,0.562
333,1588,9733,9629,104,0.989,0.011
334,1590,8875,5439,3436,0.613,0.387
335,1602,22819,22819,0,1.0,0.0
336,1603,19916,19916,0,1.0,0.0
337,1604,34677,34677,0,1.0,0.0
338,1605,26221,26221,0,1.0,0.0
339,1606,19077,19077,0,1.0,0.0
340,1607,8351,8351,0,1.0,0.0
341,1608,3888,3888,0,1.0,0.0
342,1609,22421,22421,0,1.0,0.0
343,1610,23945,23945,0,1.0,0.0
344,1611,2242,1705,537,0.76,0.24
345,1612,4845,2130,2715,0.44,0.56
346,1701,31217,31217,0,1.0,0.0
347,1702,37206,37206,0,1.0,0.0
348,1718,469,469,0,1.0,0.0
349,1719,4996,4991,5,0.999,0.001
350,1720,21361,20147,1214,0.943,0.057
351,1721,16593,16346,247,0.985,0.015
352,1730,13221,13143,78,0.994,0.006
353,1731,1396,1396,0,1.0,0.0
354,1740,4897,285,4612,0.058,0.942
355,1741,4852,723,4129,0.149,0.851
356,1742,17726,15273,2453,0.862,0.138
357,1745,397,397,0,1.0,0.0
358,1746,13547,13016,531,0.961,0.039
359,1747,5911,5871,40,0.993,0.007
360,1748,14925,11693,3232,0.783,0.217
361,1749,19063,18690,373,0.98,0.02
362,1752,38499,38380,119,0.997,0.003
363,1754,10106,10048,58,0.994,0.006
364,1756,5839,2629,3210,0.45,0.55
365,1757,28061,27799,262,0.991,0.009
366,1760,32786,32384,402,0.988,0.012
367,1770,4119,1272,2847,0.309,0.691
368,1772,9370,9313,57,0.994,0.006
369,1773,5112,2749,2363,0.538,0.462
370,1775,6590,4096,2494,0.622,0.378
371,1776,17659,16703,956,0.946,0.054
372,1778,13109,12743,366,0.972,0.028
373,1801,38903,38903,0,1.0,0.0
374,1803,24487,24487,0,1.0,0.0
375,1810,33201,33201,0,1.0,0.0
376,1821,30310,30310,0,1.0,0.0
377,1824,24911,24911,0,1.0,0.0
378,1826,29422,28230,1192,0.959,0.041
379,1827,3179,486,2693,0.153,0.847
380,1830,25137,24681,456,0.982,0.018
381,1832,22060,22060,0,1.0,0.0
382,1833,8183,7397,786,0.904,0.096
383,1834,6459,5647,812,0.874,0.126
384,1835,13682,13510,172,0.987,0.013
385,1840,4733,4733,0,1.0,0.0
386,1841,47225,47225,0,1.0,0.0
387,1843,24425,24425,0,1.0,0.0
388,1844,47249,47247,2,1.0,0.0
389,1845,28352,27116,1236,0.956,0.044
390,1850,15237,15237,0,1.0,0.0
391,1851,30190,30190,0,1.0,0.0
392,1852,33508,33508,0,1.0,0.0
393,1854,27606,27606,0,1.0,0.0
394,1860,6338,5487,851,0.866,0.134
395,1862,10227,10185,42,0.996,0.004
396,1863,8891,8891,0,1.0,0.0
397,1864,14892,14892,0,1.0,0.0
398,1867,23956,23956,0,1.0,0.0
399,1876,28667,28667,0,1.0,0.0
400,1879,11305,10904,401,0.965,0.035
401,1880,24733,24733,0,1.0,0.0
402,1886,21951,21912,39,0.998,0.002
403,1887,22325,22325,0,1.0,0.0
404,1890,21382,21382,0,1.0,0.0
405,1901,1689,1689,0,1.0,0.0
406,1902,45139,45139,0,1.0,0.0
407,1904,18203,18203,0,1.0,0.0
408,1905,25251,25251,0,1.0,0.0
409,1906,26660,26660,0,1.0,0.0
410,1907,14027,14027,0,1.0,0.0
411,1908,3410,3410,0,1.0,0.0
412,1913,16283,16191,92,0.994,0.006
413,1915,39502,39233,269,0.993,0.007
414,1921,7961,3423,4538,0.43,0.57
415,1922,3108,1598,1510,0.514,0.486
416,1923,26342,26342,0,1.0,0.0
417,1929,3504,1978,1526,0.564,0.436
418,1930,28789,25397,3392,0.882,0.118
419,1937,151,151,0,1.0,0.0
420,1938,13175,9247,3928,0.702,0.298
421,1940,12108,12108,0,1.0,0.0
422,1944,5136,4237,899,0.825,0.175
423,1945,19808,19808,0,1.0,0.0
424,1949,8987,7952,1035,0.885,0.115
425,1950,17416,17413,3,1.0,0.0
426,1951,3558,2087,1471,0.587,0.413
427,1952,8283,7397,886,0.893,0.107
428,1960,50944,50944,0,1.0,0.0
429,1966,6952,6397,555,0.92,0.08
430,1969,5856,4418,1438,0.754,0.246
431,1970,41109,41109,0,1.0,0.0
432,1982,7764,6436,1328,0.829,0.171
433,1983,6089,5182,907,0.851,0.149
434,1984,4875,3847,1028,0.789,0.211
435,1985,4235,1815,2420,0.429,0.571
436,2019,16332,15744,588,0.964,0.036
437,2021,21561,21561,0,1.0,0.0
438,2025,7542,7221,321,0.957,0.043
439,2026,24711,24711,0,1.0,0.0
440,2030,5589,3911,1678,0.7,0.3
441,2032,4226,4226,0,1.0,0.0
442,2035,16865,16702,163,0.99,0.01
443,2038,31635,31369,266,0.992,0.008
444,2043,22157,21581,576,0.974,0.026
445,2045,10293,10292,1,1.0,0.0
446,2047,180,180,0,1.0,0.0
447,2048,23184,23184,0,1.0,0.0
448,2050,25429,23226,2203,0.913,0.087
449,2052,12024,11445,579,0.952,0.048
450,2053,12752,12714,38,0.997,0.003
451,2054,7891,6861,1030,0.869,0.131
452,2056,10981,10963,18,0.998,0.002
453,2061,10506,9458,1048,0.9,0.1
454,2062,28602,28602,0,1.0,0.0
455,2066,17656,16627,1029,0.942,0.058
456,2067,17486,16050,1436,0.918,0.082
457,2071,1707,1707,0,1.0,0.0
458,2072,26999,26999,0,1.0,0.0
459,2081,18472,18472,0,1.0,0.0
460,2090,14636,14442,194,0.987,0.013
461,2093,10955,9559,1396,0.873,0.127
462,2108,3825,3825,0,1.0,0.0
463,2109,3771,3771,0,1.0,0.0
464,2110,1733,1733,0,1.0,0.0
465,2111,7383,7383,0,1.0,0.0
466,2113,6915,6915,0,1.0,0.0
467,2114,11999,11999,0,1.0,0.0
468,2115,28441,28441,0,1.0,0.0
469,2116,20628,20628,0,1.0,0.0
470,2118,26498,26498,0,1.0,0.0
471,2119,25346,25346,0,1.0,0.0
472,2120,15181,15181,0,1.0,0.0
473,2121,25978,25978,0,1.0,0.0
474,2122,23479,22946,533,0.977,0.023
475,2124,47783,47783,0,1.0,0.0
476,2125,33295,33295,0,1.0,0.0
477,2126,25562,25562,0,1.0,0.0
478,2127,31799,31799,0,1.0,0.0
479,2128,40508,40508,0,1.0,0.0
480,2129,16439,16439,0,1.0,0.0
481,2130,35401,35401,0,1.0,0.0
482,2131,29826,29826,0,1.0,0.0
483,2132,25861,25861,0,1.0,0.0
484,2134,21503,21503,0,1.0,0.0
485,2135,42780,42780,0,1.0,0.0
486,2136,28488,28488,0,1.0,0.0
487,2138,36314,36314,0,1.0,0.0
488,2139,36349,36349,0,1.0,0.0
489,2140,17607,17607,0,1.0,0.0
490,2141,11910,11910,0,1.0,0.0
491,2142,3141,3141,0,1.0,0.0
492,2143,24514,24514,0,1.0,0.0
493,2144,23891,23891,0,1.0,0.0
494,2145,25439,25439,0,1.0,0.0
495,2148,59503,59503,0,1.0,0.0
496,2149,41550,41550,0,1.0,0.0
497,2150,35124,35124,0,1.0,0.0
498,2151,51808,51808,0,1.0,0.0
499,2152,17497,17497,0,1.0,0.0
500,2155,57964,57964,0,1.0,0.0
501,2163,2582,2582,0,1.0,0.0
502,2169,55055,55055,0,1.0,0.0
503,2170,19505,19505,0,1.0,0.0
504,2171,17711,17711,0,1.0,0.0
505,2176,26983,26983,0,1.0,0.0
506,2180,21437,21437,0,1.0,0.0
507,2184,35744,35744,0,1.0,0.0
508,2186,27003,27003,0,1.0,0.0
509,2188,14608,14608,0,1.0,0.0
510,2189,14559,14559,0,1.0,0.0
511,2190,16119,16119,0,1.0,0.0
512,2191,8457,8457,0,1.0,0.0
513,2199,1146,1146,0,1.0,0.0
514,2203,0,0,0,,
515,2210,2090,2090,0,1.0,0.0
516,2215,26125,26125,0,1.0,0.0
517,2301,61025,61025,0,1.0,0.0
518,2302,32741,32741,0,1.0,0.0
519,2322,4356,4356,0,1.0,0.0
520,2324,26563,25017,1546,0.942,0.058
521,2330,11509,8828,2681,0.767,0.233
522,2332,15059,14153,906,0.94,0.06
523,2333,13794,12940,854,0.938,0.062
524,2338,7518,5416,2102,0.72,0.28
525,2339,13879,13879,0,1.0,0.0
526,2341,10218,9167,1051,0.897,0.103
527,2343,10745,10745,0,1.0,0.0
528,2346,23106,12690,10416,0.549,0.451
529,2347,10612,5394,5218,0.508,0.492
530,2351,16029,16029,0,1.0,0.0
531,2356,12564,12131,433,0.966,0.034
532,2357,1360,1360,0,1.0,0.0
533,2359,17828,17309,519,0.971,0.029
534,2360,56271,50529,5742,0.898,0.102
535,2364,12629,11575,1054,0.917,0.083
536,2366,197,0,197,0.0,1.0
537,2367,2820,345,2475,0.122,0.878
538,2368,32158,32158,0,1.0,0.0
539,2370,17489,17489,0,1.0,0.0
540,2375,9188,8772,416,0.955,0.045
541,2379,6916,6357,559,0.919,0.081
542,2382,14489,14489,0,1.0,0.0
543,2420,14052,14052,0,1.0,0.0
544,2421,17342,17342,0,1.0,0.0
545,2445,20679,20679,0,1.0,0.0
546,2446,29311,29311,0,1.0,0.0
547,2451,17426,17426,0,1.0,0.0
548,2452,14238,14238,0,1.0,0.0
549,2453,28968,28968,0,1.0,0.0
550,2457,1432,1432,0,1.0,0.0
551,2458,12131,12131,0,1.0,0.0
552,2459,19095,19095,0,1.0,0.0
553,2460,8742,8742,0,1.0,0.0
554,2461,7059,7059,0,1.0,0.0
555,2462,1554,1554,0,1.0,0.0
556,2464,2953,2953,0,1.0,0.0
557,2465,11710,11710,0,1.0,0.0
558,2466,8096,8096,0,1.0,0.0
559,2467,22491,22491,0,1.0,0.0
560,2468,5273,5273,0,1.0,0.0
561,2472,32014,32014,0,1.0,0.0
562,2474,26312,26312,0,1.0,0.0
563,2476,16532,16532,0,1.0,0.0
564,2478,24664,24664,0,1.0,0.0
565,2481,16244,16244,0,1.0,0.0
566,2482,10306,10306,0,1.0,0.0
567,2492,19931,19931,0,1.0,0.0
568,2493,11261,11261,0,1.0,0.0
569,2494,8955,8955,0,1.0,0.0
570,2532,12690,11439,1251,0.901,0.099
571,2534,842,626,216,0.743,0.257
572,2535,1177,0,1177,0.0,1.0
573,2536,19583,18186,1397,0.929,0.071
574,2537,6293,6056,237,0.962,0.038
575,2538,3603,3221,382,0.894,0.106
576,2539,4067,2795,1272,0.687,0.313
577,2540,8221,8086,135,0.984,0.016
578,2542,1139,1034,105,0.908,0.092
579,2543,635,612,23,0.964,0.036
580,2553,226,209,17,0.925,0.075
581,2554,9852,8250,1602,0.837,0.163
582,2556,3115,3115,0,1.0,0.0
583,2557,4491,3872,619,0.862,0.138
584,2558,2156,2151,5,0.998,0.002
585,2559,3376,3298,78,0.977,0.023
586,2561,539,539,0,1.0,0.0
587,2562,2977,2912,65,0.978,0.022
588,2563,10359,10321,38,0.996,0.004
589,2564,310,0,310,0.0,1.0
590,2568,4000,3415,585,0.854,0.146
591,2571,10481,9703,778,0.926,0.074
592,2575,2725,0,2725,0.0,1.0
593,2576,3754,3110,644,0.828,0.172
594,2584,10,0,10,0.0,1.0
595,2601,14089,14089,0,1.0,0.0
596,2630,1850,1582,268,0.855,0.145
597,2631,9679,7965,1714,0.823,0.177
598,2632,10742,10713,29,0.997,0.003
599,2633,3884,3710,174,0.955,0.045
600,2635,3296,3035,261,0.921,0.079
601,2637,253,185,68,0.731,0.269
602,2638,3207,2926,281,0.912,0.088
603,2639,2875,2875,0,1.0,0.0
604,2641,532,197,335,0.37,0.63
605,2642,4937,4658,279,0.943,0.057
606,2643,26,26,0,1.0,0.0
607,2644,3955,3954,1,1.0,0.0
608,2645,9663,8989,674,0.93,0.07
609,2646,1676,1676,0,1.0,0.0
610,2647,129,129,0,1.0,0.0
611,2648,7301,7126,175,0.976,0.024
612,2649,14006,13341,665,0.953,0.047
613,2650,848,788,60,0.929,0.071
614,2651,16,4,12,0.25,0.75
615,2652,1175,385,790,0.328,0.672
616,2653,5911,4947,964,0.837,0.163
617,2655,3518,2840,678,0.807,0.193
618,2657,2942,2767,175,0.941,0.059
619,2659,1108,1103,5,0.995,0.005
620,2660,6261,6139,122,0.981,0.019
621,2663,173,99,74,0.572,0.428
622,2664,9371,9371,0,1.0,0.0
623,2666,828,0,828,0.0,1.0
624,2667,2580,470,2110,0.182,0.818
625,2668,3278,2508,770,0.765,0.235
626,2669,285,237,48,0.832,0.168
627,2670,1307,1307,0,1.0,0.0
628,2671,1023,1023,0,1.0,0.0
629,2672,180,180,0,1.0,0.0
630,2673,8402,8127,275,0.967,0.033
631,2675,6577,5748,829,0.874,0.126
632,2702,4125,3097,1028,0.751,0.249
633,2703,43593,43593,0,1.0,0.0
634,2713,52,0,52,0.0,1.0
635,2715,3123,1224,1899,0.392,0.608
636,2717,4745,2136,2609,0.45,0.55
637,2718,6655,6278,377,0.943,0.057
638,2719,15873,15350,523,0.967,0.033
639,2720,30287,30074,213,0.993,0.007
640,2721,26290,26290,0,1.0,0.0
641,2723,14767,14767,0,1.0,0.0
642,2724,16908,16908,0,1.0,0.0
643,2725,2631,2631,0,1.0,0.0
644,2726,15534,15534,0,1.0,0.0
645,2738,4907,3909,998,0.797,0.203
646,2739,6045,2885,3160,0.477,0.523
647,2740,43087,43087,0,1.0,0.0
648,2743,10307,6461,3846,0.627,0.373
649,2744,11900,11900,0,1.0,0.0
650,2745,24576,24437,139,0.994,0.006
651,2746,15342,15342,0,1.0,0.0
652,2747,22927,16996,5931,0.741,0.259
653,2748,11442,9224,2218,0.806,0.194
654,2760,26739,26739,0,1.0,0.0
655,2762,8264,7650,614,0.926,0.074
656,2763,1973,1973,0,1.0,0.0
657,2764,3988,1973,2015,0.495,0.505
658,2766,19031,16080,2951,0.845,0.155
659,2767,13566,12991,575,0.958,0.042
660,2769,11608,1505,10103,0.13,0.87
661,2770,5093,270,4823,0.053,0.947
662,2771,13708,12544,1164,0.915,0.085
663,2777,15840,12669,3171,0.8,0.2
664,2779,6411,2777,3634,0.433,0.567
665,2780,49036,46327,2709,0.945,0.055
666,2790,15717,7997,7720,0.509,0.491
667,2791,246,0,246,0.0,1.0
668,2802,786,786,0,1.0,0.0
669,2804,2607,1352,1255,0.519,0.481
670,2806,16310,16310,0,1.0,0.0
671,2807,1051,0,1051,0.0,1.0
672,2808,2401,0,2401,0.0,1.0
673,2809,22938,22792,146,0.994,0.006
674,2812,1497,0,1497,0.0,1.0
675,2813,7831,1571,6260,0.201,0.799
676,2814,7496,541,6955,0.072,0.928
677,2815,278,0,278,0.0,1.0
678,2816,32611,28054,4557,0.86,0.14
679,2817,6135,1554,4581,0.253,0.747
680,2818,18082,16120,1962,0.891,0.109
681,2822,6111,1556,4555,0.255,0.745
682,2825,5377,0,5377,0.0,1.0
683,2826,791,499,292,0.631,0.369
684,2827,2172,0,2172,0.0,1.0
685,2828,7704,7669,35,0.995,0.005
686,2830,5976,3325,2651,0.556,0.444
687,2831,3515,1983,1532,0.564,0.436
688,2832,4608,0,4608,0.0,1.0
689,2833,784,0,784,0.0,1.0
690,2835,5405,4948,457,0.915,0.085
691,2836,136,0,136,0.0,1.0
692,2837,3492,0,3492,0.0,1.0
693,2838,3400,3400,0,1.0,0.0
694,2839,1902,1327,575,0.698,0.302
695,2840,23335,23004,331,0.986,0.014
696,2841,1392,1392,0,1.0,0.0
697,2842,16095,15699,396,0.975,0.025
698,2852,22551,21942,609,0.973,0.027
699,2857,8412,1881,6531,0.224,0.776
700,2858,570,558,12,0.979,0.021
701,2859,6738,3883,2855,0.576,0.424
702,2860,45199,45199,0,1.0,0.0
703,2861,26178,26178,0,1.0,0.0
704,2863,19385,19385,0,1.0,0.0
705,2864,33396,31035,2361,0.929,0.071
706,2865,16951,16933,18,0.999,0.001
707,2871,17171,16630,541,0.968,0.032
708,2872,218,0,218,0.0,1.0
709,2873,235,0,235,0.0,1.0
710,2874,5860,3923,1937,0.669,0.331
711,2875,307,0,307,0.0,1.0
712,2876,430,430,0,1.0,0.0
713,2878,15780,11192,4588,0.709,0.291
714,2879,20371,15430,4941,0.757,0.243
715,2881,7841,7477,364,0.954,0.046
716,2882,14184,14170,14,0.999,0.001
717,2885,10627,10203,424,0.96,0.04
718,2886,29269,29269,0,1.0,0.0
719,2888,19912,19912,0,1.0,0.0
720,2889,28217,28217,0,1.0,0.0
721,2891,21198,19771,1427,0.933,0.067
722,2892,4988,648,4340,0.13,0.87
723,2893,29630,29630,0,1.0,0.0
724,2894,722,0,722,0.0,1.0
725,2895,41186,41186,0,1.0,0.0
726,2896,11537,9703,1834,0.841,0.159
727,2898,1696,0,1696,0.0,1.0
728,2903,10780,10780,0,1.0,0.0
729,2904,29359,29359,0,1.0,0.0
730,2905,25223,25223,0,1.0,0.0
731,2906,28387,28387,0,1.0,0.0
732,2907,27445,27445,0,1.0,0.0
733,2908,37467,37467,0,1.0,0.0
734,2909,43540,43540,0,1.0,0.0
735,2910,21000,21000,0,1.0,0.0
736,2911,15574,15574,0,1.0,0.0
737,2912,1370,1370,0,1.0,0.0
738,2914,21963,21963,0,1.0,0.0
739,2915,16897,16897,0,1.0,0.0
740,2916,8139,8139,0,1.0,0.0
741,2917,13762,12679,1083,0.921,0.079
742,2919,28790,27467,1323,0.954,0.046
743,2920,37547,37547,0,1.0,0.0
744,2921,12361,11553,808,0.935,0.065
745,3031,11247,6332,4915,0.563,0.437
746,3032,4953,1368,3585,0.276,0.724
747,3033,4987,0,4987,0.0,1.0
748,3034,3970,15,3955,0.004,0.996
749,3036,4782,730,4052,0.153,0.847
750,3037,4219,0,4219,0.0,1.0
751,3038,33269,30111,3158,0.905,0.095
752,3042,6341,3158,3183,0.498,0.502
753,3043,1573,0,1573,0.0,1.0
754,3044,4263,665,3598,0.156,0.844
755,3045,13560,8287,5273,0.611,0.389
756,3046,2758,0,2758,0.0,1.0
757,3047,1767,0,1767,0.0,1.0
758,3048,3426,0,3426,0.0,1.0
759,3049,7688,1059,6629,0.138,0.862
760,3051,24480,23204,1276,0.948,0.052
761,3052,8258,5647,2611,0.684,0.316
762,3053,23957,21475,2482,0.896,0.104
763,3054,25477,22474,3003,0.882,0.118
764,3055,15086,12164,2922,0.806,0.194
765,3057,2500,157,2343,0.063,0.937
766,3060,29357,29357,0,1.0,0.0
767,3062,26694,25967,727,0.973,0.027
768,3063,16216,16197,19,0.999,0.001
769,3064,14227,14227,0,1.0,0.0
770,3070,5254,0,5254,0.0,1.0
771,3071,5109,0,5109,0.0,1.0
772,3076,12897,9466,3431,0.734,0.266
773,3077,10155,4611,5544,0.454,0.546
774,3079,28776,28450,326,0.989,0.011
775,3082,1615,0,1615,0.0,1.0
776,3084,1366,0,1366,0.0,1.0
777,3086,3728,1197,2531,0.321,0.679
778,3087,13592,10511,3081,0.773,0.227
779,3101,3049,3049,0,1.0,0.0
780,3102,31096,31096,0,1.0,0.0
781,3103,36476,36476,0,1.0,0.0
782,3104,32798,32798,0,1.0,0.0
783,3106,13374,9608,3766,0.718,0.282
784,3109,10314,9781,533,0.948,0.052
785,3110,21203,19896,1307,0.938,0.062
786,3215,247,0,247,0.0,1.0
787,3216,2159,0,2159,0.0,1.0
788,3217,2076,44,2032,0.021,0.979
789,3218,960,0,960,0.0,1.0
790,3220,7430,1270,6160,0.171,0.829
791,3221,2091,0,2091,0.0,1.0
792,3222,5353,0,5353,0.0,1.0
793,3223,3427,137,3290,0.04,0.96
794,3224,2318,0,2318,0.0,1.0
795,3225,3660,0,3660,0.0,1.0
796,3226,1117,0,1117,0.0,1.0
797,3227,925,0,925,0.0,1.0
798,3229,5589,0,5589,0.0,1.0
799,3230,1231,0,1231,0.0,1.0
800,3231,202,0,202,0.0,1.0
801,3233,115,0,115,0.0,1.0
802,3234,4572,0,4572,0.0,1.0
803,3235,8562,6295,2267,0.735,0.265
804,3237,2254,0,2254,0.0,1.0
805,3238,75,0,75,0.0,1.0
806,3240,1340,0,1340,0.0,1.0
807,3241,876,0,876,0.0,1.0
808,3242,4836,0,4836,0.0,1.0
809,3243,1085,0,1085,0.0,1.0
810,3244,8092,3884,4208,0.48,0.52
811,3245,2027,173,1854,0.085,0.915
812,3246,15963,13909,2054,0.871,0.129
813,3249,7113,2930,4183,0.412,0.588
814,3251,1662,0,1662,0.0,1.0
815,3253,6219,0,6219,0.0,1.0
816,3254,4049,0,4049,0.0,1.0
817,3255,2090,0,2090,0.0,1.0
818,3256,2169,0,2169,0.0,1.0
819,3257,4455,0,4455,0.0,1.0
820,3258,2517,0,2517,0.0,1.0
821,3259,368,0,368,0.0,1.0
822,3260,809,0,809,0.0,1.0
823,3261,4246,0,4246,0.0,1.0
824,3262,1231,0,1231,0.0,1.0
825,3263,4114,0,4114,0.0,1.0
826,3264,7468,4605,2863,0.617,0.383
827,3266,2163,0,2163,0.0,1.0
828,3268,1272,0,1272,0.0,1.0
829,3269,2966,64,2902,0.022,0.978
830,3273,312,0,312,0.0,1.0
831,3275,11437,6269,5168,0.548,0.452
832,3276,8324,3750,4574,0.451,0.549
833,3278,2952,0,2952,0.0,1.0
834,3279,829,0,829,0.0,1.0
835,3280,1123,0,1123,0.0,1.0
836,3281,8785,0,8785,0.0,1.0
837,3282,902,0,902,0.0,1.0
838,3284,999,0,999,0.0,1.0
839,3285,2479,0,2479,0.0,1.0
840,3287,1295,0,1295,0.0,1.0
841,3290,4731,0,4731,0.0,1.0
842,3291,39,0,39,0.0,1.0
843,3293,143,0,143,0.0,1.0
844,3301,33008,30152,2856,0.913,0.087
845,3303,15524,9744,5780,0.628,0.372
846,3304,7519,2661,4858,0.354,0.646
847,3307,5334,0,5334,0.0,1.0
848,3431,25280,21533,3747,0.852,0.148
849,3440,2692,0,2692,0.0,1.0
850,3441,395,0,395,0.0,1.0
851,3442,1491,0,1491,0.0,1.0
852,3443,742,0,742,0.0,1.0
853,3444,1590,0,1590,0.0,1.0
854,3445,691,0,691,0.0,1.0
855,3446,6285,41,6244,0.007,0.993
856,3447,2422,0,2422,0.0,1.0
857,3448,811,0,811,0.0,1.0
858,3449,1654,0,1654,0.0,1.0
859,3450,961,0,961,0.0,1.0
860,3451,4077,9,4068,0.002,0.998
861,3452,5457,2901,2556,0.532,0.468
862,3455,2086,936,1150,0.449,0.551
863,3456,742,0,742,0.0,1.0
864,3457,852,0,852,0.0,1.0
865,3458,6643,3165,3478,0.476,0.524
866,3461,6014,102,5912,0.017,0.983
867,3462,1562,0,1562,0.0,1.0
868,3464,1109,0,1109,0.0,1.0
869,3465,2156,0,2156,0.0,1.0
870,3466,1332,0,1332,0.0,1.0
871,3467,1842,0,1842,0.0,1.0
872,3470,5033,0,5033,0.0,1.0
873,3561,5939,3518,2421,0.592,0.408
874,3570,10051,8888,1163,0.884,0.116
875,3574,2526,0,2526,0.0,1.0
876,3575,124,0,124,0.0,1.0
877,3576,3238,0,3238,0.0,1.0
878,3579,461,0,461,0.0,1.0
879,3580,1369,0,1369,0.0,1.0
880,3581,3230,2271,959,0.703,0.297
881,3582,2577,0,2577,0.0,1.0
882,3583,1107,0,1107,0.0,1.0
883,3584,3774,0,3774,0.0,1.0
884,3585,2519,0,2519,0.0,1.0
885,3586,547,0,547,0.0,1.0
886,3588,1641,0,1641,0.0,1.0
887,3590,1052,0,1052,0.0,1.0
888,3592,1145,0,1145,0.0,1.0
889,3593,313,0,313,0.0,1.0
890,3595,639,0,639,0.0,1.0
891,3597,521,0,521,0.0,1.0
892,3598,3285,0,3285,0.0,1.0
893,3601,477,0,477,0.0,1.0
894,3602,2654,0,2654,0.0,1.0
895,3603,5412,2907,2505,0.537,0.463
896,3604,69,0,69,0.0,1.0
897,3605,1160,0,1160,0.0,1.0
898,3607,322,0,322,0.0,1.0
899,3608,2811,663,2148,0.236,0.764
900,3609,854,794,60,0.93,0.07
901,3740,911,0,911,0.0,1.0
902,3741,4208,0,4208,0.0,1.0
903,3743,14103,9598,4505,0.681,0.319
904,3745,1424,29,1395,0.02,0.98
905,3746,216,0,216,0.0,1.0
906,3748,4762,377,4385,0.079,0.921
907,3750,870,29,841,0.033,0.967
908,3751,583,0,583,0.0,1.0
909,3752,810,0,810,0.0,1.0
910,3753,2971,0,2971,0.0,1.0
911,3754,86,86,0,1.0,0.0
912,3755,10538,8764,1774,0.832,0.168
913,3765,503,0,503,0.0,1.0
914,3766,8958,6886,2072,0.769,0.231
915,3768,1716,0,1716,0.0,1.0
916,3770,524,0,524,0.0,1.0
917,3771,754,0,754,0.0,1.0
918,3773,7841,3056,4785,0.39,0.61
919,3774,1966,0,1966,0.0,1.0
920,3777,1237,0,1237,0.0,1.0
921,3779,790,0,790,0.0,1.0
922,3780,410,0,410,0.0,1.0
923,3781,1840,0,1840,0.0,1.0
924,3782,2945,0,2945,0.0,1.0
925,3784,4086,3347,739,0.819,0.181
926,3785,2400,0,2400,0.0,1.0
927,3801,21532,20859,673,0.969,0.031
928,3809,3716,0,3716,0.0,1.0
929,3810,1538,0,1538,0.0,1.0
930,3811,6753,6753,0,1.0,0.0
931,3812,824,0,824,0.0,1.0
932,3813,3250,190,3060,0.058,0.942
933,3814,2329,0,2329,0.0,1.0
934,3816,1368,0,1368,0.0,1.0
935,3817,574,0,574,0.0,1.0
936,3818,3807,1707,2100,0.448,0.552
937,3819,4377,2455,1922,0.561,0.439
938,3820,30039,29607,432,0.986,0.014
939,3823,1719,116,1603,0.067,0.933
940,3824,14638,12053,2585,0.823,0.177
941,3825,8512,159,8353,0.019,0.981
942,3826,2470,2466,4,0.998,0.002
943,3827,3150,1014,2136,0.322,0.678
944,3830,1610,0,1610,0.0,1.0
945,3832,395,0,395,0.0,1.0
946,3833,20955,12913,8042,0.616,0.384
947,3835,6786,2957,3829,0.436,0.564
948,3836,1489,0,1489,0.0,1.0
949,3837,1519,0,1519,0.0,1.0
950,3838,1031,0,1031,0.0,1.0
951,3839,3735,2530,1205,0.677,0.323
952,3840,3566,2783,783,0.78,0.22
953,3841,6334,6193,141,0.978,0.022
954,3842,15345,14806,539,0.965,0.035
955,3844,2238,703,1535,0.314,0.686
956,3845,991,118,873,0.119,0.881
957,3846,799,0,799,0.0,1.0
958,3847,294,287,7,0.976,0.024
959,3848,6020,4023,1997,0.668,0.332
960,3849,1585,0,1585,0.0,1.0
961,3850,372,0,372,0.0,1.0
962,3851,4040,1528,2512,0.378,0.622
963,3852,558,0,558,0.0,1.0
964,3853,602,0,602,0.0,1.0
965,3854,968,968,0,1.0,0.0
966,3855,2638,0,2638,0.0,1.0
967,3856,1680,596,1084,0.355,0.645
968,3857,9006,7539,1467,0.837,0.163
969,3858,4603,3460,1143,0.752,0.248
970,3860,4056,2383,1673,0.588,0.412
971,3861,4330,24,4306,0.006,0.994
972,3862,4278,2475,1803,0.579,0.421
973,3864,1696,0,1696,0.0,1.0
974,3865,7609,7607,2,1.0,0.0
975,3867,20758,16472,4286,0.794,0.206
976,3868,5323,4841,482,0.909,0.091
977,3869,2469,1506,963,0.61,0.39
978,3870,5162,4788,374,0.928,0.072
979,3871,136,65,71,0.478,0.522
980,3872,3809,0,3809,0.0,1.0
981,3873,5711,4093,1618,0.717,0.283
982,3874,8776,8692,84,0.99,0.01
983,3875,833,0,833,0.0,1.0
984,3878,11824,11450,374,0.968,0.032
985,3882,1465,0,1465,0.0,1.0
986,3883,178,0,178,0.0,1.0
987,3884,3964,0,3964,0.0,1.0
988,3885,7261,5373,1888,0.74,0.26
989,3886,2112,0,2112,0.0,1.0
990,3887,2154,0,2154,0.0,1.0
991,3890,327,0,327,0.0,1.0
992,3894,6314,0,6314,0.0,1.0
993,3901,7246,2515,4731,0.347,0.653
994,3902,2211,185,2026,0.084,0.916
995,3903,6211,2956,3255,0.476,0.524
996,3904,7703,6069,1634,0.788,0.212
997,3905,1780,900,880,0.506,0.494
998,3906,4647,0,4647,0.0,1.0
999,3907,894,0,894,0.0,1.0
1000,3908,7233,4349,2884,0.601,0.399
1001,3909,9738,5739,3999,0.589,0.411
1002,3910,328,328,0,1.0,0.0
1003,3911,250,250,0,1.0,0.0
1004,4001,2429,0,2429,0.0,1.0
1005,4002,7351,0,7351,0.0,1.0
1006,4003,330,0,330,0.0,1.0
1007,4005,23146,17198,5948,0.743,0.257
1008,4006,96,0,96,0.0,1.0
1009,4008,2723,0,2723,0.0,1.0
1010,4009,5151,0,5151,0.0,1.0
1011,4010,1597,0,1597,0.0,1.0
1012,4011,20278,15633,4645,0.771,0.229
1013,4015,3808,0,3808,0.0,1.0
1014,4017,341,0,341,0.0,1.0
1015,4019,71,0,71,0.0,1.0
1016,4020,1403,0,1403,0.0,1.0
1017,4021,5820,1970,3850,0.338,0.662
1018,4022,1148,0,1148,0.0,1.0
1019,4024,608,0,608,0.0,1.0
1020,4027,6031,325,5706,0.054,0.946
1021,4029,1725,0,1725,0.0,1.0
1022,4030,2208,0,2208,0.0,1.0
1023,4032,7879,2637,5242,0.335,0.665
1024,4037,3834,0,3834,0.0,1.0
1025,4038,16381,6254,10127,0.382,0.618
1026,4039,7422,0,7422,0.0,1.0
1027,4040,3111,0,3111,0.0,1.0
1028,4041,1613,0,1613,0.0,1.0
1029,4042,4281,0,4281,0.0,1.0
1030,4043,10810,6933,3877,0.641,0.359
1031,4046,7496,1698,5798,0.227,0.773
1032,4047,1892,0,1892,0.0,1.0
1033,4048,2946,0,2946,0.0,1.0
1034,4049,3659,0,3659,0.0,1.0
1035,4050,230,0,230,0.0,1.0
1036,4051,1153,0,1153,0.0,1.0
1037,4055,3793,0,3793,0.0,1.0
1038,4056,257,0,257,0.0,1.0
1039,4057,56,0,56,0.0,1.0
1040,4061,3369,0,3369,0.0,1.0
1041,4062,17020,10571,6449,0.621,0.379
1042,4063,412,412,0,1.0,0.0
1043,4064,8212,8023,189,0.977,0.023
1044,4066,539,0,539,0.0,1.0
1045,4068,1505,0,1505,0.0,1.0
1046,4069,1465,0,1465,0.0,1.0
1047,4071,4801,688,4113,0.143,0.857
1048,4072,18482,13611,4871,0.736,0.264
1049,4073,16189,10800,5389,0.667,0.333
1050,4074,18760,12099,6661,0.645,0.355
1051,4076,2683,0,2683,0.0,1.0
1052,4079,3871,0,3871,0.0,1.0
1053,4083,4525,2784,1741,0.615,0.385
1054,4084,8088,70,8018,0.009,0.991
1055,4085,1786,0,1786,0.0,1.0
1056,4086,8787,5488,3299,0.625,0.375
1057,4087,2116,0,2116,0.0,1.0
1058,4088,1516,0,1516,0.0,1.0
1059,4090,9589,0,9589,0.0,1.0
1060,4091,911,0,911,0.0,1.0
1061,4092,17515,16747,768,0.956,0.044
1062,4093,8034,0,8034,0.0,1.0
1063,4095,1274,0,1274,0.0,1.0
1064,4096,8349,7386,963,0.885,0.115
1065,4097,3574,363,3211,0.102,0.898
1066,4101,17227,17227,0,1.0,0.0
1067,4102,17335,17335,0,1.0,0.0
1068,4103,30606,30606,0,1.0,0.0
1069,4105,11158,6038,5120,0.541,0.459
1070,4106,25175,25174,1,1.0,0.0
1071,4107,8980,7769,1211,0.865,0.135
1072,4108,862,0,862,0.0,1.0
1073,4109,93,0,93,0.0,1.0
1074,4110,1391,1345,46,0.967,0.033
1075,4210,23045,17924,5121,0.778,0.222
1076,4216,640,0,640,0.0,1.0
1077,4217,3312,0,3312,0.0,1.0
1078,4219,1472,0,1472,0.0,1.0
1079,4220,3077,0,3077,0.0,1.0
1080,4221,1098,0,1098,0.0,1.0
1081,4222,3848,0,3848,0.0,1.0
1082,4224,3040,0,3040,0.0,1.0
1083,4226,190,0,190,0.0,1.0
1084,4227,79,0,79,0.0,1.0
1085,4228,6,0,6,0.0,1.0
1086,4231,236,0,236,0.0,1.0
1087,4234,168,0,168,0.0,1.0
1088,4236,4350,0,4350,0.0,1.0
1089,4237,238,0,238,0.0,1.0
1090,4238,1416,0,1416,0.0,1.0
1091,4239,4851,1412,3439,0.291,0.709
1092,4240,36592,33768,2824,0.923,0.077
1093,4250,4228,1969,2259,0.466,0.534
1094,4252,4799,3577,1222,0.745,0.255
1095,4253,2095,0,2095,0.0,1.0
1096,4254,3181,1680,1501,0.528,0.472
1097,4255,802,0,802,0.0,1.0
1098,4256,3064,0,3064,0.0,1.0
1099,4257,2681,1586,1095,0.592,0.408
1100,4258,2617,0,2617,0.0,1.0
1101,4259,3264,0,3264,0.0,1.0
1102,4260,5542,82,5460,0.015,0.985
1103,4261,444,0,444,0.0,1.0
1104,4263,2326,0,2326,0.0,1.0
1105,4265,918,0,918,0.0,1.0
1106,4267,37,0,37,0.0,1.0
1107,4268,5023,1847,3176,0.368,0.632
1108,4270,5880,477,5403,0.081,0.919
1109,4271,67,0,67,0.0,1.0
1110,4274,5343,0,5343,0.0,1.0
1111,4275,514,0,514,0.0,1.0
1112,4276,5841,3401,2440,0.582,0.418
1113,4280,6474,2077,4397,0.321,0.679
1114,4281,5116,2456,2660,0.48,0.52
1115,4282,5734,0,5734,0.0,1.0
1116,4284,1138,0,1138,0.0,1.0
1117,4285,433,0,433,0.0,1.0
1118,4286,47,0,47,0.0,1.0
1119,4287,3224,0,3224,0.0,1.0
1120,4289,1815,0,1815,0.0,1.0
1121,4290,1541,0,1541,0.0,1.0
1122,4292,948,0,948,0.0,1.0
1123,4294,3995,0,3995,0.0,1.0
1124,4330,26086,13631,12455,0.523,0.477
1125,4342,1672,0,1672,0.0,1.0
1126,4343,25,0,25,0.0,1.0
1127,4344,2951,1902,1049,0.645,0.355
1128,4345,11646,3673,7973,0.315,0.685
1129,4346,1772,1659,113,0.936,0.064
1130,4347,2355,1392,963,0.591,0.409
1131,4348,2976,0,2976,0.0,1.0
1132,4349,1158,0,1158,0.0,1.0
1133,4350,3577,0,3577,0.0,1.0
1134,4351,2571,0,2571,0.0,1.0
1135,4352,1632,0,1632,0.0,1.0
1136,4353,2300,0,2300,0.0,1.0
1137,4354,1535,0,1535,0.0,1.0
1138,4355,2600,0,2600,0.0,1.0
1139,4357,3399,0,3399,0.0,1.0
1140,4358,4276,0,4276,0.0,1.0
1141,4359,388,380,8,0.979,0.021
1142,4360,560,0,560,0.0,1.0
1143,4363,2575,0,2575,0.0,1.0
1144,4364,6025,0,6025,0.0,1.0
1145,4401,44899,32226,12673,0.718,0.282
1146,4406,819,0,819,0.0,1.0
1147,4408,176,0,176,0.0,1.0
1148,4410,1290,0,1290,0.0,1.0
1149,4411,1492,461,1031,0.309,0.691
1150,4412,9482,7803,1679,0.823,0.177
1151,4413,196,0,196,0.0,1.0
1152,4414,1248,0,1248,0.0,1.0
1153,4415,276,0,276,0.0,1.0
1154,4416,5468,0,5468,0.0,1.0
1155,4417,370,0,370,0.0,1.0
1156,4418,1771,0,1771,0.0,1.0
1157,4419,2794,0,2794,0.0,1.0
1158,4421,1366,0,1366,0.0,1.0
1159,4422,1409,0,1409,0.0,1.0
1160,4424,823,0,823,0.0,1.0
1161,4426,4720,0,4720,0.0,1.0
1162,4427,2858,0,2858,0.0,1.0
1163,4428,3146,0,3146,0.0,1.0
1164,4429,4717,0,4717,0.0,1.0
1165,4430,1728,0,1728,0.0,1.0
1166,4431,81,0,81,0.0,1.0
1167,4434,1246,0,1246,0.0,1.0
1168,4435,1092,0,1092,0.0,1.0
1169,4438,1124,0,1124,0.0,1.0
1170,4441,1840,0,1840,0.0,1.0
1171,4442,93,0,93,0.0,1.0
1172,4443,2537,0,2537,0.0,1.0
1173,4444,8824,2659,6165,0.301,0.699
1174,4448,1431,0,1431,0.0,1.0
1175,4449,1489,0,1489,0.0,1.0
1176,4450,1368,0,1368,0.0,1.0
1177,4451,259,0,259,0.0,1.0
1178,4453,779,0,779,0.0,1.0
1179,4454,69,0,69,0.0,1.0
1180,4455,923,0,923,0.0,1.0
1181,4456,2851,0,2851,0.0,1.0
1182,4457,5948,0,5948,0.0,1.0
1183,4459,773,0,773,0.0,1.0
1184,4460,1419,0,1419,0.0,1.0
1185,4461,3070,1854,1216,0.604,0.396
1186,4462,4835,3976,859,0.822,0.178
1187,4463,2847,0,2847,0.0,1.0
1188,4464,684,0,684,0.0,1.0
1189,4468,9521,6219,3302,0.653,0.347
1190,4469,2702,2702,0,1.0,0.0
1191,4471,609,0,609,0.0,1.0
1192,4472,2144,0,2144,0.0,1.0
1193,4473,7660,6670,990,0.871,0.129
1194,4474,3733,473,3260,0.127,0.873
1195,4475,418,0,418,0.0,1.0
1196,4476,1259,0,1259,0.0,1.0
1197,4478,316,0,316,0.0,1.0
1198,4479,1343,0,1343,0.0,1.0
1199,4481,559,0,559,0.0,1.0
1200,4485,233,0,233,0.0,1.0
1201,4487,964,0,964,0.0,1.0
1202,4488,1202,0,1202,0.0,1.0
1203,4489,197,143,54,0.726,0.274
1204,4490,273,0,273,0.0,1.0
1205,4491,140,0,140,0.0,1.0
1206,4492,166,0,166,0.0,1.0
1207,4493,1967,0,1967,0.0,1.0
1208,4495,407,0,407,0.0,1.0
1209,4496,3757,0,3757,0.0,1.0
1210,4497,389,0,389,0.0,1.0
1211,4530,10818,7846,2972,0.725,0.275
1212,4535,709,0,709,0.0,1.0
1213,4537,2073,0,2073,0.0,1.0
1214,4538,2080,0,2080,0.0,1.0
1215,4539,1168,0,1168,0.0,1.0
1216,4541,80,0,80,0.0,1.0
1217,4543,2218,0,2218,0.0,1.0
1218,4544,724,0,724,0.0,1.0
1219,4547,1152,0,1152,0.0,1.0
1220,4548,1042,0,1042,0.0,1.0
1221,4551,806,0,806,0.0,1.0
1222,4553,1752,0,1752,0.0,1.0
1223,4554,710,0,710,0.0,1.0
1224,4555,1643,0,1643,0.0,1.0
1225,4556,1249,0,1249,0.0,1.0
1226,4558,308,0,308,0.0,1.0
1227,4562,2216,0,2216,0.0,1.0
1228,4563,1534,0,1534,0.0,1.0
1229,4564,489,0,489,0.0,1.0
1230,4568,391,0,391,0.0,1.0
1231,4570,2,0,2,0.0,1.0
1232,4571,323,0,323,0.0,1.0
1233,4572,5075,0,5075,0.0,1.0
1234,4573,501,0,501,0.0,1.0
1235,4574,1510,0,1510,0.0,1.0
1236,4575,85,0,85,0.0,1.0
1237,4576,604,0,604,0.0,1.0
1238,4578,4450,0,4450,0.0,1.0
1239,4579,3072,192,2880,0.062,0.938
1240,4605,12974,2805,10169,0.216,0.784
1241,4606,1272,0,1272,0.0,1.0
1242,4607,1182,0,1182,0.0,1.0
1243,4609,5222,2562,2660,0.491,0.509
1244,4611,508,0,508,0.0,1.0
1245,4612,589,0,589,0.0,1.0
1246,4613,183,0,183,0.0,1.0
1247,4614,2579,0,2579,0.0,1.0
1248,4616,824,0,824,0.0,1.0
1249,4617,811,0,811,0.0,1.0
1250,4619,3121,2504,617,0.802,0.198
1251,4622,1412,0,1412,0.0,1.0
1252,4623,1054,0,1054,0.0,1.0
1253,4624,184,0,184,0.0,1.0
1254,4625,47,0,47,0.0,1.0
1255,4626,507,0,507,0.0,1.0
1256,4627,1636,0,1636,0.0,1.0
1257,4628,703,0,703,0.0,1.0
1258,4629,107,0,107,0.0,1.0
1259,4630,1398,0,1398,0.0,1.0
1260,4631,1331,0,1331,0.0,1.0
1261,4634,1923,0,1923,0.0,1.0
1262,4635,61,0,61,0.0,1.0
1263,4637,136,0,136,0.0,1.0
1264,4640,2261,0,2261,0.0,1.0
1265,4642,123,0,123,0.0,1.0
1266,4643,1018,0,1018,0.0,1.0
1267,4644,13,13,0,1.0,0.0
1268,4645,73,0,73,0.0,1.0
1269,4646,94,0,94,0.0,1.0
1270,4648,580,0,580,0.0,1.0
1271,4649,1370,0,1370,0.0,1.0
1272,4650,235,0,235,0.0,1.0
1273,4652,1690,0,1690,0.0,1.0
1274,4653,490,0,490,0.0,1.0
1275,4654,3424,0,3424,0.0,1.0
1276,4655,1119,0,1119,0.0,1.0
1277,4657,363,0,363,0.0,1.0
1278,4658,1353,0,1353,0.0,1.0
1279,4660,1309,0,1309,0.0,1.0
1280,4662,488,0,488,0.0,1.0
1281,4664,1238,0,1238,0.0,1.0
1282,4666,1172,0,1172,0.0,1.0
1283,4667,1638,0,1638,0.0,1.0
1284,4668,1680,0,1680,0.0,1.0
1285,4669,204,0,204,0.0,1.0
1286,4671,576,0,576,0.0,1.0
1287,4673,112,0,112,0.0,1.0
1288,4674,484,0,484,0.0,1.0
1289,4675,253,0,253,0.0,1.0
1290,4676,1088,0,1088,0.0,1.0
1291,4677,274,0,274,0.0,1.0
1292,4679,1767,0,1767,0.0,1.0
1293,4680,1131,0,1131,0.0,1.0
1294,4681,1043,0,1043,0.0,1.0
1295,4683,104,0,104,0.0,1.0
1296,4684,1466,0,1466,0.0,1.0
1297,4685,332,0,332,0.0,1.0
1298,4686,114,0,114,0.0,1.0
1299,4691,441,0,441,0.0,1.0
1300,4693,516,0,516,0.0,1.0
1301,4694,2376,0,2376,0.0,1.0
1302,4730,9992,4128,5864,0.413,0.587
1303,4732,1670,0,1670,0.0,1.0
1304,4733,221,0,221,0.0,1.0
1305,4734,800,0,800,0.0,1.0
1306,4735,617,0,617,0.0,1.0
1307,4736,9876,3974,5902,0.402,0.598
1308,4739,1112,0,1112,0.0,1.0
1309,4740,1287,0,1287,0.0,1.0
1310,4741,3,0,3,0.0,1.0
1311,4742,3496,0,3496,0.0,1.0
1312,4743,4676,0,4676,0.0,1.0
1313,4745,1082,0,1082,0.0,1.0
1314,4746,470,0,470,0.0,1.0
1315,4747,1337,0,1337,0.0,1.0
1316,4750,2603,0,2603,0.0,1.0
1317,4756,3344,0,3344,0.0,1.0
1318,4757,2870,0,2870,0.0,1.0
1319,4758,1498,0,1498,0.0,1.0
1320,4760,795,0,795,0.0,1.0
1321,4761,529,0,529,0.0,1.0
1322,4762,602,0,602,0.0,1.0
1323,4763,726,0,726,0.0,1.0
1324,4764,66,0,66,0.0,1.0
1325,4765,1262,0,1262,0.0,1.0
1326,4766,386,0,386,0.0,1.0
1327,4768,400,0,400,0.0,1.0
1328,4769,9692,6081,3611,0.627,0.373
1329,4772,762,0,762,0.0,1.0
1330,4773,723,0,723,0.0,1.0
1331,4774,730,0,730,0.0,1.0
1332,4776,925,0,925,0.0,1.0
1333,4777,422,0,422,0.0,1.0
1334,4779,398,0,398,0.0,1.0
1335,4780,808,0,808,0.0,1.0
1336,4781,560,0,560,0.0,1.0
1337,4783,426,0,426,0.0,1.0
1338,4785,2504,0,2504,0.0,1.0
1339,4786,1970,0,1970,0.0,1.0
1340,4787,544,0,544,0.0,1.0
1341,4841,7297,6658,639,0.912,0.088
1342,4843,4851,3361,1490,0.693,0.307
1343,4847,1536,0,1536,0.0,1.0
1344,4848,566,0,566,0.0,1.0
1345,4849,3684,0,3684,0.0,1.0
1346,4851,75,0,75,0.0,1.0
1347,4852,69,0,69,0.0,1.0
1348,4853,354,0,354,0.0,1.0
1349,4854,1580,92,1488,0.058,0.942
1350,4855,307,0,307,0.0,1.0
1351,4856,3330,744,2586,0.223,0.777
1352,4858,1533,0,1533,0.0,1.0
1353,4859,724,0,724,0.0,1.0
1354,4860,1591,0,1591,0.0,1.0
1355,4861,2781,1888,893,0.679,0.321
1356,4862,3592,0,3592,0.0,1.0
1357,4863,1165,0,1165,0.0,1.0
1358,4864,4751,0,4751,0.0,1.0
1359,4901,26248,20454,5794,0.779,0.221
1360,4910,2041,0,2041,0.0,1.0
1361,4911,2136,0,2136,0.0,1.0
1362,4912,1048,0,1048,0.0,1.0
1363,4915,8806,3358,5448,0.381,0.619
1364,4917,2849,0,2849,0.0,1.0
1365,4918,349,0,349,0.0,1.0
1366,4920,1713,0,1713,0.0,1.0
1367,4921,1593,0,1593,0.0,1.0
1368,4922,1164,0,1164,0.0,1.0
1369,4923,482,0,482,0.0,1.0
1370,4924,2275,0,2275,0.0,1.0
1371,4925,75,0,75,0.0,1.0
1372,4926,52,0,52,0.0,1.0
1373,4927,3486,0,3486,0.0,1.0
1374,4928,2198,0,2198,0.0,1.0
1375,4929,837,3,834,0.004,0.996
1376,4930,4295,0,4295,0.0,1.0
1377,4932,1181,0,1181,0.0,1.0
1378,4933,65,0,65,0.0,1.0
1379,4936,261,0,261,0.0,1.0
1380,4937,6645,2875,3770,0.433,0.567
1381,4938,9869,3716,6153,0.377,0.623
1382,4939,1105,0,1105,0.0,1.0
1383,4940,118,0,118,0.0,1.0
1384,4941,1751,0,1751,0.0,1.0
1385,4942,1326,0,1326,0.0,1.0
1386,4943,1792,0,1792,0.0,1.0
1387,4944,42,0,42,0.0,1.0
1388,4945,1242,0,1242,0.0,1.0
1389,4947,1852,0,1852,0.0,1.0
1390,4949,913,0,913,0.0,1.0
1391,4950,4855,2,4853,0.0,1.0
1392,4951,906,0,906,0.0,1.0
1393,4952,1829,0,1829,0.0,1.0
1394,4953,3228,0,3228,0.0,1.0
1395,4955,1362,0,1362,0.0,1.0
1396,4956,760,0,760,0.0,1.0
1397,4957,4265,0,4265,0.0,1.0
1398,4958,1954,0,1954,0.0,1.0
1399,4961,972,0,972,0.0,1.0
1400,4962,125,0,125,0.0,1.0
1401,4963,7238,2312,4926,0.319,0.681
1402,4964,221,0,221,0.0,1.0
1403,4965,1976,0,1976,0.0,1.0
1404,4966,1682,0,1682,0.0,1.0
1405,4967,4230,2520,1710,0.596,0.404
1406,4969,1362,0,1362,0.0,1.0
1407,4970,1620,0,1620,0.0,1.0
1408,4971,2005,0,2005,0.0,1.0
1409,4973,1389,0,1389,0.0,1.0
1410,4974,2611,0,2611,0.0,1.0
1411,4975,48,48,0,1.0,0.0
1412,4976,9903,4749,5154,0.48,0.52
1413,4978,799,0,799,0.0,1.0
1414,4979,1064,0,1064,0.0,1.0
1415,4981,2316,0,2316,0.0,1.0
1416,4982,630,0,630,0.0,1.0
1417,4983,1752,0,1752,0.0,1.0
1418,4984,523,0,523,0.0,1.0
1419,4985,114,0,114,0.0,1.0
1420,4986,1721,0,1721,0.0,1.0
1421,4987,1030,0,1030,0.0,1.0
1422,4988,2134,0,2134,0.0,1.0
1423,4989,4215,0,4215,0.0,1.0
1424,4992,103,103,0,1.0,0.0
1425,5001,9123,5434,3689,0.596,0.404
1426,5031,218,0,218,0.0,1.0
1427,5032,2664,0,2664,0.0,1.0
1428,5033,2744,0,2744,0.0,1.0
1429,5034,310,0,310,0.0,1.0
1430,5035,638,0,638,0.0,1.0
1431,5036,1037,0,1037,0.0,1.0
1432,5037,560,0,560,0.0,1.0
1433,5038,1230,0,1230,0.0,1.0
1434,5039,1110,0,1110,0.0,1.0
1435,5040,471,0,471,0.0,1.0
1436,5041,354,0,354,0.0,1.0
1437,5042,605,0,605,0.0,1.0
1438,5043,937,0,937,0.0,1.0
1439,5045,1758,0,1758,0.0,1.0
1440,5046,1139,0,1139,0.0,1.0
1441,5048,2429,0,2429,0.0,1.0
1442,5050,146,0,146,0.0,1.0
1443,5051,1549,0,1549,0.0,1.0
1444,5052,348,0,348,0.0,1.0
1445,5053,332,0,332,0.0,1.0
1446,5055,3363,853,2510,0.254,0.746
1447,5056,567,0,567,0.0,1.0
1448,5058,346,0,346,0.0,1.0
1449,5059,874,0,874,0.0,1.0
1450,5060,4415,0,4415,0.0,1.0
1451,5061,1679,0,1679,0.0,1.0
1452,5062,702,0,702,0.0,1.0
1453,5065,1064,0,1064,0.0,1.0
1454,5067,258,0,258,0.0,1.0
1455,5068,3125,0,3125,0.0,1.0
1456,5069,555,0,555,0.0,1.0
1457,5070,484,0,484,0.0,1.0
1458,5071,324,0,324,0.0,1.0
1459,5072,526,0,526,0.0,1.0
1460,5075,1113,0,1113,0.0,1.0
1461,5076,412,0,412,0.0,1.0
1462,5077,1215,0,1215,0.0,1.0
1463,5079,730,0,730,0.0,1.0
1464,5081,550,0,550,0.0,1.0
1465,5083,151,0,151,0.0,1.0
1466,5084,140,0,140,0.0,1.0
1467,5086,793,0,793,0.0,1.0
1468,5089,4979,2675,2304,0.537,0.463
1469,5091,3288,0,3288,0.0,1.0
1470,5101,4643,3514,1129,0.757,0.243
1471,5141,112,0,112,0.0,1.0
1472,5142,680,0,680,0.0,1.0
1473,5143,4343,0,4343,0.0,1.0
1474,5146,750,0,750,0.0,1.0
1475,5148,1140,0,1140,0.0,1.0
1476,5149,2092,0,2092,0.0,1.0
1477,5150,831,558,273,0.671,0.329
1478,5151,1553,0,1553,0.0,1.0
1479,5152,448,0,448,0.0,1.0
1480,5153,687,0,687,0.0,1.0
1481,5154,661,373,288,0.564,0.436
1482,5155,828,0,828,0.0,1.0
1483,5156,9226,4314,4912,0.468,0.532
1484,5158,1049,277,772,0.264,0.736
1485,5161,552,0,552,0.0,1.0
1486,5201,14851,10295,4556,0.693,0.307
1487,5250,3408,0,3408,0.0,1.0
1488,5251,1350,0,1350,0.0,1.0
1489,5252,274,0,274,0.0,1.0
1490,5253,685,0,685,0.0,1.0
1491,5254,273,0,273,0.0,1.0
1492,5255,4121,0,4121,0.0,1.0
1493,5257,2718,1918,800,0.706,0.294
1494,5260,459,0,459,0.0,1.0
1495,5261,2738,452,2286,0.165,0.835
1496,5262,2547,510,2037,0.2,0.8
1497,5301,16820,9963,6857,0.592,0.408
1498,5340,763,0,763,0.0,1.0
1499,5341,407,0,407,0.0,1.0
1500,5342,581,0,581,0.0,1.0
1501,5343,917,0,917,0.0,1.0
1502,5345,2119,0,2119,0.0,1.0
1503,5346,5184,0,5184,0.0,1.0
1504,5350,763,0,763,0.0,1.0
1505,5352,824,0,824,0.0,1.0
1506,5353,1072,0,1072,0.0,1.0
1507,5354,2210,8,2202,0.004,0.996
1508,5355,813,0,813,0.0,1.0
1509,5356,717,0,717,0.0,1.0
1510,5358,148,0,148,0.0,1.0
1511,5359,594,0,594,0.0,1.0
1512,5360,251,0,251,0.0,1.0
1513,5361,947,0,947,0.0,1.0
1514,5362,127,0,127,0.0,1.0
1515,5363,2021,0,2021,0.0,1.0
1516,5401,28185,28185,0,1.0,0.0
1517,5403,17593,16043,1550,0.912,0.088
1518,5404,7240,7240,0,1.0,0.0
1519,5405,4406,4406,0,1.0,0.0
1520,5408,10114,10114,0,1.0,0.0
1521,5439,1734,1734,0,1.0,0.0
1522,5440,1998,0,1998,0.0,1.0
1523,5441,958,0,958,0.0,1.0
1524,5442,339,0,339,0.0,1.0
1525,5443,6656,0,6656,0.0,1.0
1526,5444,1714,0,1714,0.0,1.0
1527,5445,3754,0,3754,0.0,1.0
1528,5446,15373,11422,3951,0.743,0.257
1529,5447,79,0,79,0.0,1.0
1530,5448,1134,0,1134,0.0,1.0
1531,5450,4977,0,4977,0.0,1.0
1532,5452,19710,17061,2649,0.866,0.134
1533,5454,4447,138,4309,0.031,0.969
1534,5455,1080,0,1080,0.0,1.0
1535,5456,1277,0,1277,0.0,1.0
1536,5457,1617,0,1617,0.0,1.0
1537,5458,2044,0,2044,0.0,1.0
1538,5459,2156,22,2134,0.01,0.99
1539,5461,4542,0,4542,0.0,1.0
1540,5462,1938,0,1938,0.0,1.0
1541,5463,471,0,471,0.0,1.0
1542,5464,3008,0,3008,0.0,1.0
1543,5465,5355,2086,3269,0.39,0.61
1544,5468,12942,8383,4559,0.648,0.352
1545,5471,896,0,896,0.0,1.0
1546,5472,1643,0,1643,0.0,1.0
1547,5473,1413,0,1413,0.0,1.0
1548,5474,803,0,803,0.0,1.0
1549,5476,3183,0,3183,0.0,1.0
1550,5477,4397,0,4397,0.0,1.0
1551,5478,14449,9054,5395,0.627,0.373
1552,5481,0,0,0,,
1553,5482,7198,5156,2042,0.716,0.284
1554,5483,1303,0,1303,0.0,1.0
1555,5485,93,0,93,0.0,1.0
1556,5486,1654,0,1654,0.0,1.0
1557,5487,1498,0,1498,0.0,1.0
1558,5488,7690,3033,4657,0.394,0.606
1559,5489,3174,126,3048,0.04,0.96
1560,5491,5909,2592,3317,0.439,0.561
1561,5492,682,0,682,0.0,1.0
1562,5494,1767,0,1767,0.0,1.0
1563,5495,9341,5167,4174,0.553,0.447
1564,5602,11916,6978,4938,0.586,0.414
1565,5640,161,0,161,0.0,1.0
1566,5641,17169,12896,4273,0.751,0.249
1567,5647,1141,0,1141,0.0,1.0
1568,5648,423,0,423,0.0,1.0
1569,5649,574,226,348,0.394,0.606
1570,5650,1123,0,1123,0.0,1.0
1571,5651,1546,0,1546,0.0,1.0
1572,5652,776,0,776,0.0,1.0
1573,5653,547,0,547,0.0,1.0
1574,5654,970,695,275,0.716,0.284
1575,5655,2868,0,2868,0.0,1.0
1576,5656,3508,0,3508,0.0,1.0
1577,5657,56,0,56,0.0,1.0
1578,5658,1402,0,1402,0.0,1.0
1579,5660,1660,0,1660,0.0,1.0
1580,5661,5620,0,5620,0.0,1.0
1581,5663,6773,4170,2603,0.616,0.384
1582,5664,80,80,0,1.0,0.0
1583,5667,2166,0,2166,0.0,1.0
1584,5669,634,0,634,0.0,1.0
1585,5672,4314,0,4314,0.0,1.0
1586,5673,2574,0,2574,0.0,1.0
1587,5674,1705,0,1705,0.0,1.0
1588,5675,1064,0,1064,0.0,1.0
1589,5676,4984,2176,2808,0.437,0.563
1590,5677,2232,795,1437,0.356,0.644
1591,5678,163,163,0,1.0,0.0
1592,5679,3296,717,2579,0.218,0.782
1593,5680,2168,0,2168,0.0,1.0
1594,5681,458,0,458,0.0,1.0
1595,5682,1251,0,1251,0.0,1.0
1596,5701,20802,17710,3092,0.851,0.149
1597,5730,302,0,302,0.0,1.0
1598,5732,708,0,708,0.0,1.0
1599,5733,5895,0,5895,0.0,1.0
1600,5734,1306,0,1306,0.0,1.0
1601,5735,4402,2208,2194,0.502,0.498
1602,5736,684,139,545,0.203,0.797
1603,5737,875,0,875,0.0,1.0
1604,5738,1072,0,1072,0.0,1.0
1605,5739,1407,0,1407,0.0,1.0
1606,5740,25,0,25,0.0,1.0
1607,5742,597,0,597,0.0,1.0
1608,5743,4330,1973,2357,0.456,0.544
1609,5744,533,0,533,0.0,1.0
1610,5747,280,0,280,0.0,1.0
1611,5748,323,0,323,0.0,1.0
1612,5751,811,0,811,0.0,1.0
1613,5753,10491,5350,5141,0.51,0.49
1614,5757,832,0,832,0.0,1.0
1615,5758,784,0,784,0.0,1.0
1616,5759,1827,578,1249,0.316,0.684
1617,5760,1123,0,1123,0.0,1.0
1618,5761,1000,0,1000,0.0,1.0
1619,5762,542,0,542,0.0,1.0
1620,5763,2747,0,2747,0.0,1.0
1621,5764,3452,0,3452,0.0,1.0
1622,5765,1803,0,1803,0.0,1.0
1623,5766,572,0,572,0.0,1.0
1624,5767,1143,0,1143,0.0,1.0
1625,5769,1216,0,1216,0.0,1.0
1626,5770,1136,0,1136,0.0,1.0
1627,5772,713,0,713,0.0,1.0
1628,5773,2136,0,2136,0.0,1.0
1629,5774,1129,0,1129,0.0,1.0
1630,5775,623,11,612,0.018,0.982
1631,5776,714,0,714,0.0,1.0
1632,5777,3420,1413,2007,0.413,0.587
1633,5778,733,0,733,0.0,1.0
1634,5819,9444,5073,4371,0.537,0.463
1635,5820,662,0,662,0.0,1.0
1636,5821,1269,0,1269,0.0,1.0
1637,5822,1873,0,1873,0.0,1.0
1638,5824,1139,0,1139,0.0,1.0
1639,5825,191,0,191,0.0,1.0
1640,5826,983,0,983,0.0,1.0
1641,5827,309,0,309,0.0,1.0
1642,5828,1928,0,1928,0.0,1.0
1643,5829,2003,0,2003,0.0,1.0
1644,5830,1502,0,1502,0.0,1.0
1645,5832,982,0,982,0.0,1.0
1646,5833,273,0,273,0.0,1.0
1647,5836,1068,0,1068,0.0,1.0
1648,5837,353,0,353,0.0,1.0
1649,5839,775,0,775,0.0,1.0
1650,5841,425,0,425,0.0,1.0
1651,5842,522,0,522,0.0,1.0
1652,5843,2556,0,2556,0.0,1.0
1653,5845,1096,0,1096,0.0,1.0
1654,5846,1252,0,1252,0.0,1.0
1655,5847,879,0,879,0.0,1.0
1656,5850,231,191,40,0.827,0.173
1657,5851,6528,2733,3795,0.419,0.581
1658,5853,711,0,711,0.0,1.0
1659,5855,7170,4004,3166,0.558,0.442
1660,5857,1540,0,1540,0.0,1.0
1661,5858,368,0,368,0.0,1.0
1662,5859,1819,0,1819,0.0,1.0
1663,5860,2557,0,2557,0.0,1.0
1664,5862,356,0,356,0.0,1.0
1665,5866,732,0,732,0.0,1.0
1666,5867,899,0,899,0.0,1.0
1667,5868,364,0,364,0.0,1.0
1668,5871,1638,0,1638,0.0,1.0
1669,5872,789,0,789,0.0,1.0
1670,5873,675,0,675,0.0,1.0
1671,5874,505,0,505,0.0,1.0
1672,5875,454,0,454,0.0,1.0
1673,5901,20,0,20,0.0,1.0
1674,5902,188,0,188,0.0,1.0
1675,5903,868,0,868,0.0,1.0
1676,5904,267,0,267,0.0,1.0
1677,5905,827,0,827,0.0,1.0
1678,5906,1178,0,1178,0.0,1.0
1679,5907,177,0,177,0.0,1.0
1680,6001,18385,17279,1106,0.94,0.06
1681,6002,20486,19516,970,0.953,0.047
1682,6010,60448,60406,42,0.999,0.001
1683,6013,9326,2105,7221,0.226,0.774
1684,6016,6226,4586,1640,0.737,0.263
1685,6018,2865,0,2865,0.0,1.0
1686,6019,10129,6457,3672,0.637,0.363
1687,6020,0,0,0,,
1688,6021,314,0,314,0.0,1.0
1689,6022,163,0,163,0.0,1.0
1690,6023,1296,1296,0,1.0,0.0
1691,6024,647,0,647,0.0,1.0
1692,6026,5117,1644,3473,0.321,0.679
1693,6027,1492,0,1492,0.0,1.0
1694,6029,15547,11620,3927,0.747,0.253
1695,6031,1287,0,1287,0.0,1.0
1696,6032,17675,16877,798,0.955,0.045
1697,6033,28762,27061,1701,0.941,0.059
1698,6035,7513,5604,1909,0.746,0.254
1699,6037,18565,16390,2175,0.883,0.117
1700,6039,1942,0,1942,0.0,1.0
1701,6040,35306,34637,669,0.981,0.019
1702,6042,22942,22942,0,1.0,0.0
1703,6043,4986,2206,2780,0.442,0.558
1704,6051,30519,30519,0,1.0,0.0
1705,6052,7858,7858,0,1.0,0.0
1706,6053,34863,34863,0,1.0,0.0
1707,6057,6707,1753,4954,0.261,0.739
1708,6058,1787,0,1787,0.0,1.0
1709,6059,0,0,0,,
1710,6060,2581,212,2369,0.082,0.918
1711,6061,169,169,0,1.0,0.0
1712,6062,17715,17715,0,1.0,0.0
1713,6063,3285,262,3023,0.08,0.92
1714,6065,882,0,882,0.0,1.0
1715,6066,29219,28656,563,0.981,0.019
1716,6067,19709,19709,0,1.0,0.0
1717,6068,1612,0,1612,0.0,1.0
1718,6069,2535,0,2535,0.0,1.0
1719,6070,15104,13706,1398,0.907,0.093
1720,6071,11645,9156,2489,0.786,0.214
1721,6073,5651,3618,2033,0.64,0.36
1722,6074,25705,25234,471,0.982,0.018
1723,6076,12659,5797,6862,0.458,0.542
1724,6078,12413,10511,1902,0.847,0.153
1725,6081,1381,1381,0,1.0,0.0
1726,6082,44654,43898,756,0.983,0.017
1727,6084,15067,9399,5668,0.624,0.376
1728,6085,7276,7276,0,1.0,0.0
1729,6088,4936,2370,2566,0.48,0.52
1730,6089,2813,2813,0,1.0,0.0
1731,6090,1232,0,1232,0.0,1.0
1732,6091,140,0,140,0.0,1.0
1733,6092,4203,3399,804,0.809,0.191
1734,6093,3322,1199,2123,0.361,0.639
1735,6095,29079,28289,790,0.973,0.027
1736,6096,12498,12498,0,1.0,0.0
1737,6098,12426,8144,4282,0.655,0.345
1738,6103,1410,1410,0,1.0,0.0
1739,6105,19392,19392,0,1.0,0.0
1740,6106,39902,39902,0,1.0,0.0
1741,6107,18786,18786,0,1.0,0.0
1742,6108,24307,24307,0,1.0,0.0
1743,6109,26668,26668,0,1.0,0.0
1744,6110,12650,12650,0,1.0,0.0
1745,6111,30562,30562,0,1.0,0.0
1746,6112,22879,22879,0,1.0,0.0
1747,6114,27449,27449,0,1.0,0.0
1748,6117,17267,17036,231,0.987,0.013
1749,6118,26956,26956,0,1.0,0.0
1750,6119,15474,15474,0,1.0,0.0
1751,6120,12887,12887,0,1.0,0.0
1752,6160,0,0,0,,
1753,6226,20114,19888,226,0.989,0.011
1754,6231,4083,908,3175,0.222,0.778
1755,6232,3297,25,3272,0.008,0.992
1756,6234,8244,3946,4298,0.479,0.521
1757,6235,2257,33,2224,0.015,0.985
1758,6237,5492,0,5492,0.0,1.0
1759,6238,12428,4120,8308,0.332,0.668
1760,6239,11183,7988,3195,0.714,0.286
1761,6241,6650,3337,3313,0.502,0.498
1762,6242,1408,0,1408,0.0,1.0
1763,6243,60,0,60,0.0,1.0
1764,6247,2841,0,2841,0.0,1.0
1765,6248,5603,658,4945,0.117,0.883
1766,6249,7308,82,7226,0.011,0.989
1767,6250,4821,2163,2658,0.449,0.551
1768,6254,1922,29,1893,0.015,0.985
1769,6255,4744,2664,2080,0.562,0.438
1770,6256,2154,1509,645,0.701,0.299
1771,6259,4498,215,4283,0.048,0.952
1772,6260,9510,7300,2210,0.768,0.232
1773,6262,586,505,81,0.862,0.138
1774,6263,345,318,27,0.922,0.078
1775,6264,166,0,166,0.0,1.0
1776,6266,495,442,53,0.893,0.107
1777,6268,11481,7839,3642,0.683,0.317
1778,6269,9844,9829,15,0.998,0.002
1779,6277,4140,806,3334,0.195,0.805
1780,6278,4454,0,4454,0.0,1.0
1781,6279,6041,1530,4511,0.253,0.747
1782,6280,3162,1373,1789,0.434,0.566
1783,6281,6930,390,6540,0.056,0.944
1784,6282,1096,0,1096,0.0,1.0
1785,6320,27617,27617,0,1.0,0.0
1786,6330,3282,1131,2151,0.345,0.655
1787,6331,5137,35,5102,0.007,0.993
1788,6332,258,140,118,0.543,0.457
1789,6333,6607,4705,1902,0.712,0.288
1790,6334,2592,602,1990,0.232,0.768
1791,6335,6729,4996,1733,0.742,0.258
1792,6336,84,0,84,0.0,1.0
1793,6339,8302,3815,4487,0.46,0.54
1794,6340,31242,30208,1034,0.967,0.033
1795,6350,67,0,67,0.0,1.0
1796,6351,16301,6884,9417,0.422,0.578
1797,6353,162,162,0,1.0,0.0
1798,6354,6141,4019,2122,0.654,0.346
1799,6355,12985,12184,801,0.938,0.062
1800,6357,12552,12547,5,1.0,0.0
1801,6359,5313,0,5313,0.0,1.0
1802,6360,37541,36336,1205,0.968,0.032
1803,6365,4720,670,4050,0.142,0.858
1804,6370,7429,4797,2632,0.646,0.354
1805,6371,9952,5567,4385,0.559,0.441
1806,6373,345,0,345,0.0,1.0
1807,6374,8373,4821,3552,0.576,0.424
1808,6375,3660,2935,725,0.802,0.198
1809,6376,57,57,0,1.0,0.0
1810,6377,2962,0,2962,0.0,1.0
1811,6378,5399,2697,2702,0.5,0.5
1812,6379,9038,8073,965,0.893,0.107
1813,6380,2862,2862,0,1.0,0.0
1814,6382,11947,10130,1817,0.848,0.152
1815,6384,2672,0,2672,0.0,1.0
1816,6385,15893,15149,744,0.953,0.047
1817,6387,213,213,0,1.0,0.0
1818,6389,41,41,0,1.0,0.0
1819,6390,236,0,236,0.0,1.0
1820,6401,19237,19237,0,1.0,0.0
1821,6403,6033,4991,1042,0.827,0.173
1822,6405,27860,27502,358,0.987,0.013
1823,6409,693,606,87,0.874,0.126
1824,6410,29161,27233,1928,0.934,0.066
1825,6412,3994,2090,1904,0.523,0.477
1826,6413,13235,12700,535,0.96,0.04
1827,6414,214,206,8,0.963,0.037
1828,6415,16857,9220,7637,0.547,0.453
1829,6416,14005,14005,0,1.0,0.0
1830,6417,4629,2666,1963,0.576,0.424
1831,6418,12914,12914,0,1.0,0.0
1832,6419,6525,528,5997,0.081,0.919
1833,6420,4182,283,3899,0.068,0.932
1834,6422,7388,4321,3067,0.585,0.415
1835,6423,5097,733,4364,0.144,0.856
1836,6424,12808,8139,4669,0.635,0.365
1837,6426,3245,2222,1023,0.685,0.315
1838,6437,22375,18386,3989,0.822,0.178
1839,6438,2550,801,1749,0.314,0.686
1840,6441,5438,1611,3827,0.296,0.704
1841,6442,2745,2745,0,1.0,0.0
1842,6443,18269,15817,2452,0.866,0.134
1843,6444,370,264,106,0.714,0.286
1844,6447,6404,3677,2727,0.574,0.426
1845,6450,36493,36080,413,0.989,0.011
1846,6451,24419,24419,0,1.0,0.0
1847,6455,3148,1402,1746,0.445,0.555
1848,6456,295,92,203,0.312,0.688
1849,6457,47648,45399,2249,0.953,0.047
1850,6460,38207,38207,0,1.0,0.0
1851,6461,14552,14552,0,1.0,0.0
1852,6467,157,157,0,1.0,0.0
1853,6468,19479,17729,1750,0.91,0.09
1854,6469,3209,1968,1241,0.613,0.387
1855,6470,16003,11215,4788,0.701,0.299
1856,6471,7720,7371,349,0.955,0.045
1857,6472,6853,5927,926,0.865,0.135
1858,6473,24388,24321,67,0.997,0.003
1859,6475,10242,8903,1339,0.869,0.131
1860,6477,13956,13956,0,1.0,0.0
1861,6478,12683,8386,4297,0.661,0.339
1862,6479,10431,10095,336,0.968,0.032
1863,6480,9508,7290,2218,0.767,0.233
1864,6481,1277,1277,0,1.0,0.0
1865,6482,11557,9036,2521,0.782,0.218
1866,6483,16540,16539,1,1.0,0.0
1867,6484,39559,39559,0,1.0,0.0
1868,6488,19904,17206,2698,0.864,0.136
1869,6489,32067,31197,870,0.973,0.027
1870,6492,45241,43522,1719,0.962,0.038
1871,6498,6963,4862,2101,0.698,0.302
1872,6510,2737,2737,0,1.0,0.0
1873,6511,53600,53600,0,1.0,0.0
1874,6512,29861,29861,0,1.0,0.0
1875,6513,38978,38978,0,1.0,0.0
1876,6514,26265,26030,235,0.991,0.009
1877,6515,17141,17141,0,1.0,0.0
1878,6516,55564,55564,0,1.0,0.0
1879,6517,14853,14853,0,1.0,0.0
1880,6518,19848,18648,1200,0.94,0.06
1881,6519,16428,16428,0,1.0,0.0
1882,6524,5563,1783,3780,0.321,0.679
1883,6525,8990,8317,673,0.925,0.075
1884,6604,30313,30313,0,1.0,0.0
1885,6605,23397,23397,0,1.0,0.0
1886,6606,46236,46236,0,1.0,0.0
1887,6607,7843,7843,0,1.0,0.0
1888,6608,13671,13671,0,1.0,0.0
1889,6610,22735,22735,0,1.0,0.0
1890,6611,36091,36054,37,0.999,0.001
1891,6612,7453,2930,4523,0.393,0.607
1892,6614,32929,32929,0,1.0,0.0
1893,6615,18453,18453,0,1.0,0.0
1894,6702,3654,3654,0,1.0,0.0
1895,6704,25139,25139,0,1.0,0.0
1896,6705,27122,27122,0,1.0,0.0
1897,6706,14324,14324,0,1.0,0.0
1898,6708,29418,29418,0,1.0,0.0
1899,6710,10715,10715,0,1.0,0.0
1900,6712,9376,8318,1058,0.887,0.113
1901,6716,16680,15179,1501,0.91,0.09
1902,6750,1446,637,809,0.441,0.559
1903,6751,3577,0,3577,0.0,1.0
1904,6752,1735,0,1735,0.0,1.0
1905,6754,1699,0,1699,0.0,1.0
1906,6755,1133,0,1133,0.0,1.0
1907,6756,2853,0,2853,0.0,1.0
1908,6757,2258,0,2258,0.0,1.0
1909,6758,354,0,354,0.0,1.0
1910,6759,5720,2029,3691,0.355,0.645
1911,6762,7561,5982,1579,0.791,0.209
1912,6763,2033,0,2033,0.0,1.0
1913,6770,31975,30846,1129,0.965,0.035
1914,6776,26889,21359,5530,0.794,0.206
1915,6777,1733,124,1609,0.072,0.928
1916,6778,1378,234,1144,0.17,0.83
1917,6779,8324,8324,0,1.0,0.0
1918,6782,2376,1340,1036,0.564,0.436
1919,6783,2228,0,2228,0.0,1.0
1920,6784,3689,751,2938,0.204,0.796
1921,6785,686,0,686,0.0,1.0
1922,6786,9867,8730,1137,0.885,0.115
1923,6787,7975,7522,453,0.943,0.057
1924,6790,36482,33064,3418,0.906,0.094
1925,6791,5666,1558,4108,0.275,0.725
1926,6793,1140,0,1140,0.0,1.0
1927,6794,1065,0,1065,0.0,1.0
1928,6795,14144,12108,2036,0.856,0.144
1929,6796,1009,0,1009,0.0,1.0
1930,6798,9984,3692,6292,0.37,0.63
1931,6801,18581,17255,1326,0.929,0.071
1932,6804,16466,15705,761,0.954,0.046
1933,6807,7150,7150,0,1.0,0.0
1934,6810,49482,47564,1918,0.961,0.039
1935,6811,31400,30665,735,0.977,0.023
1936,6812,13881,12807,1074,0.923,0.077
1937,6820,20732,20593,139,0.993,0.007
1938,6824,33900,32665,1235,0.964,0.036
1939,6825,21123,21110,13,0.999,0.001
1940,6830,24027,23787,240,0.99,0.01
1941,6831,14792,10012,4780,0.677,0.323
1942,6840,19738,19340,398,0.98,0.02
1943,6850,18078,18078,0,1.0,0.0
1944,6851,26703,26703,0,1.0,0.0
1945,6853,3646,3646,0,1.0,0.0
1946,6854,29100,29096,4,1.0,0.0
1947,6855,7892,7892,0,1.0,0.0
1948,6856,3,3,0,1.0,0.0
1949,6870,7316,7316,0,1.0,0.0
1950,6877,24677,22506,2171,0.912,0.088
1951,6878,8043,8043,0,1.0,0.0
1952,6880,26647,26616,31,0.999,0.001
1953,6883,10179,8672,1507,0.852,0.148
1954,6890,4306,4306,0,1.0,0.0
1955,6896,9110,2508,6602,0.275,0.725
1956,6897,18071,16196,1875,0.896,0.104
1957,6901,6828,6828,0,1.0,0.0
1958,6902,63406,63406,0,1.0,0.0
1959,6903,14499,13809,690,0.952,0.048
1960,6905,19649,19649,0,1.0,0.0
1961,6906,9088,9088,0,1.0,0.0
1962,6907,9016,9016,0,1.0,0.0
1963,7001,16305,16305,0,1.0,0.0
1964,7002,63031,63031,0,1.0,0.0
1965,7003,47312,47312,0,1.0,0.0
1966,7004,7440,7326,114,0.985,0.015
1967,7005,15269,13347,1922,0.874,0.126
1968,7006,24812,24812,0,1.0,0.0
1969,7008,22844,22844,0,1.0,0.0
1970,7009,12411,12411,0,1.0,0.0
1971,7010,23594,23594,0,1.0,0.0
1972,7011,39710,39710,0,1.0,0.0
1973,7012,11703,11703,0,1.0,0.0
1974,7013,27051,27051,0,1.0,0.0
1975,7014,5184,5184,0,1.0,0.0
1976,7016,22625,22625,0,1.0,0.0
1977,7017,35945,35945,0,1.0,0.0
1978,7018,28322,28322,0,1.0,0.0
1979,7020,11513,11513,0,1.0,0.0
1980,7021,2091,2091,0,1.0,0.0
1981,7022,13835,13835,0,1.0,0.0
1982,7023,7318,7318,0,1.0,0.0
1983,7024,35353,35353,0,1.0,0.0
1984,7026,30555,30555,0,1.0,0.0
1985,7027,4226,4226,0,1.0,0.0
1986,7028,7618,7618,0,1.0,0.0
1987,7029,16026,16026,0,1.0,0.0
1988,7030,50005,50005,0,1.0,0.0
1989,7031,15392,15392,0,1.0,0.0
1990,7032,40684,40684,0,1.0,0.0
1991,7033,7914,7914,0,1.0,0.0
1992,7034,9360,9360,0,1.0,0.0
1993,7035,10607,10521,86,0.992,0.008
1994,7036,41970,41970,0,1.0,0.0
1995,7039,29358,29358,0,1.0,0.0
1996,7040,23876,23876,0,1.0,0.0
1997,7041,6868,6868,0,1.0,0.0
1998,7042,25599,25599,0,1.0,0.0
1999,7043,12138,12138,0,1.0,0.0
2000,7044,13584,13584,0,1.0,0.0
2001,7045,10127,9595,532,0.947,0.053
2002,7046,4194,4194,0,1.0,0.0
2003,7047,60773,60773,0,1.0,0.0
2004,7050,30074,30074,0,1.0,0.0
2005,7052,46182,46182,0,1.0,0.0
2006,7054,29305,29305,0,1.0,0.0
2007,7055,69816,69816,0,1.0,0.0
2008,7057,11335,11335,0,1.0,0.0
2009,7058,5372,5372,0,1.0,0.0
2010,7059,15311,14383,928,0.939,0.061
2011,7060,44998,44998,0,1.0,0.0
2012,7062,12949,12949,0,1.0,0.0
2013,7063,13538,13538,0,1.0,0.0
2014,7064,3723,3723,0,1.0,0.0
2015,7065,27346,27346,0,1.0,0.0
2016,7066,14756,14756,0,1.0,0.0
2017,7067,18036,18036,0,1.0,0.0
2018,7068,5819,5819,0,1.0,0.0
2019,7069,6157,6157,0,1.0,0.0
2020,7070,18061,18061,0,1.0,0.0
2021,7071,20554,20554,0,1.0,0.0
2022,7072,6127,6127,0,1.0,0.0
2023,7073,8913,8913,0,1.0,0.0
2024,7074,2708,2708,0,1.0,0.0
2025,7075,7626,7626,0,1.0,0.0
2026,7076,23480,23480,0,1.0,0.0
2027,7077,2766,2766,0,1.0,0.0
2028,7078,13250,13250,0,1.0,0.0
2029,7079,16316,16316,0,1.0,0.0
2030,7080,23377,23377,0,1.0,0.0
2031,7081,15808,15808,0,1.0,0.0
2032,7082,5384,5173,211,0.961,0.039
2033,7083,53053,53053,0,1.0,0.0
2034,7086,12554,12554,0,1.0,0.0
2035,7087,66515,66515,0,1.0,0.0
2036,7088,3606,3606,0,1.0,0.0
2037,7090,30338,30338,0,1.0,0.0
2038,7092,6730,6730,0,1.0,0.0
2039,7093,60884,60884,0,1.0,0.0
2040,7094,16264,16264,0,1.0,0.0
2041,7095,19844,19844,0,1.0,0.0
2042,7102,12579,12579,0,1.0,0.0
2043,7103,32698,32698,0,1.0,0.0
2044,7104,50478,50478,0,1.0,0.0
2045,7105,46983,46983,0,1.0,0.0
2046,7106,31298,31298,0,1.0,0.0
2047,7107,37650,37650,0,1.0,0.0
2048,7108,24386,24386,0,1.0,0.0
2049,7109,35897,35897,0,1.0,0.0
2050,7110,28351,28351,0,1.0,0.0
2051,7111,53942,53942,0,1.0,0.0
2052,7112,26417,26417,0,1.0,0.0
2053,7114,14748,14748,0,1.0,0.0
2054,7201,26263,26263,0,1.0,0.0
2055,7202,40849,40849,0,1.0,0.0
2056,7203,21085,21085,0,1.0,0.0
2057,7204,13297,13297,0,1.0,0.0
2058,7205,21398,21398,0,1.0,0.0
2059,7206,26636,26636,0,1.0,0.0
2060,7208,31219,31219,0,1.0,0.0
2061,7302,36352,36352,0,1.0,0.0
2062,7304,41233,41233,0,1.0,0.0
2063,7305,60104,60104,0,1.0,0.0
2064,7306,52669,52669,0,1.0,0.0
2065,7307,43812,43812,0,1.0,0.0
2066,7310,12838,12838,0,1.0,0.0
2067,7311,522,522,0,1.0,0.0
2068,7401,6494,6494,0,1.0,0.0
2069,7403,7603,7004,599,0.921,0.079
2070,7405,17701,14461,3240,0.817,0.183
2071,7407,19403,19403,0,1.0,0.0
2072,7410,32457,32457,0,1.0,0.0
2073,7416,5781,5362,419,0.928,0.072
2074,7417,10580,10580,0,1.0,0.0
2075,7418,2249,1266,983,0.563,0.437
2076,7419,9160,8495,665,0.927,0.073
2077,7420,4942,4942,0,1.0,0.0
2078,7421,7439,5078,2361,0.683,0.317
2079,7422,6616,5811,805,0.878,0.122
2080,7423,4078,4078,0,1.0,0.0
2081,7424,26222,26222,0,1.0,0.0
2082,7430,25890,24971,919,0.965,0.035
2083,7432,7128,7128,0,1.0,0.0
2084,7435,2405,971,1434,0.404,0.596
2085,7436,12754,12754,0,1.0,0.0
2086,7438,11559,10185,1374,0.881,0.119
2087,7439,2456,2410,46,0.981,0.019
2088,7440,4494,4494,0,1.0,0.0
2089,7442,11097,11097,0,1.0,0.0
2090,7444,11046,11021,25,0.998,0.002
2091,7446,14484,14484,0,1.0,0.0
2092,7450,24985,24985,0,1.0,0.0
2093,7452,11601,11601,0,1.0,0.0
2094,7456,12211,9539,2672,0.781,0.219
2095,7457,3559,3559,0,1.0,0.0
2096,7458,11360,11360,0,1.0,0.0
2097,7460,3457,670,2787,0.194,0.806
2098,7461,19563,8142,11421,0.416,0.584
2099,7462,6885,5773,1112,0.838,0.162
2100,7463,9615,9615,0,1.0,0.0
2101,7465,6244,5941,303,0.951,0.049
2102,7470,54717,54717,0,1.0,0.0
2103,7480,16122,11008,5114,0.683,0.317
2104,7481,16716,16716,0,1.0,0.0
2105,7495,0,0,0,,
2106,7501,33543,33543,0,1.0,0.0
2107,7502,15406,15406,0,1.0,0.0
2108,7503,18723,18723,0,1.0,0.0
2109,7504,12882,12882,0,1.0,0.0
2110,7505,2256,2256,0,1.0,0.0
2111,7506,18791,18791,0,1.0,0.0
2112,7508,22600,22600,0,1.0,0.0
2113,7512,10804,10804,0,1.0,0.0
2114,7513,11508,11508,0,1.0,0.0
2115,7514,18289,18289,0,1.0,0.0
2116,7522,20883,20883,0,1.0,0.0
2117,7524,12709,12709,0,1.0,0.0
2118,7601,43010,43010,0,1.0,0.0
2119,7603,8187,8187,0,1.0,0.0
2120,7604,11842,11842,0,1.0,0.0
2121,7605,8950,8950,0,1.0,0.0
2122,7606,2310,2310,0,1.0,0.0
2123,7607,9555,9555,0,1.0,0.0
2124,7608,67,67,0,1.0,0.0
2125,7620,1849,1849,0,1.0,0.0
2126,7621,26761,26761,0,1.0,0.0
2127,7624,8373,8373,0,1.0,0.0
2128,7626,8537,8537,0,1.0,0.0
2129,7627,4881,4881,0,1.0,0.0
2130,7628,17433,17433,0,1.0,0.0
2131,7630,7379,7379,0,1.0,0.0
2132,7631,27119,27119,0,1.0,0.0
2133,7632,5309,5309,0,1.0,0.0
2134,7640,4664,4664,0,1.0,0.0
2135,7641,3382,3382,0,1.0,0.0
2136,7642,10207,10207,0,1.0,0.0
2137,7643,10626,10626,0,1.0,0.0
2138,7644,24136,24136,0,1.0,0.0
2139,7645,7832,7832,0,1.0,0.0
2140,7646,16341,16341,0,1.0,0.0
2141,7647,5152,5152,0,1.0,0.0
2142,7648,5730,5730,0,1.0,0.0
2143,7649,7978,7978,0,1.0,0.0
2144,7650,19601,19601,0,1.0,0.0
2145,7652,26342,26342,0,1.0,0.0
2146,7656,8669,8669,0,1.0,0.0
2147,7657,11032,11032,0,1.0,0.0
2148,7660,12729,12729,0,1.0,0.0
2149,7661,11340,11340,0,1.0,0.0
2150,7662,5530,5530,0,1.0,0.0
2151,7663,13659,13659,0,1.0,0.0
2152,7666,39776,39776,0,1.0,0.0
2153,7670,14573,14573,0,1.0,0.0
2154,7675,26339,26339,0,1.0,0.0
2155,7676,9075,9075,0,1.0,0.0
2156,7677,5730,5730,0,1.0,0.0
2157,7701,23813,23813,0,1.0,0.0
2158,7702,3809,3809,0,1.0,0.0
2159,7703,690,690,0,1.0,0.0
2160,7704,6133,6133,0,1.0,0.0
2161,7711,1533,1533,0,1.0,0.0
2162,7712,39158,39154,4,1.0,0.0
2163,7716,8574,8574,0,1.0,0.0
2164,7717,1901,1901,0,1.0,0.0
2165,7718,6263,6263,0,1.0,0.0
2166,7719,21538,21320,218,0.99,0.01
2167,7720,4298,4298,0,1.0,0.0
2168,7721,2974,2974,0,1.0,0.0
2169,7722,10209,7639,2570,0.748,0.252
2170,7723,1020,1020,0,1.0,0.0
2171,7724,21710,21695,15,0.999,0.001
2172,7726,42508,41142,1366,0.968,0.032
2173,7727,7050,5897,1153,0.836,0.164
2174,7728,56257,53949,2308,0.959,0.041
2175,7730,17396,17396,0,1.0,0.0
2176,7731,38304,35953,2351,0.939,0.061
2177,7732,5189,5189,0,1.0,0.0
2178,7733,16849,16764,85,0.995,0.005
2179,7734,13269,13269,0,1.0,0.0
2180,7735,19569,19569,0,1.0,0.0
2181,7737,4264,4264,0,1.0,0.0
2182,7738,6095,5988,107,0.982,0.018
2183,7739,5938,5938,0,1.0,0.0
2184,7740,31038,31038,0,1.0,0.0
2185,7746,18666,18666,0,1.0,0.0
2186,7747,30770,30770,0,1.0,0.0
2187,7748,28030,28030,0,1.0,0.0
2188,7750,3279,3279,0,1.0,0.0
2189,7751,19736,19736,0,1.0,0.0
2190,7753,37554,37315,239,0.994,0.006
2191,7755,6363,6363,0,1.0,0.0
2192,7756,3342,3342,0,1.0,0.0
2193,7757,5356,5356,0,1.0,0.0
2194,7758,4967,4967,0,1.0,0.0
2195,7760,9283,9283,0,1.0,0.0
2196,7762,8403,8403,0,1.0,0.0
2197,7764,8097,8097,0,1.0,0.0
2198,7801,25386,25334,52,0.998,0.002
2199,7803,3651,3651,0,1.0,0.0
2200,7820,39,0,39,0.0,1.0
2201,7821,9193,1375,7818,0.15,0.85
2202,7822,887,0,887,0.0,1.0
2203,7823,7571,3819,3752,0.504,0.496
2204,7825,9555,0,9555,0.0,1.0
2205,7826,6180,0,6180,0.0,1.0
2206,7827,4244,0,4244,0.0,1.0
2207,7828,14150,13140,1010,0.929,0.071
2208,7830,6503,0,6503,0.0,1.0
2209,7832,3903,249,3654,0.064,0.936
2210,7833,157,0,157,0.0,1.0
2211,7834,17722,17722,0,1.0,0.0
2212,7836,12568,11409,1159,0.908,0.092
2213,7838,3568,569,2999,0.159,0.841
2214,7840,29849,25432,4417,0.852,0.148
2215,7842,130,103,27,0.792,0.208
2216,7843,12241,12094,147,0.988,0.012
2217,7846,89,0,89,0.0,1.0
2218,7847,1670,1602,68,0.959,0.041
2219,7848,5026,1889,3137,0.376,0.624
2220,7849,9054,8947,107,0.988,0.012
2221,7850,6436,6436,0,1.0,0.0
2222,7851,119,0,119,0.0,1.0
2223,7852,3609,3512,97,0.973,0.027
2224,7853,13325,7809,5516,0.586,0.414
2225,7856,3944,3871,73,0.981,0.019
2226,7857,3244,3244,0,1.0,0.0
2227,7860,26288,11862,14426,0.451,0.549
2228,7863,4332,1195,3137,0.276,0.724
2229,7865,2189,288,1901,0.132,0.868
2230,7866,22098,20270,1828,0.917,0.083
2231,7869,25291,24880,411,0.984,0.016
2232,7870,26,0,26,0.0,1.0
2233,7871,21165,16296,4869,0.77,0.23
2234,7874,8905,8435,470,0.947,0.053
2235,7876,10619,10619,0,1.0,0.0
2236,7878,934,934,0,1.0,0.0
2237,7880,192,192,0,1.0,0.0
2238,7881,16,0,16,0.0,1.0
2239,7882,14492,10256,4236,0.708,0.292
2240,7885,10078,9456,622,0.938,0.062
2241,7901,22806,22806,0,1.0,0.0
2242,7920,26747,24944,1803,0.933,0.067
2243,7921,7621,6388,1233,0.838,0.162
2244,7922,12246,12246,0,1.0,0.0
2245,7924,7534,5879,1655,0.78,0.22
2246,7926,120,120,0,1.0,0.0
2247,7927,3403,3403,0,1.0,0.0
2248,7928,19144,18683,461,0.976,0.024
2249,7930,8559,4710,3849,0.55,0.45
2250,7931,3296,737,2559,0.224,0.776
2251,7932,9868,9868,0,1.0,0.0
2252,7933,3251,3038,213,0.934,0.066
2253,7934,1501,1105,396,0.736,0.264
2254,7935,313,176,137,0.562,0.438
2255,7936,11157,11157,0,1.0,0.0
2256,7939,228,228,0,1.0,0.0
2257,7940,17278,17278,0,1.0,0.0
2258,7945,9539,6882,2657,0.721,0.279
2259,7946,3144,3104,40,0.987,0.013
2260,7950,19564,19564,0,1.0,0.0
2261,7960,43747,40610,3137,0.928,0.072
2262,7961,4,4,0,1.0,0.0
2263,7970,117,117,0,1.0,0.0
2264,7974,11768,11768,0,1.0,0.0
2265,7976,754,0,754,0.0,1.0
2266,7977,669,552,117,0.825,0.175
2267,7979,589,0,589,0.0,1.0
2268,7980,2307,2224,83,0.964,0.036
2269,7981,8865,8865,0,1.0,0.0
2270,8001,844,0,844,0.0,1.0
2271,8002,22274,22274,0,1.0,0.0
2272,8003,30629,30629,0,1.0,0.0
2273,8004,12350,11924,426,0.966,0.034
2274,8005,22448,21079,1369,0.939,0.061
2275,8006,518,518,0,1.0,0.0
2276,8007,5250,5250,0,1.0,0.0
2277,8008,6975,6903,72,0.99,0.01
2278,8009,12854,11604,1250,0.903,0.097
2279,8010,11539,11539,0,1.0,0.0
2280,8011,33,0,33,0.0,1.0
2281,8012,38992,38992,0,1.0,0.0
2282,8014,504,444,60,0.881,0.119
2283,8015,20763,19137,1626,0.922,0.078
2284,8016,33540,33125,415,0.988,0.012
2285,8019,925,0,925,0.0,1.0
2286,8020,2201,1802,399,0.819,0.181
2287,8021,44833,44833,0,1.0,0.0
2288,8022,8783,6497,2286,0.74,0.26
2289,8023,451,451,0,1.0,0.0
2290,8026,2274,2274,0,1.0,0.0
2291,8027,4888,4685,203,0.958,0.042
2292,8028,20078,18984,1094,0.946,0.054
2293,8029,4784,4784,0,1.0,0.0
2294,8030,13410,13410,0,1.0,0.0
2295,8031,11584,11584,0,1.0,0.0
2296,8033,16261,16261,0,1.0,0.0
2297,8034,18151,18151,0,1.0,0.0
2298,8035,7566,7566,0,1.0,0.0
2299,8036,5917,5287,630,0.894,0.106
2300,8037,24308,15103,9205,0.621,0.379
2301,8038,124,0,124,0.0,1.0
2302,8039,137,0,137,0.0,1.0
2303,8041,1002,65,937,0.065,0.935
2304,8042,203,0,203,0.0,1.0
2305,8043,29131,29131,0,1.0,0.0
2306,8045,2909,2909,0,1.0,0.0
2307,8046,31587,31587,0,1.0,0.0
2308,8048,12495,11848,647,0.948,0.052
2309,8049,5350,5350,0,1.0,0.0
2310,8050,24285,24187,98,0.996,0.004
2311,8051,10758,10758,0,1.0,0.0
2312,8052,19172,19172,0,1.0,0.0
2313,8053,45538,44199,1339,0.971,0.029
2314,8054,41864,41864,0,1.0,0.0
2315,8055,27179,25604,1575,0.942,0.058
2316,8056,4736,4167,569,0.88,0.12
2317,8057,21090,21090,0,1.0,0.0
2318,8059,5612,5612,0,1.0,0.0
2319,8060,24713,23771,942,0.962,0.038
2320,8061,2672,2661,11,0.996,0.004
2321,8062,15756,12532,3224,0.795,0.205
2322,8063,3102,3102,0,1.0,0.0
2323,8064,311,0,311,0.0,1.0
2324,8065,7398,7398,0,1.0,0.0
2325,8066,8437,8437,0,1.0,0.0
2326,8067,1635,0,1635,0.0,1.0
2327,8068,6727,4697,2030,0.698,0.302
2328,8069,13076,12167,909,0.93,0.07
2329,8070,13059,11044,2015,0.846,0.154
2330,8071,9551,9520,31,0.997,0.003
2331,8072,225,0,225,0.0,1.0
2332,8073,203,203,0,1.0,0.0
2333,8074,58,19,39,0.328,0.672
2334,8075,28894,28894,0,1.0,0.0
2335,8077,18307,18307,0,1.0,0.0
2336,8078,8385,8385,0,1.0,0.0
2337,8079,10987,5724,5263,0.521,0.479
2338,8080,37433,35980,1453,0.961,0.039
2339,8081,50589,48136,2453,0.952,0.048
2340,8083,9455,9455,0,1.0,0.0
2341,8084,7040,7040,0,1.0,0.0
2342,8085,18737,15669,3068,0.836,0.164
2343,8086,7699,7092,607,0.921,0.079
2344,8087,24104,21473,2631,0.891,0.109
2345,8088,24664,16386,8278,0.664,0.336
2346,8089,4253,2990,1263,0.703,0.297
2347,8090,8358,8358,0,1.0,0.0
2348,8091,5357,5357,0,1.0,0.0
2349,8092,3673,2515,1158,0.685,0.315
2350,8093,9741,9741,0,1.0,0.0
2351,8094,39940,35189,4751,0.881,0.119
2352,8095,236,0,236,0.0,1.0
2353,8096,36116,36116,0,1.0,0.0
2354,8097,3293,3293,0,1.0,0.0
2355,8098,9090,4195,4895,0.461,0.539
2356,8102,7565,7565,0,1.0,0.0
2357,8103,15190,15190,0,1.0,0.0
2358,8104,23851,23851,0,1.0,0.0
2359,8105,29077,29077,0,1.0,0.0
2360,8106,9874,9874,0,1.0,0.0
2361,8107,13675,13675,0,1.0,0.0
2362,8108,18045,18045,0,1.0,0.0
2363,8109,22407,22407,0,1.0,0.0
2364,8110,19008,19008,0,1.0,0.0
2365,8201,10007,9735,272,0.973,0.027
2366,8202,1444,1315,129,0.911,0.089
2367,8203,9454,9450,4,1.0,0.0
2368,8204,18557,17018,1539,0.917,0.083
2369,8205,28626,26978,1648,0.942,0.058
2370,8210,17167,10297,6870,0.6,0.4
2371,8212,294,281,13,0.956,0.044
2372,8215,13442,7781,5661,0.579,0.421
2373,8217,70,0,70,0.0,1.0
2374,8221,7092,6956,136,0.981,0.019
2375,8223,4125,3773,352,0.915,0.085
2376,8224,573,0,573,0.0,1.0
2377,8225,8659,8624,35,0.996,0.004
2378,8226,11701,11685,16,0.999,0.001
2379,8230,5599,4445,1154,0.794,0.206
2380,8232,19292,19292,0,1.0,0.0
2381,8234,42532,39222,3310,0.922,0.078
2382,8240,2371,2371,0,1.0,0.0
2383,8241,1103,563,540,0.51,0.49
2384,8242,3216,3000,216,0.933,0.067
2385,8243,2114,1997,117,0.945,0.055
2386,8244,10849,10795,54,0.995,0.005
2387,8246,92,0,92,0.0,1.0
2388,8247,925,895,30,0.968,0.032
2389,8248,158,0,158,0.0,1.0
2390,8251,10364,9885,479,0.954,0.046
2391,8260,13661,13616,45,0.997,0.003
2392,8270,8492,2081,6411,0.245,0.755
2393,8302,46872,34788,12084,0.742,0.258
2394,8310,1670,607,1063,0.363,0.637
2395,8311,2057,0,2057,0.0,1.0
2396,8312,7875,7701,174,0.978,0.022
2397,8314,2511,0,2511,0.0,1.0
2398,8316,400,0,400,0.0,1.0
2399,8317,1344,0,1344,0.0,1.0
2400,8318,12702,2150,10552,0.169,0.831
2401,8319,1253,0,1253,0.0,1.0
2402,8320,1256,0,1256,0.0,1.0
2403,8321,247,0,247,0.0,1.0
2404,8322,10524,6356,4168,0.604,0.396
2405,8323,804,0,804,0.0,1.0
2406,8324,526,0,526,0.0,1.0
2407,8326,1761,1581,180,0.898,0.102
2408,8327,3070,0,3070,0.0,1.0
2409,8328,1347,1208,139,0.897,0.103
2410,8329,221,0,221,0.0,1.0
2411,8330,28167,20083,8084,0.713,0.287
2412,8332,36768,29819,6949,0.811,0.189
2413,8340,979,0,979,0.0,1.0
2414,8341,2239,2038,201,0.91,0.09
2415,8343,5030,1533,3497,0.305,0.695
2416,8344,5847,3166,2681,0.541,0.459
2417,8345,805,0,805,0.0,1.0
2418,8346,843,0,843,0.0,1.0
2419,8348,275,0,275,0.0,1.0
2420,8349,2347,0,2347,0.0,1.0
2421,8350,825,0,825,0.0,1.0
2422,8352,448,448,0,1.0,0.0
2423,8353,516,240,276,0.465,0.535
2424,8360,43355,40014,3341,0.923,0.077
2425,8361,17352,15257,2095,0.879,0.121
2426,8401,39554,39554,0,1.0,0.0
2427,8402,6354,6354,0,1.0,0.0
2428,8403,997,997,0,1.0,0.0
2429,8406,10650,10650,0,1.0,0.0
2430,8501,6582,3538,3044,0.538,0.462
2431,8502,11317,10814,503,0.956,0.044
2432,8505,17736,16414,1322,0.925,0.075
2433,8510,5231,1887,3344,0.361,0.639
2434,8511,826,619,207,0.749,0.251
2435,8512,10105,8889,1216,0.88,0.12
2436,8514,4477,1272,3205,0.284,0.716
2437,8515,4637,2465,2172,0.532,0.468
2438,8518,4986,4986,0,1.0,0.0
2439,8520,27869,26705,1164,0.958,0.042
2440,8525,4767,2168,2599,0.455,0.545
2441,8527,54392,48738,5654,0.896,0.104
2442,8528,315,207,108,0.657,0.343
2443,8530,8071,5093,2978,0.631,0.369
2444,8533,6945,4599,2346,0.662,0.338
2445,8534,12929,10386,2543,0.803,0.197
2446,8535,5385,1892,3493,0.351,0.649
2447,8536,20073,19970,103,0.995,0.005
2448,8540,47115,43658,3457,0.927,0.073
2449,8542,5189,5189,0,1.0,0.0
2450,8550,19445,18988,457,0.976,0.024
2451,8551,5532,2609,2923,0.472,0.528
2452,8553,682,682,0,1.0,0.0
2453,8554,3818,3818,0,1.0,0.0
2454,8555,877,0,877,0.0,1.0
2455,8558,6629,4603,2026,0.694,0.306
2456,8559,4982,438,4544,0.088,0.912
2457,8560,3656,2461,1195,0.673,0.327
2458,8561,226,161,65,0.712,0.288
2459,8562,5371,3773,1598,0.702,0.298
2460,8608,983,983,0,1.0,0.0
2461,8609,13546,13546,0,1.0,0.0
2462,8610,30468,30468,0,1.0,0.0
2463,8611,28038,28038,0,1.0,0.0
2464,8618,38229,38229,0,1.0,0.0
2465,8619,22723,22723,0,1.0,0.0
2466,8620,14693,13803,890,0.939,0.061
2467,8628,9054,9054,0,1.0,0.0
2468,8629,12331,12331,0,1.0,0.0
2469,8638,22832,22832,0,1.0,0.0
2470,8640,7716,7631,85,0.989,0.011
2471,8641,3553,3553,0,1.0,0.0
2472,8648,32263,31965,298,0.991,0.009
2473,8690,18567,18567,0,1.0,0.0
2474,8691,15104,13650,1454,0.904,0.096
2475,8701,92843,92663,180,0.998,0.002
2476,8720,843,843,0,1.0,0.0
2477,8721,20512,20468,44,0.998,0.002
2478,8722,11045,11045,0,1.0,0.0
2479,8723,31641,31641,0,1.0,0.0
2480,8724,42352,42305,47,0.999,0.001
2481,8730,4774,4774,0,1.0,0.0
2482,8731,20009,19272,737,0.963,0.037
2483,8732,1484,1484,0,1.0,0.0
2484,8733,2752,2741,11,0.996,0.004
2485,8734,7651,6554,1097,0.857,0.143
2486,8735,3114,3114,0,1.0,0.0
2487,8736,12578,12578,0,1.0,0.0
2488,8738,1042,1042,0,1.0,0.0
2489,8740,2010,2010,0,1.0,0.0
2490,8741,2488,2488,0,1.0,0.0
2491,8742,24405,24405,0,1.0,0.0
2492,8750,3528,3528,0,1.0,0.0
2493,8751,4212,4212,0,1.0,0.0
2494,8752,2074,2069,5,0.998,0.002
2495,8753,63678,63678,0,1.0,0.0
2496,8755,25302,25302,0,1.0,0.0
2497,8757,33217,33116,101,0.997,0.003
2498,8758,7043,6887,156,0.978,0.022
2499,8759,33263,32219,1044,0.969,0.031
2500,8801,8551,5444,3107,0.637,0.363
2501,8802,4067,0,4067,0.0,1.0
2502,8804,2771,1219,1552,0.44,0.56
2503,8805,12254,12254,0,1.0,0.0
2504,8807,37972,37756,216,0.994,0.006
2505,8808,86,86,0,1.0,0.0
2506,8809,6421,6068,353,0.945,0.055
2507,8810,8401,8369,32,0.996,0.004
2508,8812,14296,14296,0,1.0,0.0
2509,8816,46298,45886,412,0.991,0.009
2510,8817,44621,44621,0,1.0,0.0
2511,8820,39590,39590,0,1.0,0.0
2512,8821,354,354,0,1.0,0.0
2513,8822,30354,22578,7776,0.744,0.256
2514,8823,9016,8896,120,0.987,0.013
2515,8824,12115,12115,0,1.0,0.0
2516,8825,4707,1108,3599,0.235,0.765
2517,8826,5838,2467,3371,0.423,0.577
2518,8827,4629,1447,3182,0.313,0.687
2519,8828,2178,2178,0,1.0,0.0
2520,8829,3725,3725,0,1.0,0.0
2521,8830,18459,18459,0,1.0,0.0
2522,8831,45620,43160,2460,0.946,0.054
2523,8832,2863,2863,0,1.0,0.0
2524,8833,8796,3326,5470,0.378,0.622
2525,8835,10344,10344,0,1.0,0.0
2526,8836,3845,3574,271,0.93,0.07
2527,8837,15847,15847,0,1.0,0.0
2528,8840,16558,16558,0,1.0,0.0
2529,8844,38367,34503,3864,0.899,0.101
2530,8846,13635,13635,0,1.0,0.0
2531,8848,8435,1280,7155,0.152,0.848
2532,8850,8281,8281,0,1.0,0.0
2533,8852,17220,16935,285,0.983,0.017
2534,8853,5247,3689,1558,0.703,0.297
2535,8854,55961,55961,0,1.0,0.0
2536,8857,39898,39104,794,0.98,0.02
2537,8858,144,0,144,0.0,1.0
2538,8859,21526,21526,0,1.0,0.0
2539,8861,53099,53099,0,1.0,0.0
2540,8863,12320,12320,0,1.0,0.0
2541,8865,29840,25956,3884,0.87,0.13
2542,8867,5042,0,5042,0.0,1.0
2543,8869,6881,6881,0,1.0,0.0
2544,8872,18811,18811,0,1.0,0.0
2545,8873,49921,48849,1072,0.979,0.021
2546,8876,22179,21771,408,0.982,0.018
2547,8879,23537,23537,0,1.0,0.0
2548,8880,4563,4563,0,1.0,0.0
2549,8882,16008,16008,0,1.0,0.0
2550,8884,8257,8257,0,1.0,0.0
2551,8886,7077,5268,1809,0.744,0.256
2552,8887,1106,1094,12,0.989,0.011
2553,8889,10063,6767,3296,0.672,0.328
2554,8890,17,17,0,1.0,0.0
2555,8901,55223,55223,0,1.0,0.0
2556,8902,41153,40972,181,0.996,0.004
2557,8904,13982,13982,0,1.0,0.0
2558,10001,21102,21102,0,1.0,0.0
2559,10002,81410,81410,0,1.0,0.0
2560,10003,56024,56024,0,1.0,0.0
2561,10004,3089,3089,0,1.0,0.0
2562,10005,7135,7135,0,1.0,0.0
2563,10006,3011,3011,0,1.0,0.0
2564,10007,6988,6988,0,1.0,0.0
2565,10009,61347,61347,0,1.0,0.0
2566,10010,31834,31834,0,1.0,0.0
2567,10011,50984,50984,0,1.0,0.0
2568,10012,24090,24090,0,1.0,0.0
2569,10013,27700,27700,0,1.0,0.0
2570,10014,31959,31959,0,1.0,0.0
2571,10016,54183,54183,0,1.0,0.0
2572,10017,16575,16575,0,1.0,0.0
2573,10018,5229,5229,0,1.0,0.0
2574,10019,42870,42870,0,1.0,0.0
2575,10020,0,0,0,,
2576,10021,43631,43631,0,1.0,0.0
2577,10022,31924,31924,0,1.0,0.0
2578,10023,60998,60998,0,1.0,0.0
2579,10024,59283,59283,0,1.0,0.0
2580,10025,94600,94600,0,1.0,0.0
2581,10026,34003,34003,0,1.0,0.0
2582,10027,59707,59707,0,1.0,0.0
2583,10028,45141,45141,0,1.0,0.0
2584,10029,76003,76003,0,1.0,0.0
2585,10030,26999,26999,0,1.0,0.0
2586,10031,56438,56438,0,1.0,0.0
2587,10032,57331,57331,0,1.0,0.0
2588,10033,53926,53926,0,1.0,0.0
2589,10034,38908,38908,0,1.0,0.0
2590,10035,33969,33969,0,1.0,0.0
2591,10036,24711,24711,0,1.0,0.0
2592,10037,17416,17416,0,1.0,0.0
2593,10038,20300,20300,0,1.0,0.0
2594,10039,24527,24527,0,1.0,0.0
2595,10040,41905,41905,0,1.0,0.0
2596,10044,11661,11661,0,1.0,0.0
2597,10065,32270,32270,0,1.0,0.0
2598,10069,5199,5199,0,1.0,0.0
2599,10075,26121,26121,0,1.0,0.0
2600,10103,3,3,0,1.0,0.0
2601,10110,0,0,0,,
2602,10111,0,0,0,,
2603,10112,0,0,0,,
2604,10115,0,0,0,,
2605,10119,92,92,0,1.0,0.0
2606,10128,60453,60453,0,1.0,0.0
2607,10152,0,0,0,,
2608,10153,0,0,0,,
2609,10154,0,0,0,,
2610,10162,1685,1685,0,1.0,0.0
2611,10165,2,2,0,1.0,0.0
2612,10167,0,0,0,,
2613,10168,0,0,0,,
2614,10169,0,0,0,,
2615,10170,2,2,0,1.0,0.0
2616,10171,0,0,0,,
2617,10172,0,0,0,,
2618,10173,2,2,0,1.0,0.0
2619,10174,0,0,0,,
2620,10177,0,0,0,,
2621,10199,9,9,0,1.0,0.0
2622,10271,0,0,0,,
2623,10278,0,0,0,,
2624,10279,0,0,0,,
2625,10280,7853,7853,0,1.0,0.0
2626,10282,4783,4783,0,1.0,0.0
2627,10301,39706,39706,0,1.0,0.0
2628,10302,19088,19088,0,1.0,0.0
2629,10303,26337,26337,0,1.0,0.0
2630,10304,42193,42193,0,1.0,0.0
2631,10305,41749,41749,0,1.0,0.0
2632,10306,55909,55909,0,1.0,0.0
2633,10307,14096,14096,0,1.0,0.0
2634,10308,27357,27357,0,1.0,0.0
2635,10309,32519,32519,0,1.0,0.0
2636,10310,24962,24962,0,1.0,0.0
2637,10311,0,0,0,,
2638,10312,59304,59304,0,1.0,0.0
2639,10314,85510,85510,0,1.0,0.0
2640,10451,45713,45713,0,1.0,0.0
2641,10452,75371,75371,0,1.0,0.0
2642,10453,78309,78309,0,1.0,0.0
2643,10454,37337,37337,0,1.0,0.0
2644,10455,39665,39665,0,1.0,0.0
2645,10456,86547,86547,0,1.0,0.0
2646,10457,70496,70496,0,1.0,0.0
2647,10458,79492,79492,0,1.0,0.0
2648,10459,47308,47308,0,1.0,0.0
2649,10460,57311,57311,0,1.0,0.0
2650,10461,50502,50502,0,1.0,0.0
2651,10462,75784,75784,0,1.0,0.0
2652,10463,67970,67970,0,1.0,0.0
2653,10464,4534,4495,39,0.991,0.009
2654,10465,42230,42230,0,1.0,0.0
2655,10466,67813,67813,0,1.0,0.0
2656,10467,97060,97060,0,1.0,0.0
2657,10468,76103,76103,0,1.0,0.0
2658,10469,66631,66631,0,1.0,0.0
2659,10470,15293,15293,0,1.0,0.0
2660,10471,22922,22922,0,1.0,0.0
2661,10472,66358,66358,0,1.0,0.0
2662,10473,58519,58519,0,1.0,0.0
2663,10474,12281,12281,0,1.0,0.0
2664,10475,40931,40931,0,1.0,0.0
2665,10501,1219,1136,83,0.932,0.068
2666,10502,5487,5487,0,1.0,0.0
2667,10503,108,108,0,1.0,0.0
2668,10504,7987,6370,1617,0.798,0.202
2669,10505,851,851,0,1.0,0.0
2670,10506,5790,2974,2816,0.514,0.486
2671,10507,6408,5553,855,0.867,0.133
2672,10509,19507,14586,4921,0.748,0.252
2673,10510,9988,9699,289,0.971,0.029
2674,10511,2246,2246,0,1.0,0.0
2675,10512,25590,20725,4865,0.81,0.19
2676,10514,11946,11476,470,0.961,0.039
2677,10516,5289,3276,2013,0.619,0.381
2678,10517,539,539,0,1.0,0.0
2679,10518,1268,904,364,0.713,0.287
2680,10519,316,195,121,0.617,0.383
2681,10520,12810,11345,1465,0.886,0.114
2682,10522,10875,10875,0,1.0,0.0
2683,10523,7444,7444,0,1.0,0.0
2684,10524,4421,1969,2452,0.445,0.555
2685,10526,1809,1722,87,0.952,0.048
2686,10527,908,908,0,1.0,0.0
2687,10528,12280,12280,0,1.0,0.0
2688,10530,12604,12604,0,1.0,0.0
2689,10532,4931,4931,0,1.0,0.0
2690,10533,7322,7322,0,1.0,0.0
2691,10535,555,555,0,1.0,0.0
2692,10536,10739,7886,2853,0.734,0.266
2693,10537,2416,2416,0,1.0,0.0
2694,10538,16597,16597,0,1.0,0.0
2695,10541,26339,25594,745,0.972,0.028
2696,10543,20135,20135,0,1.0,0.0
2697,10545,141,141,0,1.0,0.0
2698,10546,1277,1277,0,1.0,0.0
2699,10547,7647,7647,0,1.0,0.0
2700,10548,3487,3487,0,1.0,0.0
2701,10549,16638,15003,1635,0.902,0.098
2702,10550,37144,37144,0,1.0,0.0
2703,10552,19786,19786,0,1.0,0.0
2704,10553,10170,10170,0,1.0,0.0
2705,10560,4737,1671,3066,0.353,0.647
2706,10562,31796,30708,1088,0.966,0.034
2707,10566,23570,23570,0,1.0,0.0
2708,10567,19929,18998,931,0.953,0.047
2709,10570,12680,12433,247,0.981,0.019
2710,10573,38352,38348,4,1.0,0.0
2711,10576,5116,157,4959,0.031,0.969
2712,10577,6552,5552,1000,0.847,0.153
2713,10578,681,533,148,0.783,0.217
2714,10579,8675,6212,2463,0.716,0.284
2715,10580,17208,16605,603,0.965,0.035
2716,10583,38982,38982,0,1.0,0.0
2717,10588,2282,2282,0,1.0,0.0
2718,10589,8475,8169,306,0.964,0.036
2719,10590,6767,3820,2947,0.565,0.435
2720,10591,22540,22414,126,0.994,0.006
2721,10594,5117,5117,0,1.0,0.0
2722,10595,8195,8195,0,1.0,0.0
2723,10596,1729,1729,0,1.0,0.0
2724,10597,968,0,968,0.0,1.0
2725,10598,28647,26680,1967,0.931,0.069
2726,10601,11376,11376,0,1.0,0.0
2727,10603,17045,17045,0,1.0,0.0
2728,10604,11250,11196,54,0.995,0.005
2729,10605,18126,18126,0,1.0,0.0
2730,10606,16499,16499,0,1.0,0.0
2731,10607,6824,6824,0,1.0,0.0
2732,10701,63393,63393,0,1.0,0.0
2733,10703,20301,20301,0,1.0,0.0
2734,10704,30165,30165,0,1.0,0.0
2735,10705,38777,38777,0,1.0,0.0
2736,10706,8679,8679,0,1.0,0.0
2737,10707,10097,10097,0,1.0,0.0
2738,10708,21225,21225,0,1.0,0.0
2739,10709,9292,9292,0,1.0,0.0
2740,10710,25120,25120,0,1.0,0.0
2741,10801,40827,40827,0,1.0,0.0
2742,10803,12435,12435,0,1.0,0.0
2743,10804,14146,14146,0,1.0,0.0
2744,10805,18414,18414,0,1.0,0.0
2745,10901,23465,23165,300,0.987,0.013
2746,10910,21,0,21,0.0,1.0
2747,10911,2,0,2,0.0,1.0
2748,10913,5532,5532,0,1.0,0.0
2749,10914,414,0,414,0.0,1.0
2750,10915,119,0,119,0.0,1.0
2751,10916,4540,889,3651,0.196,0.804
2752,10917,1968,1640,328,0.833,0.167
2753,10918,11647,7102,4545,0.61,0.39
2754,10919,1040,270,770,0.26,0.74
2755,10920,8554,8554,0,1.0,0.0
2756,10921,4135,3176,959,0.768,0.232
2757,10922,1559,1482,77,0.951,0.049
2758,10923,8732,8732,0,1.0,0.0
2759,10924,13120,8228,4892,0.627,0.373
2760,10925,4539,4497,42,0.991,0.009
2761,10926,3203,3190,13,0.996,0.004
2762,10927,11910,11910,0,1.0,0.0
2763,10928,4175,4134,41,0.99,0.01
2764,10930,8958,8071,887,0.901,0.099
2765,10931,1023,710,313,0.694,0.306
2766,10932,60,13,47,0.217,0.783
2767,10933,473,0,473,0.0,1.0
2768,10940,48418,39929,8489,0.825,0.175
2769,10941,13779,10502,3277,0.762,0.238
2770,10950,47226,43883,3343,0.929,0.071
2771,10952,38917,38917,0,1.0,0.0
2772,10953,252,131,121,0.52,0.48
2773,10954,23045,23045,0,1.0,0.0
2774,10956,31521,31521,0,1.0,0.0
2775,10958,3291,1325,1966,0.403,0.597
2776,10960,15093,15093,0,1.0,0.0
2777,10962,5950,5950,0,1.0,0.0
2778,10963,4298,3111,1187,0.724,0.276
2779,10964,1472,1472,0,1.0,0.0
2780,10965,14791,14791,0,1.0,0.0
2781,10968,2353,2353,0,1.0,0.0
2782,10969,1267,0,1267,0.0,1.0
2783,10970,9993,9836,157,0.984,0.016
2784,10973,2126,238,1888,0.112,0.888
2785,10974,3152,3042,110,0.965,0.035
2786,10975,281,0,281,0.0,1.0
2787,10976,2258,2258,0,1.0,0.0
2788,10977,59048,59048,0,1.0,0.0
2789,10979,234,234,0,1.0,0.0
2790,10980,13383,12896,487,0.964,0.036
2791,10983,5532,5532,0,1.0,0.0
2792,10984,2842,2842,0,1.0,0.0
2793,10985,58,0,58,0.0,1.0
2794,10986,1974,1105,869,0.56,0.44
2795,10987,3395,0,3395,0.0,1.0
2796,10988,896,0,896,0.0,1.0
2797,10989,9293,9293,0,1.0,0.0
2798,10990,20631,11778,8853,0.571,0.429
2799,10992,9621,8932,689,0.928,0.072
2800,10993,4769,4769,0,1.0,0.0
2801,10994,7085,7085,0,1.0,0.0
2802,10996,6756,6525,231,0.966,0.034
2803,10998,3122,0,3122,0.0,1.0
2804,11001,26883,26883,0,1.0,0.0
2805,11003,41356,41356,0,1.0,0.0
2806,11004,14016,14016,0,1.0,0.0
2807,11005,1806,1806,0,1.0,0.0
2808,11010,23821,23821,0,1.0,0.0
2809,11020,5914,5914,0,1.0,0.0
2810,11021,17729,17729,0,1.0,0.0
2811,11023,9027,9027,0,1.0,0.0
2812,11024,8002,8002,0,1.0,0.0
2813,11030,17962,17962,0,1.0,0.0
2814,11040,40782,40782,0,1.0,0.0
2815,11042,520,520,0,1.0,0.0
2816,11050,30171,30171,0,1.0,0.0
2817,11096,8344,8344,0,1.0,0.0
2818,11101,25484,25484,0,1.0,0.0
2819,11102,34133,34133,0,1.0,0.0
2820,11103,38780,38780,0,1.0,0.0
2821,11104,27232,27232,0,1.0,0.0
2822,11105,36688,36688,0,1.0,0.0
2823,11106,38875,38875,0,1.0,0.0
2824,11109,3523,3523,0,1.0,0.0
2825,11201,51128,51128,0,1.0,0.0
2826,11203,76174,76174,0,1.0,0.0
2827,11204,78134,78134,0,1.0,0.0
2828,11205,40366,40366,0,1.0,0.0
2829,11206,81677,81677,0,1.0,0.0
2830,11207,93386,93386,0,1.0,0.0
2831,11208,94469,94469,0,1.0,0.0
2832,11209,68853,68853,0,1.0,0.0
2833,11210,62008,62008,0,1.0,0.0
2834,11211,90117,90117,0,1.0,0.0
2835,11212,84500,84500,0,1.0,0.0
2836,11213,63767,63767,0,1.0,0.0
2837,11214,88630,88630,0,1.0,0.0
2838,11215,63488,63488,0,1.0,0.0
2839,11216,54316,54316,0,1.0,0.0
2840,11217,35881,35881,0,1.0,0.0
2841,11218,75220,75220,0,1.0,0.0
2842,11219,92221,92221,0,1.0,0.0
2843,11220,99598,99598,0,1.0,0.0
2844,11221,78895,78895,0,1.0,0.0
2845,11222,36934,36934,0,1.0,0.0
2846,11223,78731,78731,0,1.0,0.0
2847,11224,47621,47621,0,1.0,0.0
2848,11225,56829,56829,0,1.0,0.0
2849,11226,101572,101572,0,1.0,0.0
2850,11228,41788,41788,0,1.0,0.0
2851,11229,80018,80018,0,1.0,0.0
2852,11230,86408,86408,0,1.0,0.0
2853,11231,33336,33336,0,1.0,0.0
2854,11232,28265,28265,0,1.0,0.0
2855,11233,67053,67053,0,1.0,0.0
2856,11234,87757,87720,37,1.0,0.0
2857,11235,79132,79132,0,1.0,0.0
2858,11236,93877,93877,0,1.0,0.0
2859,11237,49896,49896,0,1.0,0.0
2860,11238,49262,49262,0,1.0,0.0
2861,11239,13393,13393,0,1.0,0.0
2862,11351,0,0,0,,
2863,11354,54878,54878,0,1.0,0.0
2864,11355,85871,85871,0,1.0,0.0
2865,11356,23438,23438,0,1.0,0.0
2866,11357,39150,39150,0,1.0,0.0
2867,11358,37546,37546,0,1.0,0.0
2868,11359,0,0,0,,
2869,11360,18884,18884,0,1.0,0.0
2870,11361,28606,28606,0,1.0,0.0
2871,11362,17823,17823,0,1.0,0.0
2872,11363,6988,6988,0,1.0,0.0
2873,11364,34555,34555,0,1.0,0.0
2874,11365,42252,42252,0,1.0,0.0
2875,11366,13532,13532,0,1.0,0.0
2876,11367,41047,41047,0,1.0,0.0
2877,11368,109931,109931,0,1.0,0.0
2878,11369,38615,38615,0,1.0,0.0
2879,11370,39688,39688,0,1.0,0.0
2880,11371,0,0,0,,
2881,11372,66636,66636,0,1.0,0.0
2882,11373,100820,100820,0,1.0,0.0
2883,11374,43600,43600,0,1.0,0.0
2884,11375,68733,68733,0,1.0,0.0
2885,11377,89830,89830,0,1.0,0.0
2886,11378,34981,34981,0,1.0,0.0
2887,11379,34821,34821,0,1.0,0.0
2888,11385,98592,98592,0,1.0,0.0
2889,11411,18556,18556,0,1.0,0.0
2890,11412,34882,34882,0,1.0,0.0
2891,11413,38912,38912,0,1.0,0.0
2892,11414,26148,26148,0,1.0,0.0
2893,11415,19341,19341,0,1.0,0.0
2894,11416,24861,24861,0,1.0,0.0
2895,11417,28967,28967,0,1.0,0.0
2896,11418,36256,36256,0,1.0,0.0
2897,11419,47211,47211,0,1.0,0.0
2898,11420,44354,44354,0,1.0,0.0
2899,11421,39127,39127,0,1.0,0.0
2900,11422,30425,30425,0,1.0,0.0
2901,11423,29987,29987,0,1.0,0.0
2902,11424,0,0,0,,
2903,11425,0,0,0,,
2904,11426,17590,17590,0,1.0,0.0
2905,11427,23593,23593,0,1.0,0.0
2906,11428,19168,19168,0,1.0,0.0
2907,11429,25105,25105,0,1.0,0.0
2908,11430,184,184,0,1.0,0.0
2909,11432,60809,60809,0,1.0,0.0
2910,11433,32687,32687,0,1.0,0.0
2911,11434,59129,59129,0,1.0,0.0
2912,11435,53687,53687,0,1.0,0.0
2913,11436,17949,17949,0,1.0,0.0
2914,11451,0,0,0,,
2915,11501,19148,19148,0,1.0,0.0
2916,11507,7406,7406,0,1.0,0.0
2917,11509,2653,2653,0,1.0,0.0
2918,11510,33048,33048,0,1.0,0.0
2919,11514,4673,4673,0,1.0,0.0
2920,11516,7556,7556,0,1.0,0.0
2921,11518,10549,10549,0,1.0,0.0
2922,11520,43341,43341,0,1.0,0.0
2923,11530,27273,27273,0,1.0,0.0
2924,11542,27633,27633,0,1.0,0.0
2925,11545,12065,11856,209,0.983,0.017
2926,11547,793,793,0,1.0,0.0
2927,11548,2780,2780,0,1.0,0.0
2928,11549,2922,2922,0,1.0,0.0
2929,11550,56435,56435,0,1.0,0.0
2930,11552,23616,23616,0,1.0,0.0
2931,11553,26034,26034,0,1.0,0.0
2932,11554,38132,38132,0,1.0,0.0
2933,11556,17,17,0,1.0,0.0
2934,11557,7823,7823,0,1.0,0.0
2935,11558,8370,8370,0,1.0,0.0
2936,11559,8176,7960,216,0.974,0.026
2937,11560,6464,5793,671,0.896,0.104
2938,11561,37280,37280,0,1.0,0.0
2939,11563,22666,22666,0,1.0,0.0
2940,11565,8690,8690,0,1.0,0.0
2941,11566,35321,35321,0,1.0,0.0
2942,11568,4555,4555,0,1.0,0.0
2943,11569,1398,1398,0,1.0,0.0
2944,11570,26646,26646,0,1.0,0.0
2945,11572,30574,30574,0,1.0,0.0
2946,11575,16272,16272,0,1.0,0.0
2947,11576,12366,12366,0,1.0,0.0
2948,11577,12337,12337,0,1.0,0.0
2949,11579,5055,5055,0,1.0,0.0
2950,11580,40113,40113,0,1.0,0.0
2951,11581,20844,20844,0,1.0,0.0
2952,11590,45768,45768,0,1.0,0.0
2953,11596,10480,10480,0,1.0,0.0
2954,11598,13328,13328,0,1.0,0.0
2955,11691,60035,60035,0,1.0,0.0
2956,11692,18540,18540,0,1.0,0.0
2957,11693,11916,11916,0,1.0,0.0
2958,11694,20408,20408,0,1.0,0.0
2959,11697,4079,4079,0,1.0,0.0
2960,11701,27109,27109,0,1.0,0.0
2961,11702,14498,14030,468,0.968,0.032
2962,11703,16415,16415,0,1.0,0.0
2963,11704,40222,40222,0,1.0,0.0
2964,11705,8030,8030,0,1.0,0.0
2965,11706,62543,62356,187,0.997,0.003
2966,11709,6669,6669,0,1.0,0.0
2967,11710,34496,34496,0,1.0,0.0
2968,11713,10401,10401,0,1.0,0.0
2969,11714,22658,22658,0,1.0,0.0
2970,11715,4752,4752,0,1.0,0.0
2971,11716,10700,10700,0,1.0,0.0
2972,11717,60745,60745,0,1.0,0.0
2973,11718,3103,3103,0,1.0,0.0
2974,11719,3589,3589,0,1.0,0.0
2975,11720,29189,29189,0,1.0,0.0
2976,11721,6292,6292,0,1.0,0.0
2977,11722,35177,35177,0,1.0,0.0
2978,11724,3220,3220,0,1.0,0.0
2979,11725,29150,29150,0,1.0,0.0
2980,11726,19857,19857,0,1.0,0.0
2981,11727,29030,29030,0,1.0,0.0
2982,11729,28032,28032,0,1.0,0.0
2983,11730,14712,14634,78,0.995,0.005
2984,11731,30184,30184,0,1.0,0.0
2985,11732,3430,3430,0,1.0,0.0
2986,11733,18949,18373,576,0.97,0.03
2987,11735,32098,32098,0,1.0,0.0
2988,11738,17638,17638,0,1.0,0.0
2989,11739,1223,1223,0,1.0,0.0
2990,11740,9454,9454,0,1.0,0.0
2991,11741,27655,27655,0,1.0,0.0
2992,11742,13261,13261,0,1.0,0.0
2993,11743,42230,40556,1674,0.96,0.04
2994,11746,67094,67094,0,1.0,0.0
2995,11747,19803,19803,0,1.0,0.0
2996,11749,3345,3345,0,1.0,0.0
2997,11751,14961,14961,0,1.0,0.0
2998,11752,9531,9531,0,1.0,0.0
2999,11753,12014,12014,0,1.0,0.0
3000,11754,18958,18958,0,1.0,0.0
3001,11755,12387,12387,0,1.0,0.0
3002,11756,42791,42791,0,1.0,0.0
3003,11757,45700,45700,0,1.0,0.0
3004,11758,53804,53804,0,1.0,0.0
3005,11762,22360,22360,0,1.0,0.0
3006,11763,28506,28506,0,1.0,0.0
3007,11764,13200,12898,302,0.977,0.023
3008,11765,737,227,510,0.308,0.692
3009,11766,12635,12635,0,1.0,0.0
3010,11767,14530,14530,0,1.0,0.0
3011,11768,21902,21902,0,1.0,0.0
3012,11769,9506,9506,0,1.0,0.0
3013,11770,137,0,137,0.0,1.0
3014,11771,10007,9038,969,0.903,0.097
3015,11772,44837,44833,4,1.0,0.0
3016,11776,24235,24235,0,1.0,0.0
3017,11777,8968,8968,0,1.0,0.0
3018,11778,12709,12450,259,0.98,0.02
3019,11779,38421,38421,0,1.0,0.0
3020,11780,15524,14096,1428,0.908,0.092
3021,11782,15814,15785,29,0.998,0.002
3022,11783,21288,21288,0,1.0,0.0
3023,11784,24655,24655,0,1.0,0.0
3024,11786,6344,5967,377,0.941,0.059
3025,11787,35772,35772,0,1.0,0.0
3026,11788,16821,16821,0,1.0,0.0
3027,11789,7895,7895,0,1.0,0.0
3028,11790,18511,18511,0,1.0,0.0
3029,11791,25076,25076,0,1.0,0.0
3030,11792,8523,7856,667,0.922,0.078
3031,11793,32298,32298,0,1.0,0.0
3032,11794,3165,3165,0,1.0,0.0
3033,11795,26030,26030,0,1.0,0.0
3034,11796,4056,4056,0,1.0,0.0
3035,11797,9041,9041,0,1.0,0.0
3036,11798,15347,15347,0,1.0,0.0
3037,11801,39553,39553,0,1.0,0.0
3038,11803,28127,28127,0,1.0,0.0
3039,11804,5010,5010,0,1.0,0.0
3040,11901,27172,23436,3736,0.863,0.137
3041,11930,1343,752,591,0.56,0.44
3042,11931,151,90,61,0.596,0.404
3043,11932,1398,0,1398,0.0,1.0
3044,11933,6844,3776,3068,0.552,0.448
3045,11934,7263,7054,209,0.971,0.029
3046,11935,3304,1513,1791,0.458,0.542
3047,11937,15398,11852,3546,0.77,0.23
3048,11939,926,661,265,0.714,0.286
3049,11940,5210,5026,184,0.965,0.035
3050,11941,1986,1897,89,0.955,0.045
3051,11942,4603,4029,574,0.875,0.125
3052,11944,4299,4260,39,0.991,0.009
3053,11946,14068,13469,599,0.957,0.043
3054,11947,416,281,135,0.675,0.325
3055,11948,1123,618,505,0.55,0.45
3056,11949,14573,13520,1053,0.928,0.072
3057,11950,16268,16268,0,1.0,0.0
3058,11951,13680,13680,0,1.0,0.0
3059,11952,4637,3525,1112,0.76,0.24
3060,11953,13553,13495,58,0.996,0.004
3061,11954,3326,2719,607,0.817,0.183
3062,11955,3285,3285,0,1.0,0.0
3063,11956,349,349,0,1.0,0.0
3064,11957,743,209,534,0.281,0.719
3065,11958,635,201,434,0.317,0.683
3066,11959,939,937,2,0.998,0.002
3067,11960,1084,871,213,0.804,0.196
3068,11961,12834,12568,266,0.979,0.021
3069,11962,494,0,494,0.0,1.0
3070,11963,6622,4911,1711,0.742,0.258
3071,11964,1858,0,1858,0.0,1.0
3072,11965,534,0,534,0.0,1.0
3073,11967,26583,26574,9,1.0,0.0
3074,11968,11593,9457,2136,0.816,0.184
3075,11970,522,522,0,1.0,0.0
3076,11971,5818,4479,1339,0.77,0.23
3077,11972,1321,1319,2,0.998,0.002
3078,11973,9,0,9,0.0,1.0
3079,11975,408,0,408,0.0,1.0
3080,11976,1565,230,1335,0.147,0.853
3081,11977,2467,2270,197,0.92,0.08
3082,11978,3255,2552,703,0.784,0.216
3083,11980,4990,4372,618,0.876,0.124
3084,12007,60,0,60,0.0,1.0
3085,12008,497,497,0,1.0,0.0
3086,12009,7164,3258,3906,0.455,0.545
3087,12010,28937,19739,9198,0.682,0.318
3088,12015,3010,246,2764,0.082,0.918
3089,12017,435,0,435,0.0,1.0
3090,12018,7930,3055,4875,0.385,0.615
3091,12019,14740,10799,3941,0.733,0.267
3092,12020,31192,23124,8068,0.741,0.259
3093,12022,929,0,929,0.0,1.0
3094,12023,2196,0,2196,0.0,1.0
3095,12024,31,0,31,0.0,1.0
3096,12025,5505,0,5505,0.0,1.0
3097,12027,3882,2760,1122,0.711,0.289
3098,12028,1172,0,1172,0.0,1.0
3099,12029,1113,0,1113,0.0,1.0
3100,12031,175,0,175,0.0,1.0
3101,12032,836,0,836,0.0,1.0
3102,12033,7851,5047,2804,0.643,0.357
3103,12035,802,0,802,0.0,1.0
3104,12036,228,0,228,0.0,1.0
3105,12037,4015,0,4015,0.0,1.0
3106,12040,113,0,113,0.0,1.0
3107,12041,481,0,481,0.0,1.0
3108,12042,271,0,271,0.0,1.0
3109,12043,8509,4665,3844,0.548,0.452
3110,12045,584,445,139,0.762,0.238
3111,12046,817,0,817,0.0,1.0
3112,12047,19664,19294,370,0.981,0.019
3113,12051,7070,5898,1172,0.834,0.166
3114,12052,1568,0,1568,0.0,1.0
3115,12053,4587,0,4587,0.0,1.0
3116,12054,16918,16211,707,0.958,0.042
3117,12056,2310,281,2029,0.122,0.878
3118,12057,1835,0,1835,0.0,1.0
3119,12058,1445,0,1445,0.0,1.0
3120,12059,1632,0,1632,0.0,1.0
3121,12060,1507,0,1507,0.0,1.0
3122,12061,9050,6533,2517,0.722,0.278
3123,12062,1776,0,1776,0.0,1.0
3124,12063,444,185,259,0.417,0.583
3125,12064,563,0,563,0.0,1.0
3126,12065,41776,39861,1915,0.954,0.046
3127,12066,2143,0,2143,0.0,1.0
3128,12067,1506,0,1506,0.0,1.0
3129,12068,3201,1237,1964,0.386,0.614
3130,12069,256,0,256,0.0,1.0
3131,12070,1410,359,1051,0.255,0.745
3132,12071,270,0,270,0.0,1.0
3133,12072,2890,802,2088,0.278,0.722
3134,12074,2963,0,2963,0.0,1.0
3135,12075,3418,0,3418,0.0,1.0
3136,12076,1500,0,1500,0.0,1.0
3137,12077,6246,4642,1604,0.743,0.257
3138,12078,23773,17024,6749,0.716,0.284
3139,12083,3795,0,3795,0.0,1.0
3140,12084,4271,3874,397,0.907,0.093
3141,12085,479,479,0,1.0,0.0
3142,12086,1865,1338,527,0.717,0.283
3143,12087,1073,0,1073,0.0,1.0
3144,12089,69,0,69,0.0,1.0
3145,12090,6262,3592,2670,0.574,0.426
3146,12092,1304,0,1304,0.0,1.0
3147,12093,1666,0,1666,0.0,1.0
3148,12094,2268,0,2268,0.0,1.0
3149,12095,12606,9579,3027,0.76,0.24
3150,12106,2193,1286,907,0.586,0.414
3151,12108,416,0,416,0.0,1.0
3152,12110,21908,21908,0,1.0,0.0
3153,12115,189,0,189,0.0,1.0
3154,12116,1920,0,1920,0.0,1.0
3155,12117,3256,943,2313,0.29,0.71
3156,12118,13897,10358,3539,0.745,0.255
3157,12120,613,0,613,0.0,1.0
3158,12121,1916,0,1916,0.0,1.0
3159,12122,4582,0,4582,0.0,1.0
3160,12123,5124,45,5079,0.009,0.991
3161,12124,606,275,331,0.454,0.546
3162,12125,1373,0,1373,0.0,1.0
3163,12130,987,987,0,1.0,0.0
3164,12131,115,0,115,0.0,1.0
3165,12132,338,0,338,0.0,1.0
3166,12134,3516,0,3516,0.0,1.0
3167,12136,804,0,804,0.0,1.0
3168,12137,1679,0,1679,0.0,1.0
3169,12138,3168,0,3168,0.0,1.0
3170,12139,295,0,295,0.0,1.0
3171,12140,1702,742,960,0.436,0.564
3172,12143,5137,3535,1602,0.688,0.312
3173,12144,20555,19697,858,0.958,0.042
3174,12147,499,0,499,0.0,1.0
3175,12148,4569,2112,2457,0.462,0.538
3176,12149,2474,851,1623,0.344,0.656
3177,12150,914,868,46,0.95,0.05
3178,12151,708,551,157,0.778,0.222
3179,12153,814,0,814,0.0,1.0
3180,12154,2818,19,2799,0.007,0.993
3181,12155,1977,0,1977,0.0,1.0
3182,12156,848,0,848,0.0,1.0
3183,12157,4061,0,4061,0.0,1.0
3184,12158,6309,3422,2887,0.542,0.458
3185,12159,7896,6534,1362,0.828,0.172
3186,12160,944,0,944,0.0,1.0
3187,12161,160,0,160,0.0,1.0
3188,12164,365,0,365,0.0,1.0
3189,12165,175,0,175,0.0,1.0
3190,12166,1363,0,1363,0.0,1.0
3191,12167,2438,0,2438,0.0,1.0
3192,12168,1952,0,1952,0.0,1.0
3193,12169,306,0,306,0.0,1.0
3194,12170,4945,2936,2009,0.594,0.406
3195,12172,405,353,52,0.872,0.128
3196,12173,1753,430,1323,0.245,0.755
3197,12174,345,0,345,0.0,1.0
3198,12175,797,0,797,0.0,1.0
3199,12176,198,0,198,0.0,1.0
3200,12177,518,467,51,0.902,0.098
3201,12180,53606,49474,4132,0.923,0.077
3202,12182,14733,13392,1341,0.909,0.091
3203,12183,2620,2620,0,1.0,0.0
3204,12184,7148,3003,4145,0.42,0.58
3205,12185,2037,0,2037,0.0,1.0
3206,12186,6277,3708,2569,0.591,0.409
3207,12187,697,102,595,0.146,0.854
3208,12188,10980,9682,1298,0.882,0.118
3209,12189,17568,17568,0,1.0,0.0
3210,12190,674,0,674,0.0,1.0
3211,12192,1722,197,1525,0.114,0.886
3212,12193,2016,0,2016,0.0,1.0
3213,12194,207,0,207,0.0,1.0
3214,12195,154,0,154,0.0,1.0
3215,12196,3031,1648,1383,0.544,0.456
3216,12197,2233,0,2233,0.0,1.0
3217,12198,7903,6910,993,0.874,0.126
3218,12202,9628,9628,0,1.0,0.0
3219,12203,29952,29848,104,0.997,0.003
3220,12204,7349,7349,0,1.0,0.0
3221,12205,26977,26832,145,0.995,0.005
3222,12206,16395,16395,0,1.0,0.0
3223,12207,1948,1948,0,1.0,0.0
3224,12208,20702,20702,0,1.0,0.0
3225,12209,10121,10121,0,1.0,0.0
3226,12210,10158,10158,0,1.0,0.0
3227,12211,11303,11303,0,1.0,0.0
3228,12222,6489,6489,0,1.0,0.0
3229,12302,27582,24512,3070,0.889,0.111
3230,12303,29857,28465,1392,0.953,0.047
3231,12304,21482,21400,82,0.996,0.004
3232,12305,5716,5716,0,1.0,0.0
3233,12306,25636,23017,2619,0.898,0.102
3234,12307,7692,7692,0,1.0,0.0
3235,12308,15335,15335,0,1.0,0.0
3236,12309,29343,29343,0,1.0,0.0
3237,12401,35040,30755,4285,0.878,0.122
3238,12404,3385,0,3385,0.0,1.0
3239,12405,780,0,780,0.0,1.0
3240,12406,823,0,823,0.0,1.0
3241,12407,173,0,173,0.0,1.0
3242,12409,804,0,804,0.0,1.0
3243,12410,397,0,397,0.0,1.0
3244,12411,497,497,0,1.0,0.0
3245,12412,673,0,673,0.0,1.0
3246,12413,2948,454,2494,0.154,0.846
3247,12414,10510,5381,5129,0.512,0.488
3248,12416,277,0,277,0.0,1.0
3249,12417,581,581,0,1.0,0.0
3250,12418,537,0,537,0.0,1.0
3251,12419,722,0,722,0.0,1.0
3252,12420,363,0,363,0.0,1.0
3253,12421,470,0,470,0.0,1.0
3254,12422,339,0,339,0.0,1.0
3255,12423,1097,0,1097,0.0,1.0
3256,12424,250,0,250,0.0,1.0
3257,12427,576,0,576,0.0,1.0
3258,12428,6602,4474,2128,0.678,0.322
3259,12429,281,0,281,0.0,1.0
3260,12430,1194,0,1194,0.0,1.0
3261,12431,1381,0,1381,0.0,1.0
3262,12432,492,492,0,1.0,0.0
3263,12433,483,0,483,0.0,1.0
3264,12434,751,0,751,0.0,1.0
3265,12435,326,0,326,0.0,1.0
3266,12436,417,0,417,0.0,1.0
3267,12438,59,0,59,0.0,1.0
3268,12439,305,0,305,0.0,1.0
3269,12440,1980,0,1980,0.0,1.0
3270,12441,114,0,114,0.0,1.0
3271,12442,953,0,953,0.0,1.0
3272,12443,3825,2462,1363,0.644,0.356
3273,12444,497,0,497,0.0,1.0
3274,12446,5061,0,5061,0.0,1.0
3275,12448,388,0,388,0.0,1.0
3276,12449,3367,3123,244,0.928,0.072
3277,12450,183,0,183,0.0,1.0
3278,12451,1674,450,1224,0.269,0.731
3279,12452,213,0,213,0.0,1.0
3280,12453,366,280,86,0.765,0.235
3281,12454,297,0,297,0.0,1.0
3282,12455,1988,0,1988,0.0,1.0
3283,12456,639,639,0,1.0,0.0
3284,12457,763,0,763,0.0,1.0
3285,12458,3232,2103,1129,0.651,0.349
3286,12459,161,0,161,0.0,1.0
3287,12460,277,0,277,0.0,1.0
3288,12461,1634,0,1634,0.0,1.0
3289,12463,1484,0,1484,0.0,1.0
3290,12464,1020,0,1020,0.0,1.0
3291,12465,266,0,266,0.0,1.0
3292,12466,2471,2471,0,1.0,0.0
3293,12468,1036,0,1036,0.0,1.0
3294,12469,677,0,677,0.0,1.0
3295,12470,536,0,536,0.0,1.0
3296,12471,215,185,30,0.86,0.14
3297,12472,1572,1238,334,0.788,0.212
3298,12473,861,0,861,0.0,1.0
3299,12474,1162,0,1162,0.0,1.0
3300,12475,354,11,343,0.031,0.969
3301,12477,18787,9401,9386,0.5,0.5
3302,12480,634,0,634,0.0,1.0
3303,12481,1356,0,1356,0.0,1.0
3304,12482,680,308,372,0.453,0.547
3305,12483,259,0,259,0.0,1.0
3306,12484,2733,0,2733,0.0,1.0
3307,12485,865,0,865,0.0,1.0
3308,12486,1523,1520,3,0.998,0.002
3309,12487,3268,599,2669,0.183,0.817
3310,12489,1292,0,1292,0.0,1.0
3311,12490,110,73,37,0.664,0.336
3312,12491,1675,1002,673,0.598,0.402
3313,12492,271,0,271,0.0,1.0
3314,12493,495,0,495,0.0,1.0
3315,12494,764,0,764,0.0,1.0
3316,12495,265,0,265,0.0,1.0
3317,12496,1634,0,1634,0.0,1.0
3318,12498,4851,1313,3538,0.271,0.729
3319,12501,2457,0,2457,0.0,1.0
3320,12502,1164,0,1164,0.0,1.0
3321,12503,775,0,775,0.0,1.0
3322,12504,1395,1204,191,0.863,0.137
3323,12507,167,0,167,0.0,1.0
3324,12508,19880,19474,406,0.98,0.02
3325,12512,127,127,0,1.0,0.0
3326,12513,651,0,651,0.0,1.0
3327,12514,2938,0,2938,0.0,1.0
3328,12515,1549,629,920,0.406,0.594
3329,12516,1833,0,1833,0.0,1.0
3330,12517,509,0,509,0.0,1.0
3331,12518,5870,5199,671,0.886,0.114
3332,12520,3109,2937,172,0.945,0.055
3333,12521,1644,0,1644,0.0,1.0
3334,12522,5172,0,5172,0.0,1.0
3335,12523,1798,0,1798,0.0,1.0
3336,12524,15598,15232,366,0.977,0.023
3337,12525,3311,0,3311,0.0,1.0
3338,12526,3686,0,3686,0.0,1.0
3339,12527,147,147,0,1.0,0.0
3340,12528,13344,8285,5059,0.621,0.379
3341,12529,2859,0,2859,0.0,1.0
3342,12530,124,0,124,0.0,1.0
3343,12531,3601,1160,2441,0.322,0.678
3344,12533,25307,20912,4395,0.826,0.174
3345,12534,17867,10789,7078,0.604,0.396
3346,12538,14578,10407,4171,0.714,0.286
3347,12540,7802,4099,3703,0.525,0.475
3348,12542,5913,4340,1573,0.734,0.266
3349,12543,3001,2953,48,0.984,0.016
3350,12545,4763,0,4763,0.0,1.0
3351,12546,3039,0,3039,0.0,1.0
3352,12547,2891,1295,1596,0.448,0.552
3353,12548,1494,0,1494,0.0,1.0
3354,12549,10201,4426,5775,0.434,0.566
3355,12550,54447,53963,484,0.991,0.009
3356,12553,24438,23415,1023,0.958,0.042
3357,12561,18308,12492,5816,0.682,0.318
3358,12563,8084,5752,2332,0.712,0.288
3359,12564,7338,4444,2894,0.606,0.394
3360,12565,1487,0,1487,0.0,1.0
3361,12566,10753,2323,8430,0.216,0.784
3362,12567,2854,0,2854,0.0,1.0
3363,12569,9826,4657,5169,0.474,0.526
3364,12570,7699,5327,2372,0.692,0.308
3365,12571,9918,4241,5677,0.428,0.572
3366,12572,9123,3445,5678,0.378,0.622
3367,12574,329,0,329,0.0,1.0
3368,12575,2258,1330,928,0.589,0.411
3369,12577,2029,1868,161,0.921,0.079
3370,12578,2411,244,2167,0.101,0.899
3371,12580,4402,859,3543,0.195,0.805
3372,12581,2246,0,2246,0.0,1.0
3373,12582,6191,5214,977,0.842,0.158
3374,12583,2451,803,1648,0.328,0.672
3375,12585,885,0,885,0.0,1.0
3376,12586,12540,9304,3236,0.742,0.258
3377,12589,17228,10304,6924,0.598,0.402
3378,12590,35102,33875,1227,0.965,0.035
3379,12592,1486,0,1486,0.0,1.0
3380,12594,4275,415,3860,0.097,0.903
3381,12601,43398,42793,605,0.986,0.014
3382,12603,42810,42300,510,0.988,0.012
3383,12604,586,586,0,1.0,0.0
3384,12701,11324,7503,3821,0.663,0.337
3385,12719,1207,0,1207,0.0,1.0
3386,12720,172,0,172,0.0,1.0
3387,12721,6627,2517,4110,0.38,0.62
3388,12722,158,91,67,0.576,0.424
3389,12723,1826,0,1826,0.0,1.0
3390,12724,245,0,245,0.0,1.0
3391,12725,277,0,277,0.0,1.0
3392,12726,1162,0,1162,0.0,1.0
3393,12729,1874,0,1874,0.0,1.0
3394,12732,786,0,786,0.0,1.0
3395,12733,1446,1351,95,0.934,0.066
3396,12734,867,8,859,0.009,0.991
3397,12736,118,0,118,0.0,1.0
3398,12737,1910,0,1910,0.0,1.0
3399,12738,320,0,320,0.0,1.0
3400,12740,1886,0,1886,0.0,1.0
3401,12741,351,0,351,0.0,1.0
3402,12742,181,0,181,0.0,1.0
3403,12743,389,0,389,0.0,1.0
3404,12745,178,0,178,0.0,1.0
3405,12746,937,320,617,0.342,0.658
3406,12747,1714,0,1714,0.0,1.0
3407,12748,2076,0,2076,0.0,1.0
3408,12749,300,0,300,0.0,1.0
3409,12750,187,0,187,0.0,1.0
3410,12751,1054,549,505,0.521,0.479
3411,12752,242,0,242,0.0,1.0
3412,12754,7221,4462,2759,0.618,0.382
3413,12758,4042,0,4042,0.0,1.0
3414,12759,1649,0,1649,0.0,1.0
3415,12760,482,0,482,0.0,1.0
3416,12762,512,0,512,0.0,1.0
3417,12763,942,0,942,0.0,1.0
3418,12764,1802,0,1802,0.0,1.0
3419,12765,885,0,885,0.0,1.0
3420,12766,437,0,437,0.0,1.0
3421,12767,126,0,126,0.0,1.0
3422,12768,1131,0,1131,0.0,1.0
3423,12769,253,0,253,0.0,1.0
3424,12770,296,0,296,0.0,1.0
3425,12771,14511,10217,4294,0.704,0.296
3426,12775,2297,0,2297,0.0,1.0
3427,12776,2180,0,2180,0.0,1.0
3428,12777,764,0,764,0.0,1.0
3429,12778,633,0,633,0.0,1.0
3430,12779,2460,1853,607,0.753,0.247
3431,12780,2312,585,1727,0.253,0.747
3432,12781,307,0,307,0.0,1.0
3433,12783,1668,0,1668,0.0,1.0
3434,12784,94,0,94,0.0,1.0
3435,12785,1024,0,1024,0.0,1.0
3436,12786,665,0,665,0.0,1.0
3437,12787,452,0,452,0.0,1.0
3438,12788,2908,0,2908,0.0,1.0
3439,12789,1838,0,1838,0.0,1.0
3440,12790,4518,1013,3505,0.224,0.776
3441,12791,737,0,737,0.0,1.0
3442,12792,335,0,335,0.0,1.0
3443,12801,14707,14707,0,1.0,0.0
3444,12803,7567,7207,360,0.952,0.048
3445,12804,26540,23116,3424,0.871,0.129
3446,12808,306,0,306,0.0,1.0
3447,12809,3528,0,3528,0.0,1.0
3448,12810,627,0,627,0.0,1.0
3449,12811,127,0,127,0.0,1.0
3450,12812,150,0,150,0.0,1.0
3451,12814,1574,0,1574,0.0,1.0
3452,12815,871,0,871,0.0,1.0
3453,12816,4610,0,4610,0.0,1.0
3454,12817,2274,0,2274,0.0,1.0
3455,12819,403,0,403,0.0,1.0
3456,12821,2750,0,2750,0.0,1.0
3457,12822,6200,3098,3102,0.5,0.5
3458,12823,238,0,238,0.0,1.0
3459,12824,894,0,894,0.0,1.0
3460,12827,3877,0,3877,0.0,1.0
3461,12828,9448,6770,2678,0.717,0.283
3462,12831,17416,8679,8737,0.498,0.502
3463,12832,7106,2740,4366,0.386,0.614
3464,12833,4401,421,3980,0.096,0.904
3465,12834,6594,2551,4043,0.387,0.613
3466,12835,2603,0,2603,0.0,1.0
3467,12836,574,0,574,0.0,1.0
3468,12837,857,0,857,0.0,1.0
3469,12838,608,0,608,0.0,1.0
3470,12839,13588,10804,2784,0.795,0.205
3471,12841,77,0,77,0.0,1.0
3472,12842,1166,0,1166,0.0,1.0
3473,12843,600,0,600,0.0,1.0
3474,12844,199,0,199,0.0,1.0
3475,12845,4842,2045,2797,0.422,0.578
3476,12846,3298,897,2401,0.272,0.728
3477,12847,605,0,605,0.0,1.0
3478,12849,385,11,374,0.029,0.971
3479,12850,2835,0,2835,0.0,1.0
3480,12851,366,0,366,0.0,1.0
3481,12852,436,0,436,0.0,1.0
3482,12853,1770,0,1770,0.0,1.0
3483,12855,259,0,259,0.0,1.0
3484,12856,187,0,187,0.0,1.0
3485,12857,498,0,498,0.0,1.0
3486,12858,59,0,59,0.0,1.0
3487,12859,2220,0,2220,0.0,1.0
3488,12860,748,0,748,0.0,1.0
3489,12861,609,0,609,0.0,1.0
3490,12862,17,0,17,0.0,1.0
3491,12863,533,0,533,0.0,1.0
3492,12864,36,0,36,0.0,1.0
3493,12865,3663,0,3663,0.0,1.0
3494,12866,36915,31512,5403,0.854,0.146
3495,12870,1509,0,1509,0.0,1.0
3496,12871,4084,0,4084,0.0,1.0
3497,12872,31,0,31,0.0,1.0
3498,12873,736,0,736,0.0,1.0
3499,12874,142,0,142,0.0,1.0
3500,12878,719,0,719,0.0,1.0
3501,12883,5025,2850,2175,0.567,0.433
3502,12884,486,0,486,0.0,1.0
3503,12885,4602,2648,1954,0.575,0.425
3504,12886,269,0,269,0.0,1.0
3505,12887,4972,0,4972,0.0,1.0
3506,12901,33439,25803,7636,0.772,0.228
3507,12903,1217,1217,0,1.0,0.0
3508,12910,2148,0,2148,0.0,1.0
3509,12911,36,0,36,0.0,1.0
3510,12912,1998,0,1998,0.0,1.0
3511,12913,1157,0,1157,0.0,1.0
3512,12914,1044,0,1044,0.0,1.0
3513,12916,2135,0,2135,0.0,1.0
3514,12917,1403,0,1403,0.0,1.0
3515,12918,2381,230,2151,0.097,0.903
3516,12919,3037,0,3037,0.0,1.0
3517,12920,2842,0,2842,0.0,1.0
3518,12921,2410,0,2410,0.0,1.0
3519,12922,65,0,65,0.0,1.0
3520,12923,632,0,632,0.0,1.0
3521,12924,158,0,158,0.0,1.0
3522,12926,2208,0,2208,0.0,1.0
3523,12927,224,0,224,0.0,1.0
3524,12928,2028,0,2028,0.0,1.0
3525,12929,3938,0,3938,0.0,1.0
3526,12930,634,0,634,0.0,1.0
3527,12932,1236,0,1236,0.0,1.0
3528,12933,17,0,17,0.0,1.0
3529,12934,1074,0,1074,0.0,1.0
3530,12935,1748,0,1748,0.0,1.0
3531,12936,599,0,599,0.0,1.0
3532,12937,1572,0,1572,0.0,1.0
3533,12939,205,0,205,0.0,1.0
3534,12941,1428,0,1428,0.0,1.0
3535,12942,646,0,646,0.0,1.0
3536,12943,459,0,459,0.0,1.0
3537,12944,4080,0,4080,0.0,1.0
3538,12945,638,0,638,0.0,1.0
3539,12946,5492,3581,1911,0.652,0.348
3540,12950,929,0,929,0.0,1.0
3541,12952,546,0,546,0.0,1.0
3542,12953,15836,10825,5011,0.684,0.316
3543,12955,381,0,381,0.0,1.0
3544,12956,1259,0,1259,0.0,1.0
3545,12957,1726,0,1726,0.0,1.0
3546,12958,1929,0,1929,0.0,1.0
3547,12959,1369,0,1369,0.0,1.0
3548,12960,1148,0,1148,0.0,1.0
3549,12961,180,0,180,0.0,1.0
3550,12962,5499,2188,3311,0.398,0.602
3551,12964,161,0,161,0.0,1.0
3552,12965,516,0,516,0.0,1.0
3553,12966,2915,0,2915,0.0,1.0
3554,12967,1223,0,1223,0.0,1.0
3555,12969,423,0,423,0.0,1.0
3556,12970,963,0,963,0.0,1.0
3557,12972,6364,0,6364,0.0,1.0
3558,12973,187,0,187,0.0,1.0
3559,12974,1599,0,1599,0.0,1.0
3560,12975,265,0,265,0.0,1.0
3561,12976,260,0,260,0.0,1.0
3562,12977,1753,1701,52,0.97,0.03
3563,12978,403,0,403,0.0,1.0
3564,12979,2304,0,2304,0.0,1.0
3565,12980,1304,0,1304,0.0,1.0
3566,12981,2253,0,2253,0.0,1.0
3567,12983,7494,5997,1497,0.8,0.2
3568,12985,1072,0,1072,0.0,1.0
3569,12986,6120,4204,1916,0.687,0.313
3570,12987,201,0,201,0.0,1.0
3571,12989,1010,0,1010,0.0,1.0
3572,12992,4778,0,4778,0.0,1.0
3573,12993,1623,0,1623,0.0,1.0
3574,12996,2086,0,2086,0.0,1.0
3575,12997,1239,0,1239,0.0,1.0
3576,12998,526,0,526,0.0,1.0
3577,13020,150,0,150,0.0,1.0
3578,13021,39506,30541,8965,0.773,0.227
3579,13024,1733,1733,0,1.0,0.0
3580,13026,1914,0,1914,0.0,1.0
3581,13027,31637,26523,5114,0.838,0.162
3582,13028,1350,0,1350,0.0,1.0
3583,13029,7109,5525,1584,0.777,0.223
3584,13030,3892,1447,2445,0.372,0.628
3585,13031,15551,13709,1842,0.882,0.118
3586,13032,12790,7097,5693,0.555,0.445
3587,13033,3556,0,3556,0.0,1.0
3588,13034,1989,0,1989,0.0,1.0
3589,13035,8617,3114,5503,0.361,0.639
3590,13036,8680,4164,4516,0.48,0.52
3591,13037,8897,5542,3355,0.623,0.377
3592,13039,17537,16072,1465,0.916,0.084
3593,13040,2758,0,2758,0.0,1.0
3594,13041,10705,9114,1591,0.851,0.149
3595,13042,2356,0,2356,0.0,1.0
3596,13044,2512,0,2512,0.0,1.0
3597,13045,30112,22994,7118,0.764,0.236
3598,13051,153,0,153,0.0,1.0
3599,13052,1679,0,1679,0.0,1.0
3600,13053,5015,3290,1725,0.656,0.344
3601,13054,1582,306,1276,0.193,0.807
3602,13057,14992,13363,1629,0.891,0.109
3603,13060,2806,0,2806,0.0,1.0
3604,13061,1040,0,1040,0.0,1.0
3605,13062,173,93,80,0.538,0.462
3606,13063,1898,0,1898,0.0,1.0
3607,13064,64,0,64,0.0,1.0
3608,13066,12390,11481,909,0.927,0.073
3609,13068,5368,623,4745,0.116,0.884
3610,13069,24931,13254,11677,0.532,0.468
3611,13071,1023,0,1023,0.0,1.0
3612,13072,1123,0,1123,0.0,1.0
3613,13073,6423,0,6423,0.0,1.0
3614,13074,4488,0,4488,0.0,1.0
3615,13076,2393,127,2266,0.053,0.947
3616,13077,6735,3431,3304,0.509,0.491
3617,13078,9866,6501,3365,0.659,0.341
3618,13080,3631,0,3631,0.0,1.0
3619,13081,1169,0,1169,0.0,1.0
3620,13082,4871,907,3964,0.186,0.814
3621,13083,1809,0,1809,0.0,1.0
3622,13084,4409,0,4409,0.0,1.0
3623,13087,168,0,168,0.0,1.0
3624,13088,22156,22156,0,1.0,0.0
3625,13090,30124,29750,374,0.988,0.012
3626,13092,2606,0,2606,0.0,1.0
3627,13101,2508,1068,1440,0.426,0.574
3628,13102,85,0,85,0.0,1.0
3629,13103,326,326,0,1.0,0.0
3630,13104,15567,12114,3453,0.778,0.222
3631,13108,6175,3173,3002,0.514,0.486
3632,13110,2338,0,2338,0.0,1.0
3633,13111,1700,0,1700,0.0,1.0
3634,13112,1973,0,1973,0.0,1.0
3635,13113,287,0,287,0.0,1.0
3636,13114,6356,0,6356,0.0,1.0
3637,13115,224,224,0,1.0,0.0
3638,13116,3457,3455,2,0.999,0.001
3639,13117,188,0,188,0.0,1.0
3640,13118,6382,0,6382,0.0,1.0
3641,13120,2328,1243,1085,0.534,0.466
3642,13122,1174,0,1174,0.0,1.0
3643,13123,314,5,309,0.016,0.984
3644,13124,124,0,124,0.0,1.0
3645,13126,37205,25907,11298,0.696,0.304
3646,13131,3895,0,3895,0.0,1.0
3647,13132,4244,0,4244,0.0,1.0
3648,13134,119,0,119,0.0,1.0
3649,13135,6617,3407,3210,0.515,0.485
3650,13136,534,0,534,0.0,1.0
3651,13138,61,0,61,0.0,1.0
3652,13140,4488,1257,3231,0.28,0.72
3653,13141,596,0,596,0.0,1.0
3654,13142,6451,0,6451,0.0,1.0
3655,13143,2873,0,2873,0.0,1.0
3656,13144,1531,0,1531,0.0,1.0
3657,13145,1926,0,1926,0.0,1.0
3658,13146,2443,0,2443,0.0,1.0
3659,13147,1281,0,1281,0.0,1.0
3660,13148,10750,7748,3002,0.721,0.279
3661,13152,7941,3265,4676,0.411,0.589
3662,13153,399,259,140,0.649,0.351
3663,13155,663,0,663,0.0,1.0
3664,13156,2000,0,2000,0.0,1.0
3665,13157,695,695,0,1.0,0.0
3666,13158,1855,0,1855,0.0,1.0
3667,13159,5184,0,5184,0.0,1.0
3668,13160,2027,0,2027,0.0,1.0
3669,13162,385,266,119,0.691,0.309
3670,13163,339,306,33,0.903,0.097
3671,13164,2338,948,1390,0.405,0.595
3672,13165,10741,6596,4145,0.614,0.386
3673,13166,5610,1855,3755,0.331,0.669
3674,13167,3342,0,3342,0.0,1.0
3675,13202,5438,5438,0,1.0,0.0
3676,13203,16029,16029,0,1.0,0.0
3677,13204,19931,19931,0,1.0,0.0
3678,13205,19201,19201,0,1.0,0.0
3679,13206,16443,16443,0,1.0,0.0
3680,13207,13897,13897,0,1.0,0.0
3681,13208,22854,22854,0,1.0,0.0
3682,13209,13243,13095,148,0.989,0.011
3683,13210,27606,27606,0,1.0,0.0
3684,13211,6517,6517,0,1.0,0.0
3685,13212,20356,20064,292,0.986,0.014
3686,13214,8793,8793,0,1.0,0.0
3687,13215,15245,12690,2555,0.832,0.168
3688,13219,15363,15363,0,1.0,0.0
3689,13224,8891,8891,0,1.0,0.0
3690,13290,0,0,0,,
3691,13301,98,0,98,0.0,1.0
3692,13302,1610,0,1610,0.0,1.0
3693,13303,1153,48,1105,0.042,0.958
3694,13304,1684,0,1684,0.0,1.0
3695,13305,293,0,293,0.0,1.0
3696,13308,3625,445,3180,0.123,0.877
3697,13309,5889,0,5889,0.0,1.0
3698,13310,624,0,624,0.0,1.0
3699,13312,331,0,331,0.0,1.0
3700,13313,526,0,526,0.0,1.0
3701,13314,443,0,443,0.0,1.0
3702,13315,1419,0,1419,0.0,1.0
3703,13316,6460,0,6460,0.0,1.0
3704,13317,3784,2214,1570,0.585,0.415
3705,13318,1325,0,1325,0.0,1.0
3706,13319,1079,1045,34,0.968,0.032
3707,13320,2018,0,2018,0.0,1.0
3708,13321,1049,1049,0,1.0,0.0
3709,13322,1076,287,789,0.267,0.733
3710,13323,11323,6827,4496,0.603,0.397
3711,13324,2149,0,2149,0.0,1.0
3712,13325,866,0,866,0.0,1.0
3713,13326,5561,0,5561,0.0,1.0
3714,13327,2056,0,2056,0.0,1.0
3715,13328,1267,0,1267,0.0,1.0
3716,13329,3889,0,3889,0.0,1.0
3717,13331,189,0,189,0.0,1.0
3718,13332,2460,0,2460,0.0,1.0
3719,13333,62,0,62,0.0,1.0
3720,13334,1374,0,1374,0.0,1.0
3721,13335,1590,0,1590,0.0,1.0
3722,13337,790,0,790,0.0,1.0
3723,13338,1206,0,1206,0.0,1.0
3724,13339,6941,2364,4577,0.341,0.659
3725,13340,8205,4592,3613,0.56,0.44
3726,13341,102,52,50,0.51,0.49
3727,13342,165,0,165,0.0,1.0
3728,13343,1658,0,1658,0.0,1.0
3729,13345,177,0,177,0.0,1.0
3730,13346,6735,4427,2308,0.657,0.343
3731,13348,1469,0,1469,0.0,1.0
3732,13350,10093,8481,1612,0.84,0.16
3733,13352,65,0,65,0.0,1.0
3734,13353,86,0,86,0.0,1.0
3735,13354,3342,0,3342,0.0,1.0
3736,13355,905,0,905,0.0,1.0
3737,13357,11096,9246,1850,0.833,0.167
3738,13360,333,0,333,0.0,1.0
3739,13361,824,0,824,0.0,1.0
3740,13362,60,0,60,0.0,1.0
3741,13363,2315,253,2062,0.109,0.891
3742,13364,243,0,243,0.0,1.0
3743,13365,8906,4956,3950,0.556,0.444
3744,13367,8830,3562,5268,0.403,0.597
3745,13368,1118,0,1118,0.0,1.0
3746,13402,1534,0,1534,0.0,1.0
3747,13403,7372,4783,2589,0.649,0.351
3748,13404,236,0,236,0.0,1.0
3749,13406,725,0,725,0.0,1.0
3750,13407,5453,2914,2539,0.534,0.466
3751,13408,4280,0,4280,0.0,1.0
3752,13409,2374,0,2374,0.0,1.0
3753,13410,241,241,0,1.0,0.0
3754,13411,3264,0,3264,0.0,1.0
3755,13413,16135,14450,1685,0.896,0.104
3756,13415,77,0,77,0.0,1.0
3757,13416,2271,0,2271,0.0,1.0
3758,13417,3305,3305,0,1.0,0.0
3759,13418,255,0,255,0.0,1.0
3760,13420,1266,0,1266,0.0,1.0
3761,13421,14125,10674,3451,0.756,0.244
3762,13424,2725,1424,1301,0.523,0.477
3763,13425,1970,0,1970,0.0,1.0
3764,13428,1635,911,724,0.557,0.443
3765,13431,2069,0,2069,0.0,1.0
3766,13433,1820,0,1820,0.0,1.0
3767,13435,286,0,286,0.0,1.0
3768,13436,108,0,108,0.0,1.0
3769,13437,460,0,460,0.0,1.0
3770,13438,3789,0,3789,0.0,1.0
3771,13439,3950,0,3950,0.0,1.0
3772,13440,42986,33076,9910,0.769,0.231
3773,13441,51,51,0,1.0,0.0
3774,13450,104,0,104,0.0,1.0
3775,13452,4629,0,4629,0.0,1.0
3776,13454,826,0,826,0.0,1.0
3777,13456,4164,1521,2643,0.365,0.635
3778,13459,2222,0,2222,0.0,1.0
3779,13460,4429,0,4429,0.0,1.0
3780,13461,3083,3083,0,1.0,0.0
3781,13464,1189,0,1189,0.0,1.0
3782,13468,451,0,451,0.0,1.0
3783,13469,847,0,847,0.0,1.0
3784,13470,725,0,725,0.0,1.0
3785,13471,3540,0,3540,0.0,1.0
3786,13472,310,0,310,0.0,1.0
3787,13473,766,0,766,0.0,1.0
3788,13475,28,0,28,0.0,1.0
3789,13476,3032,1218,1814,0.402,0.598
3790,13477,1452,0,1452,0.0,1.0
3791,13478,3083,681,2402,0.221,0.779
3792,13480,3532,0,3532,0.0,1.0
3793,13483,256,0,256,0.0,1.0
3794,13484,176,0,176,0.0,1.0
3795,13485,1132,0,1132,0.0,1.0
3796,13486,815,0,815,0.0,1.0
3797,13488,98,0,98,0.0,1.0
3798,13489,658,0,658,0.0,1.0
3799,13490,1361,360,1001,0.265,0.735
3800,13491,3641,0,3641,0.0,1.0
3801,13492,11596,11213,383,0.967,0.033
3802,13493,2070,0,2070,0.0,1.0
3803,13494,314,0,314,0.0,1.0
3804,13495,2144,2144,0,1.0,0.0
3805,13501,38546,38390,156,0.996,0.004
3806,13502,33257,30037,3220,0.903,0.097
3807,13601,38158,30042,8116,0.787,0.213
3808,13602,3881,3881,0,1.0,0.0
3809,13603,9760,9721,39,0.996,0.004
3810,13605,4777,1841,2936,0.385,0.615
3811,13606,2716,701,2015,0.258,0.742
3812,13607,1822,0,1822,0.0,1.0
3813,13608,1719,0,1719,0.0,1.0
3814,13612,2852,2043,809,0.716,0.284
3815,13613,2726,0,2726,0.0,1.0
3816,13614,357,0,357,0.0,1.0
3817,13615,1271,1106,165,0.87,0.13
3818,13616,1880,1352,528,0.719,0.281
3819,13617,11299,6489,4810,0.574,0.426
3820,13618,1711,0,1711,0.0,1.0
3821,13619,10901,6452,4449,0.592,0.408
3822,13620,2197,0,2197,0.0,1.0
3823,13621,650,0,650,0.0,1.0
3824,13622,2432,0,2432,0.0,1.0
3825,13623,49,0,49,0.0,1.0
3826,13624,5457,0,5457,0.0,1.0
3827,13625,1868,0,1868,0.0,1.0
3828,13626,2267,0,2267,0.0,1.0
3829,13628,220,220,0,1.0,0.0
3830,13630,1525,0,1525,0.0,1.0
3831,13633,345,0,345,0.0,1.0
3832,13634,3984,1302,2682,0.327,0.673
3833,13635,1092,0,1092,0.0,1.0
3834,13636,282,0,282,0.0,1.0
3835,13637,4491,1365,3126,0.304,0.696
3836,13638,378,337,41,0.892,0.108
3837,13639,243,0,243,0.0,1.0
3838,13640,271,0,271,0.0,1.0
3839,13641,91,0,91,0.0,1.0
3840,13642,10088,4146,5942,0.411,0.589
3841,13643,19,19,0,1.0,0.0
3842,13646,2211,0,2211,0.0,1.0
3843,13647,69,0,69,0.0,1.0
3844,13648,2424,0,2424,0.0,1.0
3845,13650,1391,0,1391,0.0,1.0
3846,13651,127,0,127,0.0,1.0
3847,13652,1815,0,1815,0.0,1.0
3848,13654,2461,0,2461,0.0,1.0
3849,13655,3512,0,3512,0.0,1.0
3850,13656,2861,0,2861,0.0,1.0
3851,13658,2357,0,2357,0.0,1.0
3852,13659,593,0,593,0.0,1.0
3853,13660,1891,0,1891,0.0,1.0
3854,13661,1646,0,1646,0.0,1.0
3855,13662,16582,11259,5323,0.679,0.321
3856,13664,399,0,399,0.0,1.0
3857,13665,882,0,882,0.0,1.0
3858,13666,266,0,266,0.0,1.0
3859,13667,3181,0,3181,0.0,1.0
3860,13668,3329,0,3329,0.0,1.0
3861,13669,16452,11344,5108,0.69,0.31
3862,13670,430,0,430,0.0,1.0
3863,13672,602,0,602,0.0,1.0
3864,13673,2249,0,2249,0.0,1.0
3865,13674,126,0,126,0.0,1.0
3866,13675,160,0,160,0.0,1.0
3867,13676,16646,9310,7336,0.559,0.441
3868,13677,93,0,93,0.0,1.0
3869,13678,211,0,211,0.0,1.0
3870,13679,1853,0,1853,0.0,1.0
3871,13680,1244,0,1244,0.0,1.0
3872,13681,897,0,897,0.0,1.0
3873,13682,877,0,877,0.0,1.0
3874,13684,1131,0,1131,0.0,1.0
3875,13685,2272,0,2272,0.0,1.0
3876,13687,479,0,479,0.0,1.0
3877,13690,846,0,846,0.0,1.0
3878,13691,3176,0,3176,0.0,1.0
3879,13692,27,0,27,0.0,1.0
3880,13693,503,0,503,0.0,1.0
3881,13694,1507,0,1507,0.0,1.0
3882,13695,134,0,134,0.0,1.0
3883,13696,87,0,87,0.0,1.0
3884,13697,2281,0,2281,0.0,1.0
3885,13730,2805,0,2805,0.0,1.0
3886,13731,1162,0,1162,0.0,1.0
3887,13732,8153,5160,2993,0.633,0.367
3888,13733,5216,120,5096,0.023,0.977
3889,13734,2287,0,2287,0.0,1.0
3890,13736,2338,0,2338,0.0,1.0
3891,13739,953,0,953,0.0,1.0
3892,13740,554,0,554,0.0,1.0
3893,13743,3806,0,3806,0.0,1.0
3894,13744,1137,42,1095,0.037,0.963
3895,13746,2539,0,2539,0.0,1.0
3896,13748,3800,2299,1501,0.605,0.395
3897,13750,1092,0,1092,0.0,1.0
3898,13751,189,0,189,0.0,1.0
3899,13752,782,0,782,0.0,1.0
3900,13753,5848,2953,2895,0.505,0.495
3901,13754,3310,0,3310,0.0,1.0
3902,13755,1228,0,1228,0.0,1.0
3903,13756,613,0,613,0.0,1.0
3904,13757,1045,0,1045,0.0,1.0
3905,13760,44264,39990,4274,0.903,0.097
3906,13774,201,0,201,0.0,1.0
3907,13775,1631,0,1631,0.0,1.0
3908,13776,513,0,513,0.0,1.0
3909,13777,727,0,727,0.0,1.0
3910,13778,5948,0,5948,0.0,1.0
3911,13780,1045,0,1045,0.0,1.0
3912,13782,755,0,755,0.0,1.0
3913,13783,2670,0,2670,0.0,1.0
3914,13784,172,0,172,0.0,1.0
3915,13786,464,0,464,0.0,1.0
3916,13787,3629,0,3629,0.0,1.0
3917,13788,991,0,991,0.0,1.0
3918,13790,19104,16602,2502,0.869,0.131
3919,13794,105,0,105,0.0,1.0
3920,13795,3800,2064,1736,0.543,0.457
3921,13796,1236,0,1236,0.0,1.0
3922,13797,2250,0,2250,0.0,1.0
3923,13801,1398,0,1398,0.0,1.0
3924,13802,718,0,718,0.0,1.0
3925,13803,3975,0,3975,0.0,1.0
3926,13804,391,0,391,0.0,1.0
3927,13806,205,0,205,0.0,1.0
3928,13807,1199,0,1199,0.0,1.0
3929,13808,1771,0,1771,0.0,1.0
3930,13809,1517,0,1517,0.0,1.0
3931,13810,1149,0,1149,0.0,1.0
3932,13811,4354,0,4354,0.0,1.0
3933,13812,2348,0,2348,0.0,1.0
3934,13813,977,0,977,0.0,1.0
3935,13815,13999,8265,5734,0.59,0.41
3936,13820,22455,17050,5405,0.759,0.241
3937,13825,3442,23,3419,0.007,0.993
3938,13826,58,0,58,0.0,1.0
3939,13827,11759,5071,6688,0.431,0.569
3940,13830,5042,0,5042,0.0,1.0
3941,13832,709,0,709,0.0,1.0
3942,13833,4255,530,3725,0.125,0.875
3943,13834,118,0,118,0.0,1.0
3944,13835,1511,0,1511,0.0,1.0
3945,13838,4409,3903,506,0.885,0.115
3946,13839,1405,0,1405,0.0,1.0
3947,13841,529,0,529,0.0,1.0
3948,13842,695,0,695,0.0,1.0
3949,13843,1888,0,1888,0.0,1.0
3950,13844,724,0,724,0.0,1.0
3951,13845,83,0,83,0.0,1.0
3952,13846,305,0,305,0.0,1.0
3953,13847,67,0,67,0.0,1.0
3954,13849,4551,1542,3009,0.339,0.661
3955,13850,22004,17094,4910,0.777,0.223
3956,13856,6596,3067,3529,0.465,0.535
3957,13859,182,0,182,0.0,1.0
3958,13860,94,0,94,0.0,1.0
3959,13861,432,156,276,0.361,0.639
3960,13862,4189,0,4189,0.0,1.0
3961,13863,688,0,688,0.0,1.0
3962,13864,1149,0,1149,0.0,1.0
3963,13865,6371,302,6069,0.047,0.953
3964,13901,19773,18405,1368,0.931,0.069
3965,13902,6177,6177,0,1.0,0.0
3966,13903,18763,14352,4411,0.765,0.235
3967,13904,9579,6824,2755,0.712,0.288
3968,13905,28026,25821,2205,0.921,0.079
3969,14001,9464,2982,6482,0.315,0.685
3970,14004,12704,1872,10832,0.147,0.853
3971,14005,1986,501,1485,0.252,0.748
3972,14006,9858,7827,2031,0.794,0.206
3973,14008,1467,0,1467,0.0,1.0
3974,14009,5672,2575,3097,0.454,0.546
3975,14011,9822,6327,3495,0.644,0.356
3976,14012,2362,0,2362,0.0,1.0
3977,14013,1751,0,1751,0.0,1.0
3978,14020,23306,17834,5472,0.765,0.235
3979,14024,1688,0,1688,0.0,1.0
3980,14025,3039,1623,1416,0.534,0.466
3981,14026,674,674,0,1.0,0.0
3982,14028,1595,491,1104,0.308,0.692
3983,14030,1807,21,1786,0.012,0.988
3984,14031,9392,7220,2172,0.769,0.231
3985,14032,7989,5126,2863,0.642,0.358
3986,14033,2219,0,2219,0.0,1.0
3987,14034,2742,1416,1326,0.516,0.484
3988,14035,125,0,125,0.0,1.0
3989,14036,5201,0,5201,0.0,1.0
3990,14037,1166,0,1166,0.0,1.0
3991,14039,101,0,101,0.0,1.0
3992,14040,2217,0,2217,0.0,1.0
3993,14041,237,0,237,0.0,1.0
3994,14042,3969,0,3969,0.0,1.0
3995,14043,24742,24742,0,1.0,0.0
3996,14047,6440,5568,872,0.865,0.135
3997,14048,15072,13723,1349,0.91,0.09
3998,14051,19533,18262,1271,0.935,0.065
3999,14052,17329,9627,7702,0.556,0.444
4000,14054,1344,0,1344,0.0,1.0
4001,14055,1405,0,1405,0.0,1.0
4002,14057,8116,3278,4838,0.404,0.596
4003,14058,2285,0,2285,0.0,1.0
4004,14059,8933,3544,5389,0.397,0.603
4005,14060,443,0,443,0.0,1.0
4006,14061,349,0,349,0.0,1.0
4007,14062,3329,0,3329,0.0,1.0
4008,14063,14870,11791,3079,0.793,0.207
4009,14065,1896,154,1742,0.081,0.919
4010,14066,1318,0,1318,0.0,1.0
4011,14067,5040,1033,4007,0.205,0.795
4012,14068,7150,7144,6,0.999,0.001
4013,14069,844,0,844,0.0,1.0
4014,14070,6732,4907,1825,0.729,0.271
4015,14072,20374,18278,2096,0.897,0.103
4016,14075,41937,39508,2429,0.942,0.058
4017,14080,4330,0,4330,0.0,1.0
4018,14081,3095,749,2346,0.242,0.758
4019,14082,426,0,426,0.0,1.0
4020,14085,7353,7074,279,0.962,0.038
4021,14086,31847,28618,3229,0.899,0.101
4022,14091,1079,0,1079,0.0,1.0
4023,14092,11086,9425,1661,0.85,0.15
4024,14094,50666,37350,13316,0.737,0.263
4025,14098,2958,0,2958,0.0,1.0
4026,14101,1905,0,1905,0.0,1.0
4027,14102,1281,0,1281,0.0,1.0
4028,14103,11183,6502,4681,0.581,0.419
4029,14105,4566,1880,2686,0.412,0.588
4030,14108,5882,3158,2724,0.537,0.463
4031,14109,1117,1117,0,1.0,0.0
4032,14111,3352,0,3352,0.0,1.0
4033,14112,85,85,0,1.0,0.0
4034,14113,703,0,703,0.0,1.0
4035,14120,45100,40569,4531,0.9,0.1
4036,14125,3782,0,3782,0.0,1.0
4037,14126,588,504,84,0.857,0.143
4038,14127,29961,25645,4316,0.856,0.144
4039,14129,1591,0,1591,0.0,1.0
4040,14130,265,0,265,0.0,1.0
4041,14131,5283,0,5283,0.0,1.0
4042,14132,6218,1526,4692,0.245,0.755
4043,14134,104,0,104,0.0,1.0
4044,14135,119,0,119,0.0,1.0
4045,14136,5033,3050,1983,0.606,0.394
4046,14138,2018,0,2018,0.0,1.0
4047,14139,2125,0,2125,0.0,1.0
4048,14141,7728,3897,3831,0.504,0.496
4049,14143,1214,0,1214,0.0,1.0
4050,14145,1618,0,1618,0.0,1.0
4051,14150,41676,41676,0,1.0,0.0
4052,14167,1663,0,1663,0.0,1.0
4053,14168,36,0,36,0.0,1.0
4054,14169,151,0,151,0.0,1.0
4055,14170,2286,475,1811,0.208,0.792
4056,14171,2077,0,2077,0.0,1.0
4057,14172,3200,1473,1727,0.46,0.54
4058,14173,396,298,98,0.753,0.247
4059,14174,5794,3648,2146,0.63,0.37
4060,14201,11549,11549,0,1.0,0.0
4061,14202,3911,3911,0,1.0,0.0
4062,14203,1618,1618,0,1.0,0.0
4063,14204,8691,8691,0,1.0,0.0
4064,14206,20751,20751,0,1.0,0.0
4065,14207,23552,23552,0,1.0,0.0
4066,14208,11125,11125,0,1.0,0.0
4067,14209,7926,7926,0,1.0,0.0
4068,14210,14694,14694,0,1.0,0.0
4069,14211,22611,22611,0,1.0,0.0
4070,14212,10641,10641,0,1.0,0.0
4071,14213,24465,24465,0,1.0,0.0
4072,14214,19775,19775,0,1.0,0.0
4073,14215,39999,39999,0,1.0,0.0
4074,14216,22431,22431,0,1.0,0.0
4075,14217,23480,23480,0,1.0,0.0
4076,14218,19039,19039,0,1.0,0.0
4077,14219,11536,11536,0,1.0,0.0
4078,14220,24227,24227,0,1.0,0.0
4079,14221,53555,53530,25,1.0,0.0
4080,14222,14046,14046,0,1.0,0.0
4081,14223,22665,22665,0,1.0,0.0
4082,14224,39889,39889,0,1.0,0.0
4083,14225,33385,33385,0,1.0,0.0
4084,14226,29267,29267,0,1.0,0.0
4085,14227,23426,23426,0,1.0,0.0
4086,14228,20857,19577,1280,0.939,0.061
4087,14261,5713,5713,0,1.0,0.0
4088,14301,12817,12817,0,1.0,0.0
4089,14302,107,107,0,1.0,0.0
4090,14303,5981,5981,0,1.0,0.0
4091,14304,30389,29915,474,0.984,0.016
4092,14305,16898,16898,0,1.0,0.0
4093,14411,14491,8171,6320,0.564,0.436
4094,14414,7142,4973,2169,0.696,0.304
4095,14415,132,0,132,0.0,1.0
4096,14416,3817,1226,2591,0.321,0.679
4097,14418,1325,0,1325,0.0,1.0
4098,14420,20467,13998,6469,0.684,0.316
4099,14422,2468,0,2468,0.0,1.0
4100,14423,4799,0,4799,0.0,1.0
4101,14424,27007,15675,11332,0.58,0.42
4102,14425,10717,9109,1608,0.85,0.15
4103,14427,1964,147,1817,0.075,0.925
4104,14428,8096,3342,4754,0.413,0.587
4105,14432,5726,2782,2944,0.486,0.514
4106,14433,4629,0,4629,0.0,1.0
4107,14435,2941,428,2513,0.146,0.854
4108,14437,11415,5141,6274,0.45,0.55
4109,14441,325,319,6,0.982,0.018
4110,14445,8019,8019,0,1.0,0.0
4111,14450,41104,39389,1715,0.958,0.042
4112,14454,11073,8871,2202,0.801,0.199
4113,14456,20087,15129,4958,0.753,0.247
4114,14462,655,0,655,0.0,1.0
4115,14464,7524,4400,3124,0.585,0.415
4116,14466,1719,0,1719,0.0,1.0
4117,14467,9105,8618,487,0.947,0.053
4118,14468,17813,9973,7840,0.56,0.44
4119,14469,6220,0,6220,0.0,1.0
4120,14470,8016,1793,6223,0.224,0.776
4121,14471,2672,0,2672,0.0,1.0
4122,14472,8598,3009,5589,0.35,0.65
4123,14475,234,0,234,0.0,1.0
4124,14476,2288,0,2288,0.0,1.0
4125,14477,1732,0,1732,0.0,1.0
4126,14478,1595,1055,540,0.661,0.339
4127,14479,275,0,275,0.0,1.0
4128,14480,833,782,51,0.939,0.061
4129,14481,1820,508,1312,0.279,0.721
4130,14482,8275,4275,4000,0.517,0.483
4131,14485,4267,2261,2006,0.53,0.47
4132,14486,308,0,308,0.0,1.0
4133,14487,6025,3106,2919,0.516,0.484
4134,14489,7192,4018,3174,0.559,0.441
4135,14502,10691,6594,4097,0.617,0.383
4136,14504,1701,1701,0,1.0,0.0
4137,14505,5393,0,5393,0.0,1.0
4138,14506,1325,912,413,0.688,0.312
4139,14507,1351,0,1351,0.0,1.0
4140,14510,4895,3520,1375,0.719,0.281
4141,14511,497,0,497,0.0,1.0
4142,14512,4721,0,4721,0.0,1.0
4143,14513,13976,9220,4756,0.66,0.34
4144,14514,6389,6326,63,0.99,0.01
4145,14516,2365,0,2365,0.0,1.0
4146,14517,2883,0,2883,0.0,1.0
4147,14519,11581,5576,6005,0.481,0.519
4148,14521,2761,0,2761,0.0,1.0
4149,14522,9565,5572,3993,0.583,0.417
4150,14525,2865,0,2865,0.0,1.0
4151,14526,19804,18725,1079,0.946,0.054
4152,14527,12820,5920,6900,0.462,0.538
4153,14529,67,0,67,0.0,1.0
4154,14530,5575,3450,2125,0.619,0.381
4155,14532,4431,0,4431,0.0,1.0
4156,14533,2000,0,2000,0.0,1.0
4157,14534,31426,29449,1977,0.937,0.063
4158,14536,687,0,687,0.0,1.0
4159,14537,207,178,29,0.86,0.14
4160,14539,242,0,242,0.0,1.0
4161,14541,4129,0,4129,0.0,1.0
4162,14542,97,0,97,0.0,1.0
4163,14543,3152,372,2780,0.118,0.882
4164,14544,2101,62,2039,0.03,0.97
4165,14545,173,0,173,0.0,1.0
4166,14546,4695,2769,1926,0.59,0.41
4167,14548,4249,2036,2213,0.479,0.521
4168,14549,91,91,0,1.0,0.0
4169,14550,1537,0,1537,0.0,1.0
4170,14551,5651,2533,3118,0.448,0.552
4171,14555,974,0,974,0.0,1.0
4172,14559,18057,12115,5942,0.671,0.329
4173,14560,2164,0,2164,0.0,1.0
4174,14561,3086,0,3086,0.0,1.0
4175,14564,14487,9984,4503,0.689,0.311
4176,14568,6048,3086,2962,0.51,0.49
4177,14569,6211,3017,3194,0.486,0.514
4178,14571,1176,0,1176,0.0,1.0
4179,14572,5081,0,5081,0.0,1.0
4180,14580,50587,48352,2235,0.956,0.044
4181,14585,120,0,120,0.0,1.0
4182,14586,10256,9909,347,0.966,0.034
4183,14588,749,0,749,0.0,1.0
4184,14589,7854,387,7467,0.049,0.951
4185,14590,5446,0,5446,0.0,1.0
4186,14591,1748,0,1748,0.0,1.0
4187,14592,110,0,110,0.0,1.0
4188,14604,1743,1743,0,1.0,0.0
4189,14605,12610,12610,0,1.0,0.0
4190,14606,28255,28255,0,1.0,0.0
4191,14607,16223,16223,0,1.0,0.0
4192,14608,12268,12268,0,1.0,0.0
4193,14609,42571,42571,0,1.0,0.0
4194,14610,14233,14233,0,1.0,0.0
4195,14611,17396,17396,0,1.0,0.0
4196,14612,34515,34515,0,1.0,0.0
4197,14613,14730,14730,0,1.0,0.0
4198,14614,1224,1224,0,1.0,0.0
4199,14615,16099,16099,0,1.0,0.0
4200,14616,28534,28534,0,1.0,0.0
4201,14617,22789,22789,0,1.0,0.0
4202,14618,22920,22920,0,1.0,0.0
4203,14619,14749,14749,0,1.0,0.0
4204,14620,25141,25141,0,1.0,0.0
4205,14621,33802,33802,0,1.0,0.0
4206,14622,12108,12108,0,1.0,0.0
4207,14623,27173,26671,502,0.982,0.018
4208,14624,36296,36183,113,0.997,0.003
4209,14625,10387,10387,0,1.0,0.0
4210,14626,30041,29701,340,0.989,0.011
4211,14627,2320,2320,0,1.0,0.0
4212,14701,40730,34846,5884,0.856,0.144
4213,14706,6356,2672,3684,0.42,0.58
4214,14707,239,0,239,0.0,1.0
4215,14708,183,0,183,0.0,1.0
4216,14709,1535,0,1535,0.0,1.0
4217,14710,3540,461,3079,0.13,0.87
4218,14711,1766,0,1766,0.0,1.0
4219,14712,3342,1136,2206,0.34,0.66
4220,14714,487,0,487,0.0,1.0
4221,14715,2747,0,2747,0.0,1.0
4222,14716,3104,0,3104,0.0,1.0
4223,14717,636,0,636,0.0,1.0
4224,14718,2163,0,2163,0.0,1.0
4225,14719,3497,0,3497,0.0,1.0
4226,14720,675,675,0,1.0,0.0
4227,14721,230,0,230,0.0,1.0
4228,14722,153,0,153,0.0,1.0
4229,14723,1295,0,1295,0.0,1.0
4230,14724,2540,0,2540,0.0,1.0
4231,14726,2156,0,2156,0.0,1.0
4232,14727,5450,0,5450,0.0,1.0
4233,14728,1031,0,1031,0.0,1.0
4234,14729,948,0,948,0.0,1.0
4235,14731,1576,0,1576,0.0,1.0
4236,14732,211,0,211,0.0,1.0
4237,14733,3833,2564,1269,0.669,0.331
4238,14735,2751,0,2751,0.0,1.0
4239,14736,282,0,282,0.0,1.0
4240,14737,4252,0,4252,0.0,1.0
4241,14738,3651,0,3651,0.0,1.0
4242,14739,2903,0,2903,0.0,1.0
4243,14740,1431,0,1431,0.0,1.0
4244,14741,1873,0,1873,0.0,1.0
4245,14742,314,314,0,1.0,0.0
4246,14743,1783,352,1431,0.197,0.803
4247,14744,2094,0,2094,0.0,1.0
4248,14747,2289,0,2289,0.0,1.0
4249,14748,746,221,525,0.296,0.704
4250,14750,4426,3408,1018,0.77,0.23
4251,14752,169,0,169,0.0,1.0
4252,14753,1166,10,1156,0.009,0.991
4253,14754,667,0,667,0.0,1.0
4254,14755,2916,0,2916,0.0,1.0
4255,14756,110,0,110,0.0,1.0
4256,14757,3487,0,3487,0.0,1.0
4257,14760,18775,16282,2493,0.867,0.133
4258,14767,2088,0,2088,0.0,1.0
4259,14769,919,0,919,0.0,1.0
4260,14770,2963,1402,1561,0.473,0.527
4261,14772,4255,0,4255,0.0,1.0
4262,14774,151,0,151,0.0,1.0
4263,14775,2537,0,2537,0.0,1.0
4264,14777,667,0,667,0.0,1.0
4265,14778,1453,1453,0,1.0,0.0
4266,14779,6932,5517,1415,0.796,0.204
4267,14781,2225,0,2225,0.0,1.0
4268,14782,2401,0,2401,0.0,1.0
4269,14783,320,0,320,0.0,1.0
4270,14784,1033,0,1033,0.0,1.0
4271,14787,5121,3015,2106,0.589,0.411
4272,14788,163,163,0,1.0,0.0
4273,14801,5475,0,5475,0.0,1.0
4274,14802,4135,4135,0,1.0,0.0
4275,14803,1174,187,987,0.159,0.841
4276,14804,1479,0,1479,0.0,1.0
4277,14805,1100,0,1100,0.0,1.0
4278,14806,2269,0,2269,0.0,1.0
4279,14807,3076,946,2130,0.308,0.692
4280,14808,591,0,591,0.0,1.0
4281,14809,2552,0,2552,0.0,1.0
4282,14810,12356,6964,5392,0.564,0.436
4283,14812,3478,0,3478,0.0,1.0
4284,14813,2520,0,2520,0.0,1.0
4285,14814,1931,1679,252,0.869,0.131
4286,14815,946,0,946,0.0,1.0
4287,14816,520,0,520,0.0,1.0
4288,14817,2380,0,2380,0.0,1.0
4289,14818,1745,0,1745,0.0,1.0
4290,14819,733,0,733,0.0,1.0
4291,14820,784,0,784,0.0,1.0
4292,14821,3314,0,3314,0.0,1.0
4293,14822,1169,0,1169,0.0,1.0
4294,14823,3754,0,3754,0.0,1.0
4295,14824,678,0,678,0.0,1.0
4296,14825,919,0,919,0.0,1.0
4297,14826,2216,0,2216,0.0,1.0
4298,14827,191,191,0,1.0,0.0
4299,14830,19850,13447,6403,0.677,0.323
4300,14836,1009,0,1009,0.0,1.0
4301,14837,5648,0,5648,0.0,1.0
4302,14838,1956,0,1956,0.0,1.0
4303,14839,793,0,793,0.0,1.0
4304,14840,3061,0,3061,0.0,1.0
4305,14841,915,0,915,0.0,1.0
4306,14842,938,0,938,0.0,1.0
4307,14843,13043,10051,2992,0.771,0.229
4308,14845,20453,16258,4195,0.795,0.205
4309,14846,792,0,792,0.0,1.0
4310,14847,2398,0,2398,0.0,1.0
4311,14850,63886,50351,13535,0.788,0.212
4312,14853,2755,2755,0,1.0,0.0
4313,14854,37,0,37,0.0,1.0
4314,14855,956,0,956,0.0,1.0
4315,14856,215,160,55,0.744,0.256
4316,14858,1598,0,1598,0.0,1.0
4317,14859,1029,0,1029,0.0,1.0
4318,14860,1039,0,1039,0.0,1.0
4319,14861,1404,0,1404,0.0,1.0
4320,14864,1307,313,994,0.239,0.761
4321,14865,2607,1456,1151,0.558,0.442
4322,14867,5569,0,5569,0.0,1.0
4323,14869,1378,0,1378,0.0,1.0
4324,14870,9821,7310,2511,0.744,0.256
4325,14871,5456,2724,2732,0.499,0.501
4326,14872,605,310,295,0.512,0.488
4327,14873,2448,0,2448,0.0,1.0
4328,14874,250,0,250,0.0,1.0
4329,14877,401,0,401,0.0,1.0
4330,14878,781,0,781,0.0,1.0
4331,14879,2398,0,2398,0.0,1.0
4332,14880,1668,0,1668,0.0,1.0
4333,14881,192,0,192,0.0,1.0
4334,14882,3826,431,3395,0.113,0.887
4335,14883,4136,0,4136,0.0,1.0
4336,14884,273,0,273,0.0,1.0
4337,14885,873,0,873,0.0,1.0
4338,14886,6753,0,6753,0.0,1.0
4339,14889,1590,0,1590,0.0,1.0
4340,14891,4149,2001,2148,0.482,0.518
4341,14892,8189,5154,3035,0.629,0.371
4342,14893,6,0,6,0.0,1.0
4343,14894,1454,0,1454,0.0,1.0
4344,14895,9616,6084,3532,0.633,0.367
4345,14897,980,0,980,0.0,1.0
4346,14898,1734,0,1734,0.0,1.0
4347,14901,16736,15536,1200,0.928,0.072
4348,14903,7567,5853,1714,0.773,0.227
4349,14904,16269,15924,345,0.979,0.021
4350,14905,9070,8915,155,0.983,0.017
4351,15001,31964,26403,5561,0.826,0.174
4352,15003,11861,11554,307,0.974,0.026
4353,15004,351,351,0,1.0,0.0
4354,15005,9450,7568,1882,0.801,0.199
4355,15006,240,240,0,1.0,0.0
4356,15007,323,279,44,0.864,0.136
4357,15009,15082,12159,2923,0.806,0.194
4358,15010,28425,22536,5889,0.793,0.207
4359,15012,15905,12552,3353,0.789,0.211
4360,15014,3184,3184,0,1.0,0.0
4361,15015,1175,1175,0,1.0,0.0
4362,15017,16213,16055,158,0.99,0.01
4363,15018,821,644,177,0.784,0.216
4364,15019,1719,370,1349,0.215,0.785
4365,15020,231,153,78,0.662,0.338
4366,15021,7352,2386,4966,0.325,0.675
4367,15022,10340,8574,1766,0.829,0.171
4368,15024,9029,8049,980,0.891,0.109
4369,15025,15944,15543,401,0.975,0.025
4370,15026,3390,22,3368,0.006,0.994
4371,15027,2201,2149,52,0.976,0.024
4372,15028,142,100,42,0.704,0.296
4373,15030,1128,1128,0,1.0,0.0
4374,15031,513,513,0,1.0,0.0
4375,15033,4910,4910,0,1.0,0.0
4376,15034,1792,1792,0,1.0,0.0
4377,15035,2129,2129,0,1.0,0.0
4378,15037,10894,8041,2853,0.738,0.262
4379,15038,325,307,18,0.945,0.055
4380,15042,8105,5732,2373,0.707,0.293
4381,15043,2458,0,2458,0.0,1.0
4382,15044,27049,23610,3439,0.873,0.127
4383,15045,4483,4483,0,1.0,0.0
4384,15046,2640,2640,0,1.0,0.0
4385,15047,151,151,0,1.0,0.0
4386,15049,895,895,0,1.0,0.0
4387,15050,2431,0,2431,0.0,1.0
4388,15051,461,461,0,1.0,0.0
4389,15052,3483,1321,2162,0.379,0.621
4390,15053,154,154,0,1.0,0.0
4391,15054,375,375,0,1.0,0.0
4392,15055,1360,1360,0,1.0,0.0
4393,15056,1140,1140,0,1.0,0.0
4394,15057,13930,8793,5137,0.631,0.369
4395,15059,4193,2806,1387,0.669,0.331
4396,15060,790,790,0,1.0,0.0
4397,15061,12799,12212,587,0.954,0.046
4398,15062,7731,7725,6,0.999,0.001
4399,15063,11677,9416,2261,0.806,0.194
4400,15064,382,382,0,1.0,0.0
4401,15065,11588,10760,828,0.929,0.071
4402,15066,12785,10041,2744,0.785,0.215
4403,15067,2281,2186,95,0.958,0.042
4404,15068,38785,34053,4732,0.878,0.122
4405,15071,9956,8071,1885,0.811,0.189
4406,15072,101,101,0,1.0,0.0
4407,15074,8874,6822,2052,0.769,0.231
4408,15075,128,128,0,1.0,0.0
4409,15076,849,756,93,0.89,0.11
4410,15077,198,0,198,0.0,1.0
4411,15078,523,516,7,0.987,0.013
4412,15081,475,475,0,1.0,0.0
4413,15082,350,347,3,0.991,0.009
4414,15083,952,693,259,0.728,0.272
4415,15084,10130,6782,3348,0.669,0.331
4416,15085,7944,7145,799,0.899,0.101
4417,15086,300,300,0,1.0,0.0
4418,15087,234,167,67,0.714,0.286
4419,15088,535,535,0,1.0,0.0
4420,15089,6262,3684,2578,0.588,0.412
4421,15090,21202,20029,1173,0.945,0.055
4422,15101,24292,23536,756,0.969,0.031
4423,15102,29529,29529,0,1.0,0.0
4424,15104,9038,9038,0,1.0,0.0
4425,15106,18536,17728,808,0.956,0.044
4426,15108,40153,39798,355,0.991,0.009
4427,15110,5565,5565,0,1.0,0.0
4428,15112,3292,3292,0,1.0,0.0
4429,15116,14427,14427,0,1.0,0.0
4430,15120,18931,18931,0,1.0,0.0
4431,15122,20131,20131,0,1.0,0.0
4432,15126,7014,5543,1471,0.79,0.21
4433,15129,10920,10899,21,0.998,0.002
4434,15131,8240,8130,110,0.987,0.013
4435,15132,21472,21472,0,1.0,0.0
4436,15133,6432,6323,109,0.983,0.017
4437,15135,5139,4697,442,0.914,0.086
4438,15136,21849,21849,0,1.0,0.0
4439,15137,10228,10228,0,1.0,0.0
4440,15139,6307,6303,4,0.999,0.001
4441,15140,3294,3294,0,1.0,0.0
4442,15142,1163,1163,0,1.0,0.0
4443,15143,19660,15959,3701,0.812,0.188
4444,15144,4142,4142,0,1.0,0.0
4445,15145,7132,7132,0,1.0,0.0
4446,15146,28323,28323,0,1.0,0.0
4447,15147,17395,17395,0,1.0,0.0
4448,15148,2814,2814,0,1.0,0.0
4449,15201,12713,12713,0,1.0,0.0
4450,15202,19685,19685,0,1.0,0.0
4451,15203,9949,9949,0,1.0,0.0
4452,15204,8329,8329,0,1.0,0.0
4453,15205,21865,21865,0,1.0,0.0
4454,15206,28615,28615,0,1.0,0.0
4455,15207,11268,11268,0,1.0,0.0
4456,15208,10406,10406,0,1.0,0.0
4457,15209,12438,12438,0,1.0,0.0
4458,15210,25954,25954,0,1.0,0.0
4459,15211,11081,11081,0,1.0,0.0
4460,15212,27895,27895,0,1.0,0.0
4461,15213,30844,30844,0,1.0,0.0
4462,15214,14352,14352,0,1.0,0.0
4463,15215,12615,12615,0,1.0,0.0
4464,15216,23350,23350,0,1.0,0.0
4465,15217,27220,27220,0,1.0,0.0
4466,15218,13851,13851,0,1.0,0.0
4467,15219,16696,16696,0,1.0,0.0
4468,15220,17718,17718,0,1.0,0.0
4469,15221,31060,31060,0,1.0,0.0
4470,15222,3294,3294,0,1.0,0.0
4471,15223,7236,7236,0,1.0,0.0
4472,15224,10141,10141,0,1.0,0.0
4473,15225,1084,1084,0,1.0,0.0
4474,15226,13974,13974,0,1.0,0.0
4475,15227,28156,28156,0,1.0,0.0
4476,15228,17595,17595,0,1.0,0.0
4477,15229,13825,13825,0,1.0,0.0
4478,15232,11374,11374,0,1.0,0.0
4479,15233,4451,4451,0,1.0,0.0
4480,15234,14056,14056,0,1.0,0.0
4481,15235,34580,34580,0,1.0,0.0
4482,15236,29724,29724,0,1.0,0.0
4483,15237,41895,41895,0,1.0,0.0
4484,15238,13162,12997,165,0.987,0.013
4485,15239,21024,19824,1200,0.943,0.057
4486,15241,20395,20395,0,1.0,0.0
4487,15243,13406,13406,0,1.0,0.0
4488,15260,0,0,0,,
4489,15290,0,0,0,,
4490,15301,49331,37737,11594,0.765,0.235
4491,15310,290,0,290,0.0,1.0
4492,15311,1391,0,1391,0.0,1.0
4493,15312,3579,0,3579,0.0,1.0
4494,15313,377,0,377,0.0,1.0
4495,15314,3788,1898,1890,0.501,0.499
4496,15315,776,0,776,0.0,1.0
4497,15316,131,0,131,0.0,1.0
4498,15317,36535,33443,3092,0.915,0.085
4499,15320,5384,3359,2025,0.624,0.376
4500,15321,1676,1676,0,1.0,0.0
4501,15322,2018,0,2018,0.0,1.0
4502,15323,4542,0,4542,0.0,1.0
4503,15324,632,0,632,0.0,1.0
4504,15325,439,0,439,0.0,1.0
4505,15327,1527,0,1527,0.0,1.0
4506,15329,1709,0,1709,0.0,1.0
4507,15330,5299,1283,4016,0.242,0.758
4508,15331,1090,1089,1,0.999,0.001
4509,15332,8148,5060,3088,0.621,0.379
4510,15333,2150,810,1340,0.377,0.623
4511,15334,113,0,113,0.0,1.0
4512,15337,744,0,744,0.0,1.0
4513,15338,1606,0,1606,0.0,1.0
4514,15340,1469,0,1469,0.0,1.0
4515,15341,869,0,869,0.0,1.0
4516,15342,4818,4793,25,0.995,0.005
4517,15344,1450,0,1450,0.0,1.0
4518,15345,1642,0,1642,0.0,1.0
4519,15346,749,0,749,0.0,1.0
4520,15347,582,582,0,1.0,0.0
4521,15348,283,283,0,1.0,0.0
4522,15349,1737,0,1737,0.0,1.0
4523,15350,425,425,0,1.0,0.0
4524,15351,901,807,94,0.896,0.104
4525,15352,987,0,987,0.0,1.0
4526,15353,64,0,64,0.0,1.0
4527,15357,1661,0,1661,0.0,1.0
4528,15358,923,0,923,0.0,1.0
4529,15359,174,0,174,0.0,1.0
4530,15360,1731,25,1706,0.014,0.986
4531,15361,151,151,0,1.0,0.0
4532,15362,767,0,767,0.0,1.0
4533,15363,760,760,0,1.0,0.0
4534,15364,869,0,869,0.0,1.0
4535,15366,164,0,164,0.0,1.0
4536,15367,8731,8129,602,0.931,0.069
4537,15368,473,470,3,0.994,0.006
4538,15370,14870,8665,6205,0.583,0.417
4539,15376,1740,0,1740,0.0,1.0
4540,15377,724,0,724,0.0,1.0
4541,15378,106,0,106,0.0,1.0
4542,15379,132,0,132,0.0,1.0
4543,15380,719,0,719,0.0,1.0
4544,15401,32288,26779,5509,0.829,0.171
4545,15410,905,121,784,0.134,0.866
4546,15411,661,0,661,0.0,1.0
4547,15412,470,302,168,0.643,0.357
4548,15413,551,241,310,0.437,0.563
4549,15417,9469,7106,2363,0.75,0.25
4550,15419,4492,4457,35,0.992,0.008
4551,15420,251,116,135,0.462,0.538
4552,15421,112,0,112,0.0,1.0
4553,15422,220,0,220,0.0,1.0
4554,15423,1781,194,1587,0.109,0.891
4555,15424,2489,0,2489,0.0,1.0
4556,15425,19270,13806,5464,0.716,0.284
4557,15427,1091,0,1091,0.0,1.0
4558,15428,1806,436,1370,0.241,0.759
4559,15429,126,0,126,0.0,1.0
4560,15430,314,314,0,1.0,0.0
4561,15431,4744,1721,3023,0.363,0.637
4562,15432,427,328,99,0.768,0.232
4563,15433,741,45,696,0.061,0.939
4564,15434,313,299,14,0.955,0.045
4565,15435,437,0,437,0.0,1.0
4566,15436,2740,2293,447,0.837,0.163
4567,15437,2573,0,2573,0.0,1.0
4568,15438,2221,896,1325,0.403,0.597
4569,15440,349,0,349,0.0,1.0
4570,15442,2105,108,1997,0.051,0.949
4571,15443,377,0,377,0.0,1.0
4572,15444,517,403,114,0.779,0.221
4573,15445,2693,1668,1025,0.619,0.381
4574,15446,324,0,324,0.0,1.0
4575,15447,181,0,181,0.0,1.0
4576,15448,192,0,192,0.0,1.0
4577,15449,184,0,184,0.0,1.0
4578,15450,2323,2120,203,0.913,0.087
4579,15451,955,0,955,0.0,1.0
4580,15454,237,0,237,0.0,1.0
4581,15455,298,220,78,0.738,0.262
4582,15456,2976,2245,731,0.754,0.246
4583,15458,2379,475,1904,0.2,0.8
4584,15459,1763,0,1763,0.0,1.0
4585,15460,120,0,120,0.0,1.0
4586,15461,4333,3839,494,0.886,0.114
4587,15462,398,0,398,0.0,1.0
4588,15463,64,0,64,0.0,1.0
4589,15464,1536,0,1536,0.0,1.0
4590,15466,458,0,458,0.0,1.0
4591,15467,141,0,141,0.0,1.0
4592,15468,2303,0,2303,0.0,1.0
4593,15469,2331,0,2331,0.0,1.0
4594,15470,982,0,982,0.0,1.0
4595,15472,306,306,0,1.0,0.0
4596,15473,3862,0,3862,0.0,1.0
4597,15474,2049,0,2049,0.0,1.0
4598,15475,1356,975,381,0.719,0.281
4599,15476,157,157,0,1.0,0.0
4600,15477,855,855,0,1.0,0.0
4601,15478,6446,437,6009,0.068,0.932
4602,15479,2113,0,2113,0.0,1.0
4603,15480,1946,0,1946,0.0,1.0
4604,15482,604,0,604,0.0,1.0
4605,15483,513,459,54,0.895,0.105
4606,15484,328,234,94,0.713,0.287
4607,15486,2303,601,1702,0.261,0.739
4608,15489,389,213,176,0.548,0.452
4609,15490,628,0,628,0.0,1.0
4610,15492,108,0,108,0.0,1.0
4611,15501,16861,9991,6870,0.593,0.407
4612,15502,191,0,191,0.0,1.0
4613,15510,2229,2229,0,1.0,0.0
4614,15520,293,0,293,0.0,1.0
4615,15521,1872,0,1872,0.0,1.0
4616,15522,12036,4668,7368,0.388,0.612
4617,15530,5368,0,5368,0.0,1.0
4618,15531,3861,0,3861,0.0,1.0
4619,15532,142,0,142,0.0,1.0
4620,15533,1370,0,1370,0.0,1.0
4621,15534,932,0,932,0.0,1.0
4622,15535,2203,0,2203,0.0,1.0
4623,15536,459,0,459,0.0,1.0
4624,15537,7952,3245,4707,0.408,0.592
4625,15538,824,0,824,0.0,1.0
4626,15539,498,0,498,0.0,1.0
4627,15540,290,0,290,0.0,1.0
4628,15541,3721,363,3358,0.098,0.902
4629,15542,1175,0,1175,0.0,1.0
4630,15544,264,0,264,0.0,1.0
4631,15545,2879,31,2848,0.011,0.989
4632,15546,386,0,386,0.0,1.0
4633,15547,504,0,504,0.0,1.0
4634,15550,1699,0,1699,0.0,1.0
4635,15551,860,0,860,0.0,1.0
4636,15552,6115,2596,3519,0.425,0.575
4637,15554,2553,0,2553,0.0,1.0
4638,15555,112,0,112,0.0,1.0
4639,15557,3684,0,3684,0.0,1.0
4640,15558,2126,0,2126,0.0,1.0
4641,15559,1968,0,1968,0.0,1.0
4642,15560,175,0,175,0.0,1.0
4643,15561,168,0,168,0.0,1.0
4644,15562,201,0,201,0.0,1.0
4645,15563,3345,0,3345,0.0,1.0
4646,15564,50,0,50,0.0,1.0
4647,15601,59483,51587,7896,0.867,0.133
4648,15610,3738,0,3738,0.0,1.0
4649,15611,543,506,37,0.932,0.068
4650,15612,474,194,280,0.409,0.591
4651,15613,13933,5656,8277,0.406,0.594
4652,15615,387,14,373,0.036,0.964
4653,15616,23,23,0,1.0,0.0
4654,15617,367,367,0,1.0,0.0
4655,15618,2634,0,2634,0.0,1.0
4656,15620,911,875,36,0.96,0.04
4657,15621,47,47,0,1.0,0.0
4658,15622,1387,0,1387,0.0,1.0
4659,15623,762,635,127,0.833,0.167
4660,15624,410,0,410,0.0,1.0
4661,15625,144,144,0,1.0,0.0
4662,15626,5105,5026,79,0.985,0.015
4663,15627,6544,4645,1899,0.71,0.29
4664,15628,525,0,525,0.0,1.0
4665,15629,676,676,0,1.0,0.0
4666,15631,1075,1016,59,0.945,0.055
4667,15632,9363,6073,3290,0.649,0.351
4668,15633,293,0,293,0.0,1.0
4669,15634,523,523,0,1.0,0.0
4670,15635,220,0,220,0.0,1.0
4671,15636,3946,3817,129,0.967,0.033
4672,15637,1861,1196,665,0.643,0.357
4673,15638,288,288,0,1.0,0.0
4674,15639,2301,1354,947,0.588,0.412
4675,15640,378,0,378,0.0,1.0
4676,15641,500,500,0,1.0,0.0
4677,15642,45286,42901,2385,0.947,0.053
4678,15644,18836,16466,2370,0.874,0.126
4679,15646,233,0,233,0.0,1.0
4680,15647,314,306,8,0.975,0.025
4681,15650,28432,21571,6861,0.759,0.241
4682,15655,423,160,263,0.378,0.622
4683,15656,10298,5908,4390,0.574,0.426
4684,15658,8916,3154,5762,0.354,0.646
4685,15660,323,0,323,0.0,1.0
4686,15661,504,504,0,1.0,0.0
4687,15662,271,271,0,1.0,0.0
4688,15663,455,0,455,0.0,1.0
4689,15665,1472,1472,0,1.0,0.0
4690,15666,16461,10114,6347,0.614,0.386
4691,15668,13139,10229,2910,0.779,0.221
4692,15670,3649,0,3649,0.0,1.0
4693,15671,865,248,617,0.287,0.713
4694,15672,3334,2120,1214,0.636,0.364
4695,15673,1296,1296,0,1.0,0.0
4696,15675,1003,911,92,0.908,0.092
4697,15676,437,397,40,0.908,0.092
4698,15677,389,0,389,0.0,1.0
4699,15678,476,403,73,0.847,0.153
4700,15679,3343,567,2776,0.17,0.83
4701,15680,101,0,101,0.0,1.0
4702,15681,5241,0,5241,0.0,1.0
4703,15683,8248,6153,2095,0.746,0.254
4704,15684,841,0,841,0.0,1.0
4705,15686,972,0,972,0.0,1.0
4706,15687,1476,0,1476,0.0,1.0
4707,15688,641,401,240,0.626,0.374
4708,15689,229,229,0,1.0,0.0
4709,15690,9078,6267,2811,0.69,0.31
4710,15691,70,70,0,1.0,0.0
4711,15692,941,941,0,1.0,0.0
4712,15693,189,189,0,1.0,0.0
4713,15695,337,0,337,0.0,1.0
4714,15696,384,384,0,1.0,0.0
4715,15697,3038,3029,9,0.997,0.003
4716,15698,791,0,791,0.0,1.0
4717,15701,34704,25600,9104,0.738,0.262
4718,15710,266,0,266,0.0,1.0
4719,15711,412,0,412,0.0,1.0
4720,15712,151,0,151,0.0,1.0
4721,15713,294,0,294,0.0,1.0
4722,15714,5323,3842,1481,0.722,0.278
4723,15715,621,0,621,0.0,1.0
4724,15716,683,673,10,0.985,0.015
4725,15717,10847,6103,4744,0.563,0.437
4726,15721,234,0,234,0.0,1.0
4727,15722,2432,999,1433,0.411,0.589
4728,15723,46,0,46,0.0,1.0
4729,15724,2412,227,2185,0.094,0.906
4730,15725,1446,0,1446,0.0,1.0
4731,15727,168,0,168,0.0,1.0
4732,15728,3701,0,3701,0.0,1.0
4733,15729,1537,0,1537,0.0,1.0
4734,15730,69,0,69,0.0,1.0
4735,15731,315,0,315,0.0,1.0
4736,15732,1669,0,1669,0.0,1.0
4737,15733,108,0,108,0.0,1.0
4738,15734,322,0,322,0.0,1.0
4739,15736,613,0,613,0.0,1.0
4740,15737,83,54,29,0.651,0.349
4741,15738,265,50,215,0.189,0.811
4742,15739,462,0,462,0.0,1.0
4743,15741,83,0,83,0.0,1.0
4744,15742,950,0,950,0.0,1.0
4745,15744,105,0,105,0.0,1.0
4746,15745,337,0,337,0.0,1.0
4747,15746,135,0,135,0.0,1.0
4748,15747,2027,0,2027,0.0,1.0
4749,15748,7060,2771,4289,0.392,0.608
4750,15750,245,71,174,0.29,0.71
4751,15752,54,0,54,0.0,1.0
4752,15753,513,0,513,0.0,1.0
4753,15754,502,436,66,0.869,0.131
4754,15756,207,0,207,0.0,1.0
4755,15757,1618,0,1618,0.0,1.0
4756,15759,3004,0,3004,0.0,1.0
4757,15760,152,0,152,0.0,1.0
4758,15761,111,0,111,0.0,1.0
4759,15762,823,0,823,0.0,1.0
4760,15764,163,0,163,0.0,1.0
4761,15765,1707,0,1707,0.0,1.0
4762,15767,14668,6394,8274,0.436,0.564
4763,15770,184,0,184,0.0,1.0
4764,15771,991,0,991,0.0,1.0
4765,15772,1715,0,1715,0.0,1.0
4766,15773,516,0,516,0.0,1.0
4767,15774,3029,0,3029,0.0,1.0
4768,15775,751,538,213,0.716,0.284
4769,15776,52,0,52,0.0,1.0
4770,15777,170,0,170,0.0,1.0
4771,15778,140,0,140,0.0,1.0
4772,15779,414,213,201,0.514,0.486
4773,15780,148,0,148,0.0,1.0
4774,15781,94,0,94,0.0,1.0
4775,15783,140,0,140,0.0,1.0
4776,15784,67,0,67,0.0,1.0
4777,15801,19270,13860,5410,0.719,0.281
4778,15821,164,0,164,0.0,1.0
4779,15823,1431,208,1223,0.145,0.855
4780,15824,5407,2648,2759,0.49,0.51
4781,15825,9562,4542,5020,0.475,0.525
4782,15827,231,0,231,0.0,1.0
4783,15828,286,0,286,0.0,1.0
4784,15829,1274,0,1274,0.0,1.0
4785,15832,328,0,328,0.0,1.0
4786,15834,4533,2677,1856,0.591,0.409
4787,15840,1993,1020,973,0.512,0.488
4788,15841,389,0,389,0.0,1.0
4789,15845,3197,0,3197,0.0,1.0
4790,15846,3636,0,3636,0.0,1.0
4791,15847,255,0,255,0.0,1.0
4792,15848,1027,0,1027,0.0,1.0
4793,15849,1399,0,1399,0.0,1.0
4794,15851,6671,2839,3832,0.426,0.574
4795,15853,6578,4410,2168,0.67,0.33
4796,15856,889,0,889,0.0,1.0
4797,15857,13212,9585,3627,0.725,0.275
4798,15860,1065,0,1065,0.0,1.0
4799,15861,174,0,174,0.0,1.0
4800,15863,225,0,225,0.0,1.0
4801,15864,1845,0,1845,0.0,1.0
4802,15865,1295,0,1295,0.0,1.0
4803,15866,261,0,261,0.0,1.0
4804,15868,1350,0,1350,0.0,1.0
4805,15870,1326,0,1326,0.0,1.0
4806,15901,4190,4190,0,1.0,0.0
4807,15902,12513,11161,1352,0.892,0.108
4808,15904,16608,14520,2088,0.874,0.126
4809,15905,21226,18720,2506,0.882,0.118
4810,15906,11144,9280,1864,0.833,0.167
4811,15909,5611,3843,1768,0.685,0.315
4812,15920,922,0,922,0.0,1.0
4813,15921,176,53,123,0.301,0.699
4814,15922,177,0,177,0.0,1.0
4815,15923,1770,0,1770,0.0,1.0
4816,15924,1034,0,1034,0.0,1.0
4817,15925,147,147,0,1.0,0.0
4818,15926,2676,0,2676,0.0,1.0
4819,15927,1176,0,1176,0.0,1.0
4820,15928,1974,897,1077,0.454,0.546
4821,15929,75,0,75,0.0,1.0
4822,15930,241,0,241,0.0,1.0
4823,15931,9148,4379,4769,0.479,0.521
4824,15934,218,117,101,0.537,0.463
4825,15935,2620,0,2620,0.0,1.0
4826,15936,1620,0,1620,0.0,1.0
4827,15937,779,0,779,0.0,1.0
4828,15938,2583,1485,1098,0.575,0.425
4829,15940,3992,2576,1416,0.645,0.355
4830,15942,2079,431,1648,0.207,0.793
4831,15943,3942,2958,984,0.75,0.25
4832,15944,3472,0,3472,0.0,1.0
4833,15945,198,0,198,0.0,1.0
4834,15946,7093,4691,2402,0.661,0.339
4835,15948,550,535,15,0.973,0.027
4836,15949,672,0,672,0.0,1.0
4837,15951,453,0,453,0.0,1.0
4838,15952,1413,0,1413,0.0,1.0
4839,15953,83,0,83,0.0,1.0
4840,15954,2413,0,2413,0.0,1.0
4841,15955,2551,777,1774,0.305,0.695
4842,15956,2739,0,2739,0.0,1.0
4843,15957,755,0,755,0.0,1.0
4844,15958,2301,103,2198,0.045,0.955
4845,15960,425,217,208,0.511,0.489
4846,15961,854,0,854,0.0,1.0
4847,15962,149,147,2,0.987,0.013
4848,15963,11114,6598,4516,0.594,0.406
4849,16001,40371,32946,7425,0.816,0.184
4850,16002,15877,3689,12188,0.232,0.768
4851,16020,1150,0,1150,0.0,1.0
4852,16022,368,0,368,0.0,1.0
4853,16023,4169,1178,2991,0.283,0.717
4854,16024,209,201,8,0.962,0.038
4855,16025,5564,0,5564,0.0,1.0
4856,16027,306,0,306,0.0,1.0
4857,16028,1886,0,1886,0.0,1.0
4858,16029,705,612,93,0.868,0.132
4859,16030,316,0,316,0.0,1.0
4860,16033,6165,2584,3581,0.419,0.581
4861,16034,2054,0,2054,0.0,1.0
4862,16035,122,0,122,0.0,1.0
4863,16036,200,0,200,0.0,1.0
4864,16037,4589,1087,3502,0.237,0.763
4865,16038,3517,922,2595,0.262,0.738
4866,16040,975,0,975,0.0,1.0
4867,16041,1888,0,1888,0.0,1.0
4868,16045,1195,1195,0,1.0,0.0
4869,16046,14396,12159,2237,0.845,0.155
4870,16048,139,0,139,0.0,1.0
4871,16049,3241,0,3241,0.0,1.0
4872,16050,1546,0,1546,0.0,1.0
4873,16051,3043,7,3036,0.002,0.998
4874,16052,2447,665,1782,0.272,0.728
4875,16053,4020,1245,2775,0.31,0.69
4876,16054,497,0,497,0.0,1.0
4877,16055,8486,3101,5385,0.365,0.635
4878,16056,4791,2478,2313,0.517,0.483
4879,16057,13909,6716,7193,0.483,0.517
4880,16059,7738,3189,4549,0.412,0.588
4881,16061,2761,0,2761,0.0,1.0
4882,16063,6559,4452,2107,0.679,0.321
4883,16066,28060,27698,362,0.987,0.013
4884,16101,34042,25928,8114,0.762,0.238
4885,16102,5755,3210,2545,0.558,0.442
4886,16105,15448,11990,3458,0.776,0.224
4887,16110,314,0,314,0.0,1.0
4888,16111,1409,0,1409,0.0,1.0
4889,16112,1571,0,1571,0.0,1.0
4890,16113,448,353,95,0.788,0.212
4891,16114,606,0,606,0.0,1.0
4892,16115,3287,331,2956,0.101,0.899
4893,16116,3074,141,2933,0.046,0.954
4894,16117,17185,13119,4066,0.763,0.237
4895,16120,2463,0,2463,0.0,1.0
4896,16121,4941,4941,0,1.0,0.0
4897,16123,2237,13,2224,0.006,0.994
4898,16124,2228,0,2228,0.0,1.0
4899,16125,18186,10595,7591,0.583,0.417
4900,16127,16145,10964,5181,0.679,0.321
4901,16130,2023,0,2023,0.0,1.0
4902,16131,933,0,933,0.0,1.0
4903,16132,355,293,62,0.825,0.175
4904,16133,1573,0,1573,0.0,1.0
4905,16134,3886,0,3886,0.0,1.0
4906,16136,801,764,37,0.954,0.046
4907,16137,12941,3838,9103,0.297,0.703
4908,16140,123,0,123,0.0,1.0
4909,16141,1806,0,1806,0.0,1.0
4910,16142,7056,2638,4418,0.374,0.626
4911,16143,2901,0,2901,0.0,1.0
4912,16145,2726,0,2726,0.0,1.0
4913,16146,14040,14040,0,1.0,0.0
4914,16148,16959,12525,4434,0.739,0.261
4915,16150,7426,5342,2084,0.719,0.281
4916,16151,77,0,77,0.0,1.0
4917,16153,2624,0,2624,0.0,1.0
4918,16154,2492,176,2316,0.071,0.929
4919,16155,103,0,103,0.0,1.0
4920,16156,3319,0,3319,0.0,1.0
4921,16157,3477,97,3380,0.028,0.972
4922,16159,4706,1198,3508,0.255,0.745
4923,16160,864,772,92,0.894,0.106
4924,16161,644,644,0,1.0,0.0
4925,16201,18214,7953,10261,0.437,0.563
4926,16210,1014,56,958,0.055,0.945
4927,16211,104,0,104,0.0,1.0
4928,16212,339,292,47,0.861,0.139
4929,16213,204,0,204,0.0,1.0
4930,16214,10127,7742,2385,0.764,0.236
4931,16217,101,0,101,0.0,1.0
4932,16218,1195,0,1195,0.0,1.0
4933,16222,2526,0,2526,0.0,1.0
4934,16223,154,0,154,0.0,1.0
4935,16224,1181,0,1181,0.0,1.0
4936,16226,8279,4728,3551,0.571,0.429
4937,16228,371,371,0,1.0,0.0
4938,16229,4997,2818,2179,0.564,0.436
4939,16230,494,0,494,0.0,1.0
4940,16232,4281,0,4281,0.0,1.0
4941,16233,1246,0,1246,0.0,1.0
4942,16235,1256,0,1256,0.0,1.0
4943,16236,262,262,0,1.0,0.0
4944,16238,410,410,0,1.0,0.0
4945,16239,4172,0,4172,0.0,1.0
4946,16240,1533,0,1533,0.0,1.0
4947,16242,4693,0,4693,0.0,1.0
4948,16244,265,0,265,0.0,1.0
4949,16245,207,0,207,0.0,1.0
4950,16246,252,0,252,0.0,1.0
4951,16248,3130,0,3130,0.0,1.0
4952,16249,2089,0,2089,0.0,1.0
4953,16250,315,0,315,0.0,1.0
4954,16253,91,0,91,0.0,1.0
4955,16254,3471,1035,2436,0.298,0.702
4956,16255,1943,0,1943,0.0,1.0
4957,16256,2084,0,2084,0.0,1.0
4958,16258,1869,596,1273,0.319,0.681
4959,16259,1934,0,1934,0.0,1.0
4960,16260,296,0,296,0.0,1.0
4961,16262,3007,0,3007,0.0,1.0
4962,16263,317,0,317,0.0,1.0
4963,16301,16321,12766,3555,0.782,0.218
4964,16311,564,0,564,0.0,1.0
4965,16312,25,0,25,0.0,1.0
4966,16313,1848,841,1007,0.455,0.545
4967,16314,5507,0,5507,0.0,1.0
4968,16316,5436,2695,2741,0.496,0.504
4969,16317,1456,0,1456,0.0,1.0
4970,16319,1355,0,1355,0.0,1.0
4971,16321,76,0,76,0.0,1.0
4972,16322,158,0,158,0.0,1.0
4973,16323,16372,9581,6791,0.585,0.415
4974,16326,391,0,391,0.0,1.0
4975,16327,2978,0,2978,0.0,1.0
4976,16328,80,0,80,0.0,1.0
4977,16329,528,369,159,0.699,0.301
4978,16331,88,0,88,0.0,1.0
4979,16332,53,0,53,0.0,1.0
4980,16333,240,0,240,0.0,1.0
4981,16334,338,0,338,0.0,1.0
4982,16335,28445,19661,8784,0.691,0.309
4983,16340,1990,291,1699,0.146,0.854
4984,16341,2030,0,2030,0.0,1.0
4985,16342,2281,0,2281,0.0,1.0
4986,16343,449,362,87,0.806,0.194
4987,16344,523,411,112,0.786,0.214
4988,16345,3543,1005,2538,0.284,0.716
4989,16346,3247,1757,1490,0.541,0.459
4990,16347,2238,0,2238,0.0,1.0
4991,16350,2737,0,2737,0.0,1.0
4992,16351,1716,0,1716,0.0,1.0
4993,16352,245,0,245,0.0,1.0
4994,16353,3348,0,3348,0.0,1.0
4995,16354,11379,5732,5647,0.504,0.496
4996,16360,1383,0,1383,0.0,1.0
4997,16361,53,0,53,0.0,1.0
4998,16362,1102,0,1102,0.0,1.0
4999,16364,1347,0,1347,0.0,1.0
5000,16365,18579,13616,4963,0.733,0.267
5001,16370,358,0,358,0.0,1.0
5002,16371,3260,2219,1041,0.681,0.319
5003,16372,499,0,499,0.0,1.0
5004,16373,3510,0,3510,0.0,1.0
5005,16374,1968,0,1968,0.0,1.0
5006,16401,6581,4034,2547,0.613,0.387
5007,16402,956,0,956,0.0,1.0
5008,16403,7029,2602,4427,0.37,0.63
5009,16404,3269,0,3269,0.0,1.0
5010,16405,922,240,682,0.26,0.74
5011,16406,3509,0,3509,0.0,1.0
5012,16407,11317,6331,4986,0.559,0.441
5013,16410,1854,540,1314,0.291,0.709
5014,16411,1477,0,1477,0.0,1.0
5015,16412,10480,5546,4934,0.529,0.471
5016,16415,8916,6518,2398,0.731,0.269
5017,16416,203,0,203,0.0,1.0
5018,16417,8329,4892,3437,0.587,0.413
5019,16420,650,0,650,0.0,1.0
5020,16421,2518,919,1599,0.365,0.635
5021,16422,401,209,192,0.521,0.479
5022,16423,4450,3468,982,0.779,0.221
5023,16424,4676,0,4676,0.0,1.0
5024,16426,3730,621,3109,0.166,0.834
5025,16427,193,0,193,0.0,1.0
5026,16428,12478,6456,6022,0.517,0.483
5027,16433,5384,1322,4062,0.246,0.754
5028,16434,2990,0,2990,0.0,1.0
5029,16435,2108,0,2108,0.0,1.0
5030,16436,756,0,756,0.0,1.0
5031,16438,8083,3381,4702,0.418,0.582
5032,16440,891,0,891,0.0,1.0
5033,16441,10136,318,9818,0.031,0.969
5034,16442,2958,0,2958,0.0,1.0
5035,16443,1425,0,1425,0.0,1.0
5036,16444,1717,1717,0,1.0,0.0
5037,16501,2044,2044,0,1.0,0.0
5038,16502,16664,16664,0,1.0,0.0
5039,16503,16850,16850,0,1.0,0.0
5040,16504,17322,17322,0,1.0,0.0
5041,16505,17168,17156,12,0.999,0.001
5042,16506,23720,23266,454,0.981,0.019
5043,16507,11088,11088,0,1.0,0.0
5044,16508,16050,16050,0,1.0,0.0
5045,16509,26810,23812,2998,0.888,0.112
5046,16510,25625,21938,3687,0.856,0.144
5047,16511,11382,10910,472,0.959,0.041
5048,16546,1154,1154,0,1.0,0.0
5049,16563,1621,1621,0,1.0,0.0
5050,16601,33870,28863,5007,0.852,0.148
5051,16602,29554,29230,324,0.989,0.011
5052,16611,2410,0,2410,0.0,1.0
5053,16613,1535,0,1535,0.0,1.0
5054,16616,116,0,116,0.0,1.0
5055,16617,2806,2632,174,0.938,0.062
5056,16619,347,0,347,0.0,1.0
5057,16620,414,346,68,0.836,0.164
5058,16621,737,0,737,0.0,1.0
5059,16622,175,0,175,0.0,1.0
5060,16623,567,0,567,0.0,1.0
5061,16624,204,0,204,0.0,1.0
5062,16625,3868,1730,2138,0.447,0.553
5063,16627,2278,0,2278,0.0,1.0
5064,16630,5080,4900,180,0.965,0.035
5065,16631,90,0,90,0.0,1.0
5066,16633,200,0,200,0.0,1.0
5067,16634,302,0,302,0.0,1.0
5068,16635,11321,7592,3729,0.671,0.329
5069,16636,742,0,742,0.0,1.0
5070,16637,2873,1640,1233,0.571,0.429
5071,16638,67,0,67,0.0,1.0
5072,16639,1494,0,1494,0.0,1.0
5073,16640,817,0,817,0.0,1.0
5074,16641,2598,2005,593,0.772,0.228
5075,16645,142,0,142,0.0,1.0
5076,16646,2558,1612,946,0.63,0.37
5077,16647,764,0,764,0.0,1.0
5078,16648,15538,11553,3985,0.744,0.256
5079,16650,2036,0,2036,0.0,1.0
5080,16651,5813,3735,2078,0.643,0.357
5081,16652,18028,11385,6643,0.632,0.368
5082,16655,1601,136,1465,0.085,0.915
5083,16656,1297,0,1297,0.0,1.0
5084,16657,1343,0,1343,0.0,1.0
5085,16659,303,0,303,0.0,1.0
5086,16661,951,0,951,0.0,1.0
5087,16662,6040,2733,3307,0.452,0.548
5088,16664,2104,0,2104,0.0,1.0
5089,16665,299,265,34,0.886,0.114
5090,16666,2960,1813,1147,0.612,0.388
5091,16667,1392,0,1392,0.0,1.0
5092,16668,3569,2020,1549,0.566,0.434
5093,16669,2351,0,2351,0.0,1.0
5094,16670,47,0,47,0.0,1.0
5095,16671,505,0,505,0.0,1.0
5096,16672,187,0,187,0.0,1.0
5097,16673,5519,3092,2427,0.56,0.44
5098,16674,736,0,736,0.0,1.0
5099,16677,481,0,481,0.0,1.0
5100,16678,2689,0,2689,0.0,1.0
5101,16679,844,0,844,0.0,1.0
5102,16680,427,0,427,0.0,1.0
5103,16682,117,117,0,1.0,0.0
5104,16683,383,0,383,0.0,1.0
5105,16685,249,0,249,0.0,1.0
5106,16686,13488,7832,5656,0.581,0.419
5107,16689,462,0,462,0.0,1.0
5108,16691,314,0,314,0.0,1.0
5109,16692,753,0,753,0.0,1.0
5110,16693,4185,0,4185,0.0,1.0
5111,16694,254,0,254,0.0,1.0
5112,16695,1198,0,1198,0.0,1.0
5113,16699,1469,1469,0,1.0,0.0
5114,16701,17980,12073,5907,0.671,0.329
5115,16720,1392,0,1392,0.0,1.0
5116,16724,143,0,143,0.0,1.0
5117,16725,166,0,166,0.0,1.0
5118,16726,542,0,542,0.0,1.0
5119,16727,211,0,211,0.0,1.0
5120,16728,25,0,25,0.0,1.0
5121,16729,761,0,761,0.0,1.0
5122,16730,121,0,121,0.0,1.0
5123,16731,2818,0,2818,0.0,1.0
5124,16732,293,0,293,0.0,1.0
5125,16733,222,0,222,0.0,1.0
5126,16734,287,0,287,0.0,1.0
5127,16735,6309,3770,2539,0.598,0.402
5128,16738,2679,0,2679,0.0,1.0
5129,16740,1032,0,1032,0.0,1.0
5130,16743,3942,0,3942,0.0,1.0
5131,16744,332,0,332,0.0,1.0
5132,16745,611,0,611,0.0,1.0
5133,16746,1265,0,1265,0.0,1.0
5134,16748,2997,0,2997,0.0,1.0
5135,16749,4319,0,4319,0.0,1.0
5136,16750,417,0,417,0.0,1.0
5137,16801,42812,41662,1150,0.973,0.027
5138,16802,12764,12764,0,1.0,0.0
5139,16803,23685,22440,1245,0.947,0.053
5140,16820,1217,0,1217,0.0,1.0
5141,16821,318,0,318,0.0,1.0
5142,16822,2283,0,2283,0.0,1.0
5143,16823,26617,17525,9092,0.658,0.342
5144,16825,240,0,240,0.0,1.0
5145,16826,616,0,616,0.0,1.0
5146,16827,3991,2791,1200,0.699,0.301
5147,16828,4478,0,4478,0.0,1.0
5148,16829,666,0,666,0.0,1.0
5149,16830,13695,9868,3827,0.721,0.279
5150,16832,510,0,510,0.0,1.0
5151,16833,5342,2751,2591,0.515,0.485
5152,16834,299,0,299,0.0,1.0
5153,16835,238,0,238,0.0,1.0
5154,16836,1152,0,1152,0.0,1.0
5155,16837,186,0,186,0.0,1.0
5156,16838,1821,0,1821,0.0,1.0
5157,16839,489,0,489,0.0,1.0
5158,16840,510,442,68,0.867,0.133
5159,16841,5934,0,5934,0.0,1.0
5160,16843,657,655,2,0.997,0.003
5161,16844,2769,0,2769,0.0,1.0
5162,16845,1088,0,1088,0.0,1.0
5163,16847,335,0,335,0.0,1.0
5164,16848,319,0,319,0.0,1.0
5165,16849,331,0,331,0.0,1.0
5166,16851,866,738,128,0.852,0.148
5167,16852,371,0,371,0.0,1.0
5168,16853,300,300,0,1.0,0.0
5169,16854,947,0,947,0.0,1.0
5170,16855,282,117,165,0.415,0.585
5171,16858,3688,300,3388,0.081,0.919
5172,16859,542,0,542,0.0,1.0
5173,16860,451,0,451,0.0,1.0
5174,16861,311,0,311,0.0,1.0
5175,16863,718,0,718,0.0,1.0
5176,16865,1839,195,1644,0.106,0.894
5177,16866,9881,7097,2784,0.718,0.282
5178,16868,483,447,36,0.925,0.075
5179,16870,7046,1480,5566,0.21,0.79
5180,16871,46,0,46,0.0,1.0
5181,16872,1551,0,1551,0.0,1.0
5182,16874,1371,0,1371,0.0,1.0
5183,16875,3945,0,3945,0.0,1.0
5184,16876,311,0,311,0.0,1.0
5185,16877,1762,0,1762,0.0,1.0
5186,16878,1762,363,1399,0.206,0.794
5187,16879,532,0,532,0.0,1.0
5188,16881,2232,263,1969,0.118,0.882
5189,16882,300,0,300,0.0,1.0
5190,16901,10243,0,10243,0.0,1.0
5191,16911,332,0,332,0.0,1.0
5192,16912,1776,0,1776,0.0,1.0
5193,16914,2347,0,2347,0.0,1.0
5194,16915,5929,0,5929,0.0,1.0
5195,16917,1437,400,1037,0.278,0.722
5196,16920,2006,0,2006,0.0,1.0
5197,16921,475,0,475,0.0,1.0
5198,16922,2002,0,2002,0.0,1.0
5199,16923,1470,0,1470,0.0,1.0
5200,16925,3186,0,3186,0.0,1.0
5201,16926,872,0,872,0.0,1.0
5202,16927,651,0,651,0.0,1.0
5203,16928,1387,0,1387,0.0,1.0
5204,16929,2320,0,2320,0.0,1.0
5205,16930,1300,0,1300,0.0,1.0
5206,16932,734,0,734,0.0,1.0
5207,16933,7488,3752,3736,0.501,0.499
5208,16935,1256,0,1256,0.0,1.0
5209,16936,2095,0,2095,0.0,1.0
5210,16937,172,0,172,0.0,1.0
5211,16938,747,0,747,0.0,1.0
5212,16939,295,0,295,0.0,1.0
5213,16940,302,0,302,0.0,1.0
5214,16941,69,0,69,0.0,1.0
5215,16942,847,0,847,0.0,1.0
5216,16943,549,0,549,0.0,1.0
5217,16946,2484,0,2484,0.0,1.0
5218,16947,4818,0,4818,0.0,1.0
5219,16948,1634,0,1634,0.0,1.0
5220,16950,3378,0,3378,0.0,1.0
5221,17002,784,0,784,0.0,1.0
5222,17003,11720,7483,4237,0.638,0.362
5223,17004,5000,0,5000,0.0,1.0
5224,17005,368,0,368,0.0,1.0
5225,17006,1052,0,1052,0.0,1.0
5226,17007,5591,2632,2959,0.471,0.529
5227,17009,2007,1946,61,0.97,0.03
5228,17010,182,182,0,1.0,0.0
5229,17011,34586,34586,0,1.0,0.0
5230,17013,34575,31004,3571,0.897,0.103
5231,17015,20798,4761,16037,0.229,0.771
5232,17016,799,624,175,0.781,0.219
5233,17017,1755,0,1755,0.0,1.0
5234,17018,4313,2062,2251,0.478,0.522
5235,17019,17721,9572,8149,0.54,0.46
5236,17020,9047,356,8691,0.039,0.961
5237,17021,1088,0,1088,0.0,1.0
5238,17022,29602,22942,6660,0.775,0.225
5239,17023,3535,0,3535,0.0,1.0
5240,17024,1893,0,1893,0.0,1.0
5241,17025,16778,15063,1715,0.898,0.102
5242,17026,3616,0,3616,0.0,1.0
5243,17027,2141,2141,0,1.0,0.0
5244,17028,3720,1821,1899,0.49,0.51
5245,17029,371,162,209,0.437,0.563
5246,17030,832,0,832,0.0,1.0
5247,17032,8192,116,8076,0.014,0.986
5248,17033,16972,15290,1682,0.901,0.099
5249,17034,2414,2414,0,1.0,0.0
5250,17035,839,0,839,0.0,1.0
5251,17036,21913,19150,2763,0.874,0.126
5252,17037,1126,0,1126,0.0,1.0
5253,17038,8219,4225,3994,0.514,0.486
5254,17039,37,0,37,0.0,1.0
5255,17040,2787,0,2787,0.0,1.0
5256,17041,213,0,213,0.0,1.0
5257,17042,37133,31123,6010,0.838,0.162
5258,17043,5957,5957,0,1.0,0.0
5259,17044,21209,14656,6553,0.691,0.309
5260,17045,3350,0,3350,0.0,1.0
5261,17046,29790,25631,4159,0.86,0.14
5262,17047,2526,0,2526,0.0,1.0
5263,17048,4046,2096,1950,0.518,0.482
5264,17049,3360,0,3360,0.0,1.0
5265,17050,32815,31124,1691,0.948,0.052
5266,17051,4653,42,4611,0.009,0.991
5267,17052,1635,0,1635,0.0,1.0
5268,17053,5001,2344,2657,0.469,0.531
5269,17055,34237,30973,3264,0.905,0.095
5270,17056,128,128,0,1.0,0.0
5271,17057,21329,19128,2201,0.897,0.103
5272,17058,1909,1141,768,0.598,0.402
5273,17059,7579,2002,5577,0.264,0.736
5274,17060,1334,0,1334,0.0,1.0
5275,17061,7157,4424,2733,0.618,0.382
5276,17062,3979,0,3979,0.0,1.0
5277,17063,3311,1630,1681,0.492,0.508
5278,17064,645,0,645,0.0,1.0
5279,17065,4222,3677,545,0.871,0.129
5280,17066,5348,3750,1598,0.701,0.299
5281,17067,14232,8075,6157,0.567,0.433
5282,17068,4298,0,4298,0.0,1.0
5283,17069,133,0,133,0.0,1.0
5284,17070,15692,14716,976,0.938,0.062
5285,17071,108,0,108,0.0,1.0
5286,17072,193,193,0,1.0,0.0
5287,17073,5271,2216,3055,0.42,0.58
5288,17074,7477,2657,4820,0.355,0.645
5289,17075,123,109,14,0.886,0.114
5290,17076,48,0,48,0.0,1.0
5291,17077,46,0,46,0.0,1.0
5292,17078,20218,17299,2919,0.856,0.144
5293,17080,298,0,298,0.0,1.0
5294,17081,352,0,352,0.0,1.0
5295,17082,3588,1101,2487,0.307,0.693
5296,17083,109,109,0,1.0,0.0
5297,17084,4340,2659,1681,0.613,0.387
5298,17086,2499,0,2499,0.0,1.0
5299,17087,2767,1980,787,0.716,0.284
5300,17088,823,0,823,0.0,1.0
5301,17090,5216,0,5216,0.0,1.0
5302,17093,801,801,0,1.0,0.0
5303,17094,2392,0,2392,0.0,1.0
5304,17097,925,877,48,0.948,0.052
5305,17098,2528,2096,432,0.829,0.171
5306,17099,1179,1086,93,0.921,0.079
5307,17101,2212,2212,0,1.0,0.0
5308,17102,7628,7628,0,1.0,0.0
5309,17103,11848,11848,0,1.0,0.0
5310,17104,20962,20962,0,1.0,0.0
5311,17109,23131,23131,0,1.0,0.0
5312,17110,24433,24399,34,0.999,0.001
5313,17111,30714,30528,186,0.994,0.006
5314,17112,33850,29624,4226,0.875,0.125
5315,17113,10749,10749,0,1.0,0.0
5316,17120,0,0,0,,
5317,17201,25293,24542,751,0.97,0.03
5318,17202,30200,17426,12774,0.577,0.423
5319,17210,193,0,193,0.0,1.0
5320,17211,368,0,368,0.0,1.0
5321,17212,702,0,702,0.0,1.0
5322,17213,639,0,639,0.0,1.0
5323,17214,1089,889,200,0.816,0.184
5324,17215,347,0,347,0.0,1.0
5325,17217,150,0,150,0.0,1.0
5326,17219,405,0,405,0.0,1.0
5327,17220,534,0,534,0.0,1.0
5328,17221,637,0,637,0.0,1.0
5329,17222,10749,6529,4220,0.607,0.393
5330,17223,289,0,289,0.0,1.0
5331,17224,1834,0,1834,0.0,1.0
5332,17225,18879,8562,10317,0.454,0.546
5333,17228,1183,0,1183,0.0,1.0
5334,17229,1276,0,1276,0.0,1.0
5335,17233,5047,0,5047,0.0,1.0
5336,17235,672,633,39,0.942,0.058
5337,17236,8895,0,8895,0.0,1.0
5338,17237,1917,1883,34,0.982,0.018
5339,17238,1794,0,1794,0.0,1.0
5340,17239,203,0,203,0.0,1.0
5341,17240,3345,0,3345,0.0,1.0
5342,17241,11853,0,11853,0.0,1.0
5343,17243,1329,0,1329,0.0,1.0
5344,17244,2407,0,2407,0.0,1.0
5345,17246,195,0,195,0.0,1.0
5346,17247,366,366,0,1.0,0.0
5347,17249,371,0,371,0.0,1.0
5348,17250,68,68,0,1.0,0.0
5349,17251,158,0,158,0.0,1.0
5350,17252,3608,1709,1899,0.474,0.526
5351,17253,337,0,337,0.0,1.0
5352,17254,89,74,15,0.831,0.169
5353,17255,1125,0,1125,0.0,1.0
5354,17256,91,0,91,0.0,1.0
5355,17257,27996,16744,11252,0.598,0.402
5356,17260,1164,0,1164,0.0,1.0
5357,17261,193,0,193,0.0,1.0
5358,17262,1462,0,1462,0.0,1.0
5359,17263,467,467,0,1.0,0.0
5360,17264,2305,0,2305,0.0,1.0
5361,17265,496,0,496,0.0,1.0
5362,17266,581,317,264,0.546,0.454
5363,17267,2810,0,2810,0.0,1.0
5364,17268,28285,21614,6671,0.764,0.236
5365,17270,115,0,115,0.0,1.0
5366,17271,339,0,339,0.0,1.0
5367,17272,294,294,0,1.0,0.0
5368,17301,4053,1830,2223,0.452,0.548
5369,17302,3083,0,3083,0.0,1.0
5370,17304,3059,0,3059,0.0,1.0
5371,17306,318,0,318,0.0,1.0
5372,17307,5899,0,5899,0.0,1.0
5373,17309,2086,0,2086,0.0,1.0
5374,17311,252,0,252,0.0,1.0
5375,17313,10899,10469,430,0.961,0.039
5376,17314,5929,0,5929,0.0,1.0
5377,17315,25756,15758,9998,0.612,0.388
5378,17316,8266,2563,5703,0.31,0.69
5379,17317,755,755,0,1.0,0.0
5380,17318,344,344,0,1.0,0.0
5381,17319,10417,9761,656,0.937,0.063
5382,17320,7823,2429,5394,0.31,0.69
5383,17321,2238,0,2238,0.0,1.0
5384,17322,6012,1870,4142,0.311,0.689
5385,17324,4219,330,3889,0.078,0.922
5386,17325,27619,16404,11215,0.594,0.406
5387,17327,7565,2690,4875,0.356,0.644
5388,17329,2494,0,2494,0.0,1.0
5389,17331,50292,40916,9376,0.814,0.186
5390,17339,6940,1997,4943,0.288,0.712
5391,17340,10896,6565,4331,0.603,0.397
5392,17343,180,0,180,0.0,1.0
5393,17344,3656,3656,0,1.0,0.0
5394,17345,7679,6531,1148,0.851,0.149
5395,17347,6202,5624,578,0.907,0.093
5396,17349,7570,5173,2397,0.683,0.317
5397,17350,12886,7390,5496,0.573,0.427
5398,17352,1292,0,1292,0.0,1.0
5399,17353,3228,0,3228,0.0,1.0
5400,17355,261,222,39,0.851,0.149
5401,17356,21610,17577,4033,0.813,0.187
5402,17360,5927,1682,4245,0.284,0.716
5403,17361,5806,5800,6,0.999,0.001
5404,17362,13397,4346,9051,0.324,0.676
5405,17363,9413,4916,4497,0.522,0.478
5406,17364,3907,890,3017,0.228,0.772
5407,17365,2510,0,2510,0.0,1.0
5408,17366,5499,4042,1457,0.735,0.265
5409,17368,7322,4902,2420,0.669,0.331
5410,17370,5683,4418,1265,0.777,0.223
5411,17371,257,257,0,1.0,0.0
5412,17372,4101,0,4101,0.0,1.0
5413,17401,17687,17687,0,1.0,0.0
5414,17402,36360,36131,229,0.994,0.006
5415,17403,39042,37154,1888,0.952,0.048
5416,17404,35517,34249,1268,0.964,0.036
5417,17406,22156,16575,5581,0.748,0.252
5418,17407,2355,2195,160,0.932,0.068
5419,17408,22507,21378,1129,0.95,0.05
5420,17501,4307,4307,0,1.0,0.0
5421,17502,2464,1225,1239,0.497,0.503
5422,17505,1785,586,1199,0.328,0.672
5423,17507,62,62,0,1.0,0.0
5424,17508,423,423,0,1.0,0.0
5425,17509,4664,1408,3256,0.302,0.698
5426,17512,17836,17287,549,0.969,0.031
5427,17516,4496,1332,3164,0.296,0.704
5428,17517,15391,12160,3231,0.79,0.21
5429,17518,1355,0,1355,0.0,1.0
5430,17519,6824,3305,3519,0.484,0.516
5431,17520,4686,4686,0,1.0,0.0
5432,17522,32483,26386,6097,0.812,0.188
5433,17527,6080,3199,2881,0.526,0.474
5434,17529,4317,1529,2788,0.354,0.646
5435,17532,3381,0,3381,0.0,1.0
5436,17535,2458,778,1680,0.317,0.683
5437,17536,2839,0,2839,0.0,1.0
5438,17538,6045,6045,0,1.0,0.0
5439,17540,9791,7273,2518,0.743,0.257
5440,17543,42626,38544,4082,0.904,0.096
5441,17545,21256,12344,8912,0.581,0.419
5442,17547,7378,6195,1183,0.84,0.16
5443,17550,790,790,0,1.0,0.0
5444,17551,10857,9832,1025,0.906,0.094
5445,17552,17831,15305,2526,0.858,0.142
5446,17554,7525,7341,184,0.976,0.024
5447,17555,7525,630,6895,0.084,0.916
5448,17557,13811,8911,4900,0.645,0.355
5449,17560,5118,2534,2584,0.495,0.505
5450,17562,4464,1725,2739,0.386,0.614
5451,17563,3849,0,3849,0.0,1.0
5452,17565,2537,52,2485,0.02,0.98
5453,17566,12019,4376,7643,0.364,0.636
5454,17569,5448,3320,2128,0.609,0.391
5455,17570,291,291,0,1.0,0.0
5456,17572,3859,902,2957,0.234,0.766
5457,17576,129,129,0,1.0,0.0
5458,17578,7485,6024,1461,0.805,0.195
5459,17579,5935,4261,1674,0.718,0.282
5460,17581,951,951,0,1.0,0.0
5461,17582,2026,936,1090,0.462,0.538
5462,17584,8957,8166,791,0.912,0.088
5463,17601,49779,49308,471,0.991,0.009
5464,17602,52452,50827,1625,0.969,0.031
5465,17603,61973,59901,2072,0.967,0.033
5466,17606,392,392,0,1.0,0.0
5467,17701,44661,39635,5026,0.887,0.113
5468,17702,10721,8141,2580,0.759,0.241
5469,17721,1604,1588,16,0.99,0.01
5470,17723,34,0,34,0.0,1.0
5471,17724,5424,0,5424,0.0,1.0
5472,17727,72,0,72,0.0,1.0
5473,17728,5120,1078,4042,0.211,0.789
5474,17729,159,0,159,0.0,1.0
5475,17730,257,243,14,0.946,0.054
5476,17731,185,0,185,0.0,1.0
5477,17737,6220,3383,2837,0.544,0.456
5478,17739,32,0,32,0.0,1.0
5479,17740,12754,6239,6515,0.489,0.511
5480,17742,39,0,39,0.0,1.0
5481,17744,3175,690,2485,0.217,0.783
5482,17745,19063,15452,3611,0.811,0.189
5483,17747,3073,0,3073,0.0,1.0
5484,17748,300,268,32,0.893,0.107
5485,17749,244,0,244,0.0,1.0
5486,17750,167,0,167,0.0,1.0
5487,17751,7084,3167,3917,0.447,0.553
5488,17752,4635,2397,2238,0.517,0.483
5489,17754,12233,6865,5368,0.561,0.439
5490,17756,12408,5787,6621,0.466,0.534
5491,17758,919,0,919,0.0,1.0
5492,17760,557,0,557,0.0,1.0
5493,17762,503,385,118,0.765,0.235
5494,17763,309,0,309,0.0,1.0
5495,17764,2327,0,2327,0.0,1.0
5496,17765,1162,0,1162,0.0,1.0
5497,17767,91,91,0,1.0,0.0
5498,17768,377,0,377,0.0,1.0
5499,17771,3158,0,3158,0.0,1.0
5500,17772,2399,0,2399,0.0,1.0
5501,17774,1277,0,1277,0.0,1.0
5502,17776,295,0,295,0.0,1.0
5503,17777,7056,3635,3421,0.515,0.485
5504,17778,102,0,102,0.0,1.0
5505,17779,235,134,101,0.57,0.43
5506,17801,16671,10683,5988,0.641,0.359
5507,17810,4683,2754,1929,0.588,0.412
5508,17812,1480,0,1480,0.0,1.0
5509,17813,1979,0,1979,0.0,1.0
5510,17814,4860,0,4860,0.0,1.0
5511,17815,30967,23394,7573,0.755,0.245
5512,17820,5556,1541,4015,0.277,0.723
5513,17821,18219,9049,9170,0.497,0.503
5514,17822,0,0,0,,
5515,17823,1273,0,1273,0.0,1.0
5516,17824,4115,0,4115,0.0,1.0
5517,17827,657,0,657,0.0,1.0
5518,17829,244,0,244,0.0,1.0
5519,17830,1947,0,1947,0.0,1.0
5520,17832,628,611,17,0.973,0.027
5521,17834,3565,3555,10,0.997,0.003
5522,17835,219,0,219,0.0,1.0
5523,17836,266,0,266,0.0,1.0
5524,17837,19815,14847,4968,0.749,0.251
5525,17840,533,0,533,0.0,1.0
5526,17841,4779,0,4779,0.0,1.0
5527,17842,8910,732,8178,0.082,0.918
5528,17844,10042,4422,5620,0.44,0.56
5529,17845,2245,0,2245,0.0,1.0
5530,17846,3738,0,3738,0.0,1.0
5531,17847,12051,9080,2971,0.753,0.247
5532,17850,645,645,0,1.0,0.0
5533,17851,7841,7535,306,0.961,0.039
5534,17853,3221,0,3221,0.0,1.0
5535,17855,992,0,992,0.0,1.0
5536,17856,3365,731,2634,0.217,0.783
5537,17857,7505,5685,1820,0.757,0.243
5538,17859,3106,797,2309,0.257,0.743
5539,17860,1994,5,1989,0.003,0.997
5540,17861,143,0,143,0.0,1.0
5541,17862,577,0,577,0.0,1.0
5542,17864,2445,0,2445,0.0,1.0
5543,17865,92,0,92,0.0,1.0
5544,17866,10310,9049,1261,0.878,0.122
5545,17867,169,0,169,0.0,1.0
5546,17868,1052,1052,0,1.0,0.0
5547,17870,14564,10967,3597,0.753,0.247
5548,17872,9943,7807,2136,0.785,0.215
5549,17876,1698,1474,224,0.868,0.132
5550,17878,1528,0,1528,0.0,1.0
5551,17880,72,0,72,0.0,1.0
5552,17881,1556,1413,143,0.908,0.092
5553,17884,305,0,305,0.0,1.0
5554,17885,141,0,141,0.0,1.0
5555,17886,895,782,113,0.874,0.126
5556,17887,1778,1774,4,0.998,0.002
5557,17888,326,210,116,0.644,0.356
5558,17889,2735,393,2342,0.144,0.856
5559,17901,23990,20300,3690,0.846,0.154
5560,17920,331,0,331,0.0,1.0
5561,17921,7676,5082,2594,0.662,0.338
5562,17922,4783,2874,1909,0.601,0.399
5563,17923,433,0,433,0.0,1.0
5564,17925,376,0,376,0.0,1.0
5565,17929,1606,1544,62,0.961,0.039
5566,17930,476,379,97,0.796,0.204
5567,17931,8472,8412,60,0.993,0.007
5568,17933,89,89,0,1.0,0.0
5569,17934,469,413,56,0.881,0.119
5570,17935,1737,1640,97,0.944,0.056
5571,17936,763,736,27,0.965,0.035
5572,17938,2442,0,2442,0.0,1.0
5573,17941,834,0,834,0.0,1.0
5574,17943,229,185,44,0.808,0.192
5575,17944,205,189,16,0.922,0.078
5576,17945,180,177,3,0.983,0.017
5577,17946,263,2,261,0.008,0.992
5578,17948,5029,4687,342,0.932,0.068
5579,17949,263,263,0,1.0,0.0
5580,17951,325,325,0,1.0,0.0
5581,17952,282,0,282,0.0,1.0
5582,17953,469,0,469,0.0,1.0
5583,17954,4564,4564,0,1.0,0.0
5584,17957,328,328,0,1.0,0.0
5585,17959,1422,0,1422,0.0,1.0
5586,17960,3868,0,3868,0.0,1.0
5587,17961,6958,4861,2097,0.699,0.301
5588,17963,9317,3462,5855,0.372,0.628
5589,17964,798,0,798,0.0,1.0
5590,17965,2067,2015,52,0.975,0.025
5591,17967,2457,0,2457,0.0,1.0
5592,17968,329,0,329,0.0,1.0
5593,17970,3241,3220,21,0.994,0.006
5594,17972,11627,8188,3439,0.704,0.296
5595,17974,344,344,0,1.0,0.0
5596,17976,6937,5232,1705,0.754,0.246
5597,17978,224,0,224,0.0,1.0
5598,17979,168,0,168,0.0,1.0
5599,17980,3238,2172,1066,0.671,0.329
5600,17981,2751,0,2751,0.0,1.0
5601,17982,430,0,430,0.0,1.0
5602,17983,1620,0,1620,0.0,1.0
5603,17985,1226,0,1226,0.0,1.0
5604,18011,5450,3730,1720,0.684,0.316
5605,18013,17802,10770,7032,0.605,0.395
5606,18014,11387,7218,4169,0.634,0.366
5607,18015,32832,32167,665,0.98,0.02
5608,18016,0,0,0,,
5609,18017,37549,37242,307,0.992,0.008
5610,18018,32413,32413,0,1.0,0.0
5611,18020,20447,19834,613,0.97,0.03
5612,18030,623,573,50,0.92,0.08
5613,18031,7528,6097,1431,0.81,0.19
5614,18032,9285,9285,0,1.0,0.0
5615,18034,8256,6992,1264,0.847,0.153
5616,18035,241,135,106,0.56,0.44
5617,18036,12822,8081,4741,0.63,0.37
5618,18037,7070,7070,0,1.0,0.0
5619,18038,3091,1685,1406,0.545,0.455
5620,18040,15742,14612,1130,0.928,0.072
5621,18041,5424,3427,1997,0.632,0.368
5622,18042,41570,38683,2887,0.931,0.069
5623,18045,26391,26106,285,0.989,0.011
5624,18046,64,64,0,1.0,0.0
5625,18049,17341,15410,1931,0.889,0.111
5626,18051,3327,2549,778,0.766,0.234
5627,18052,26902,26892,10,1.0,0.0
5628,18053,2375,412,1963,0.173,0.827
5629,18054,4278,1738,2540,0.406,0.594
5630,18055,11780,7804,3976,0.662,0.338
5631,18056,943,755,188,0.801,0.199
5632,18058,9464,1664,7800,0.176,0.824
5633,18059,1228,1228,0,1.0,0.0
5634,18062,24351,22242,2109,0.913,0.087
5635,18063,548,502,46,0.916,0.084
5636,18064,24073,21485,2588,0.892,0.108
5637,18066,6005,0,6005,0.0,1.0
5638,18067,17852,14185,3667,0.795,0.205
5639,18068,42,42,0,1.0,0.0
5640,18069,8017,6537,1480,0.815,0.185
5641,18070,739,285,454,0.386,0.614
5642,18071,10578,6571,4007,0.621,0.379
5643,18072,6571,5224,1347,0.795,0.205
5644,18073,9350,6072,3278,0.649,0.351
5645,18074,5775,2061,3714,0.357,0.643
5646,18076,2662,2650,12,0.995,0.005
5647,18077,2370,0,2370,0.0,1.0
5648,18078,7074,6428,646,0.909,0.091
5649,18079,436,394,42,0.904,0.096
5650,18080,11456,8402,3054,0.733,0.267
5651,18081,357,0,357,0.0,1.0
5652,18083,530,530,0,1.0,0.0
5653,18085,1119,1119,0,1.0,0.0
5654,18086,398,352,46,0.884,0.116
5655,18087,738,738,0,1.0,0.0
5656,18088,8375,6845,1530,0.817,0.183
5657,18091,5926,4095,1831,0.691,0.309
5658,18092,3223,1456,1767,0.452,0.548
5659,18101,3897,3897,0,1.0,0.0
5660,18102,49779,49779,0,1.0,0.0
5661,18103,45336,44810,526,0.988,0.012
5662,18104,43236,42738,498,0.988,0.012
5663,18105,12,12,0,1.0,0.0
5664,18106,6889,6795,94,0.986,0.014
5665,18109,16932,16922,10,0.999,0.001
5666,18195,0,0,0,,
5667,18201,27516,26777,739,0.973,0.027
5668,18202,12083,10804,1279,0.894,0.106
5669,18210,8258,6776,1482,0.821,0.179
5670,18211,1304,0,1304,0.0,1.0
5671,18212,131,0,131,0.0,1.0
5672,18214,2078,0,2078,0.0,1.0
5673,18216,1067,994,73,0.932,0.068
5674,18218,2281,2281,0,1.0,0.0
5675,18219,1436,1436,0,1.0,0.0
5676,18220,344,0,344,0.0,1.0
5677,18221,389,293,96,0.753,0.247
5678,18222,9020,5248,3772,0.582,0.418
5679,18223,115,37,78,0.322,0.678
5680,18224,6017,5054,963,0.84,0.16
5681,18225,114,114,0,1.0,0.0
5682,18229,8498,3770,4728,0.444,0.556
5683,18230,132,69,63,0.523,0.477
5684,18231,535,533,2,0.996,0.004
5685,18232,3941,3941,0,1.0,0.0
5686,18234,401,401,0,1.0,0.0
5687,18235,19353,8431,10922,0.436,0.564
5688,18237,3110,2836,274,0.912,0.088
5689,18239,232,232,0,1.0,0.0
5690,18240,3891,1824,2067,0.469,0.531
5691,18241,646,0,646,0.0,1.0
5692,18242,235,0,235,0.0,1.0
5693,18244,402,221,181,0.55,0.45
5694,18245,348,0,348,0.0,1.0
5695,18246,143,0,143,0.0,1.0
5696,18248,631,0,631,0.0,1.0
5697,18249,4129,1237,2892,0.3,0.7
5698,18250,3034,2377,657,0.783,0.217
5699,18251,46,24,22,0.522,0.478
5700,18252,11188,6601,4587,0.59,0.41
5701,18254,871,738,133,0.847,0.153
5702,18255,4337,0,4337,0.0,1.0
5703,18256,359,0,359,0.0,1.0
5704,18301,28561,25463,3098,0.892,0.108
5705,18302,17362,6844,10518,0.394,0.606
5706,18321,1711,1642,69,0.96,0.04
5707,18322,2781,1803,978,0.648,0.352
5708,18323,275,0,275,0.0,1.0
5709,18324,9714,4150,5564,0.427,0.573
5710,18325,2465,0,2465,0.0,1.0
5711,18326,4152,686,3466,0.165,0.835
5712,18327,700,690,10,0.986,0.014
5713,18328,7759,28,7731,0.004,0.996
5714,18330,8927,8354,573,0.936,0.064
5715,18331,867,361,506,0.416,0.584
5716,18332,3085,641,2444,0.208,0.792
5717,18333,712,0,712,0.0,1.0
5718,18334,4156,3123,1033,0.751,0.249
5719,18335,672,437,235,0.65,0.35
5720,18336,4082,3352,730,0.821,0.179
5721,18337,14572,9305,5267,0.639,0.361
5722,18340,174,0,174,0.0,1.0
5723,18342,492,0,492,0.0,1.0
5724,18343,3982,0,3982,0.0,1.0
5725,18344,3589,2994,595,0.834,0.166
5726,18346,2964,2015,949,0.68,0.32
5727,18347,3364,0,3364,0.0,1.0
5728,18349,132,0,132,0.0,1.0
5729,18350,1931,173,1758,0.09,0.91
5730,18351,518,0,518,0.0,1.0
5731,18352,1098,304,794,0.277,0.723
5732,18353,12779,6297,6482,0.493,0.507
5733,18354,951,0,951,0.0,1.0
5734,18355,1492,218,1274,0.146,0.854
5735,18356,136,4,132,0.029,0.971
5736,18357,104,0,104,0.0,1.0
5737,18360,28362,19018,9344,0.671,0.329
5738,18370,1096,0,1096,0.0,1.0
5739,18371,747,0,747,0.0,1.0
5740,18372,3210,2440,770,0.76,0.24
5741,18403,7087,6247,840,0.881,0.119
5742,18405,2561,0,2561,0.0,1.0
5743,18407,13862,11121,2741,0.802,0.198
5744,18411,21985,16919,5066,0.77,0.23
5745,18413,151,0,151,0.0,1.0
5746,18414,5452,1308,4144,0.24,0.76
5747,18415,1245,0,1245,0.0,1.0
5748,18417,1121,0,1121,0.0,1.0
5749,18419,4634,1268,3366,0.274,0.726
5750,18420,57,0,57,0.0,1.0
5751,18421,4754,3184,1570,0.67,0.33
5752,18424,5613,0,5613,0.0,1.0
5753,18425,1354,0,1354,0.0,1.0
5754,18426,4526,0,4526,0.0,1.0
5755,18427,118,0,118,0.0,1.0
5756,18428,12012,158,11854,0.013,0.987
5757,18430,33,0,33,0.0,1.0
5758,18431,12666,5256,7410,0.415,0.585
5759,18433,6508,3966,2542,0.609,0.391
5760,18434,4192,4175,17,0.996,0.004
5761,18435,795,0,795,0.0,1.0
5762,18436,13853,0,13853,0.0,1.0
5763,18437,211,0,211,0.0,1.0
5764,18438,1172,0,1172,0.0,1.0
5765,18439,500,0,500,0.0,1.0
5766,18441,289,0,289,0.0,1.0
5767,18443,458,0,458,0.0,1.0
5768,18444,13778,2855,10923,0.207,0.793
5769,18445,2329,0,2329,0.0,1.0
5770,18446,3733,0,3733,0.0,1.0
5771,18447,10548,8385,2163,0.795,0.205
5772,18451,448,0,448,0.0,1.0
5773,18452,4802,4802,0,1.0,0.0
5774,18453,1104,0,1104,0.0,1.0
5775,18454,64,0,64,0.0,1.0
5776,18455,105,0,105,0.0,1.0
5777,18456,423,54,369,0.128,0.872
5778,18457,82,0,82,0.0,1.0
5779,18458,3017,0,3017,0.0,1.0
5780,18459,51,0,51,0.0,1.0
5781,18460,184,0,184,0.0,1.0
5782,18461,404,0,404,0.0,1.0
5783,18462,427,0,427,0.0,1.0
5784,18463,199,0,199,0.0,1.0
5785,18464,1193,0,1193,0.0,1.0
5786,18465,1340,0,1340,0.0,1.0
5787,18466,16681,15031,1650,0.901,0.099
5788,18469,357,0,357,0.0,1.0
5789,18470,2226,0,2226,0.0,1.0
5790,18471,685,272,413,0.397,0.603
5791,18472,7521,0,7521,0.0,1.0
5792,18473,495,381,114,0.77,0.23
5793,18503,1182,1182,0,1.0,0.0
5794,18504,21265,20975,290,0.986,0.014
5795,18505,20586,20008,578,0.972,0.028
5796,18507,4891,4889,2,1.0,0.0
5797,18508,12292,12226,66,0.995,0.005
5798,18509,13589,13589,0,1.0,0.0
5799,18510,14119,14119,0,1.0,0.0
5800,18512,12218,12196,22,0.998,0.002
5801,18517,5274,5148,126,0.976,0.024
5802,18518,8313,8313,0,1.0,0.0
5803,18519,5104,5104,0,1.0,0.0
5804,18602,257,0,257,0.0,1.0
5805,18603,19320,15030,4290,0.778,0.222
5806,18610,5008,2576,2432,0.514,0.486
5807,18612,18051,12114,5937,0.671,0.329
5808,18614,2426,0,2426,0.0,1.0
5809,18615,1867,0,1867,0.0,1.0
5810,18616,738,0,738,0.0,1.0
5811,18617,1924,1627,297,0.846,0.154
5812,18618,3793,1643,2150,0.433,0.567
5813,18619,273,0,273,0.0,1.0
5814,18621,6248,0,6248,0.0,1.0
5815,18622,257,0,257,0.0,1.0
5816,18623,2733,0,2733,0.0,1.0
5817,18624,718,0,718,0.0,1.0
5818,18625,491,0,491,0.0,1.0
5819,18626,516,0,516,0.0,1.0
5820,18628,192,0,192,0.0,1.0
5821,18629,1801,0,1801,0.0,1.0
5822,18630,3556,0,3556,0.0,1.0
5823,18631,1286,1236,50,0.961,0.039
5824,18632,409,0,409,0.0,1.0
5825,18634,13569,12820,749,0.945,0.055
5826,18635,3881,1519,2362,0.391,0.609
5827,18636,1438,0,1438,0.0,1.0
5828,18640,17155,16150,1005,0.941,0.059
5829,18641,6812,6812,0,1.0,0.0
5830,18642,4345,4275,70,0.984,0.016
5831,18643,12908,10196,2712,0.79,0.21
5832,18644,7546,5520,2026,0.732,0.268
5833,18651,8880,8238,642,0.928,0.072
5834,18653,132,0,132,0.0,1.0
5835,18655,6278,0,6278,0.0,1.0
5836,18656,2195,0,2195,0.0,1.0
5837,18657,11985,3426,8559,0.286,0.714
5838,18660,3702,0,3702,0.0,1.0
5839,18661,5730,0,5730,0.0,1.0
5840,18701,3447,3447,0,1.0,0.0
5841,18702,40295,37267,3028,0.925,0.075
5842,18704,31206,30915,291,0.991,0.009
5843,18705,14806,14806,0,1.0,0.0
5844,18706,16105,15421,684,0.958,0.042
5845,18707,15557,10719,4838,0.689,0.311
5846,18708,8817,7189,1628,0.815,0.185
5847,18709,2903,2903,0,1.0,0.0
5848,18801,8266,0,8266,0.0,1.0
5849,18810,6162,4282,1880,0.695,0.305
5850,18812,1644,0,1644,0.0,1.0
5851,18814,156,0,156,0.0,1.0
5852,18816,128,0,128,0.0,1.0
5853,18817,306,0,306,0.0,1.0
5854,18818,1394,0,1394,0.0,1.0
5855,18821,1153,936,217,0.812,0.188
5856,18822,3642,1474,2168,0.405,0.595
5857,18823,193,0,193,0.0,1.0
5858,18824,1401,0,1401,0.0,1.0
5859,18825,111,0,111,0.0,1.0
5860,18826,1910,0,1910,0.0,1.0
5861,18828,352,0,352,0.0,1.0
5862,18829,868,0,868,0.0,1.0
5863,18830,735,0,735,0.0,1.0
5864,18831,1039,0,1039,0.0,1.0
5865,18832,1874,544,1330,0.29,0.71
5866,18833,2056,0,2056,0.0,1.0
5867,18834,3691,0,3691,0.0,1.0
5868,18837,3267,0,3267,0.0,1.0
5869,18840,10731,8555,2176,0.797,0.203
5870,18842,278,0,278,0.0,1.0
5871,18843,277,0,277,0.0,1.0
5872,18844,1870,0,1870,0.0,1.0
5873,18845,297,0,297,0.0,1.0
5874,18846,847,0,847,0.0,1.0
5875,18847,6024,2597,3427,0.431,0.569
5876,18848,9193,4044,5149,0.44,0.56
5877,18850,2357,0,2357,0.0,1.0
5878,18851,706,0,706,0.0,1.0
5879,18853,4252,0,4252,0.0,1.0
5880,18854,1510,0,1510,0.0,1.0
5881,18901,27598,27013,585,0.979,0.021
5882,18902,20973,18356,2617,0.875,0.125
5883,18912,39,19,20,0.487,0.513
5884,18913,185,0,185,0.0,1.0
5885,18914,21063,20113,950,0.955,0.045
5886,18915,1063,1063,0,1.0,0.0
5887,18917,2158,2158,0,1.0,0.0
5888,18920,361,0,361,0.0,1.0
5889,18923,998,764,234,0.766,0.234
5890,18925,6195,4741,1454,0.765,0.235
5891,18929,9306,8736,570,0.939,0.061
5892,18930,2721,0,2721,0.0,1.0
5893,18932,388,388,0,1.0,0.0
5894,18935,116,116,0,1.0,0.0
5895,18936,4,4,0,1.0,0.0
5896,18938,13989,7224,6765,0.516,0.484
5897,18940,28825,25188,3637,0.874,0.126
5898,18942,3260,0,3260,0.0,1.0
5899,18944,24479,18613,5866,0.76,0.24
5900,18947,6172,2691,3481,0.436,0.564
5901,18950,252,0,252,0.0,1.0
5902,18951,34651,26178,8473,0.755,0.245
5903,18954,9745,9745,0,1.0,0.0
5904,18955,1662,1361,301,0.819,0.181
5905,18960,12473,9358,3115,0.75,0.25
5906,18962,515,515,0,1.0,0.0
5907,18964,13812,13812,0,1.0,0.0
5908,18966,37999,37999,0,1.0,0.0
5909,18969,15273,13643,1630,0.893,0.107
5910,18970,696,696,0,1.0,0.0
5911,18972,3512,388,3124,0.11,0.89
5912,18974,40953,40941,12,1.0,0.0
5913,18976,19795,19795,0,1.0,0.0
5914,18977,4291,4116,175,0.959,0.041
5915,18980,510,0,510,0.0,1.0
5916,19001,17020,17020,0,1.0,0.0
5917,19002,32412,32412,0,1.0,0.0
5918,19003,12519,12519,0,1.0,0.0
5919,19004,9416,9416,0,1.0,0.0
5920,19006,21423,21423,0,1.0,0.0
5921,19007,21125,21125,0,1.0,0.0
5922,19008,20535,20535,0,1.0,0.0
5923,19009,864,864,0,1.0,0.0
5924,19010,21103,21103,0,1.0,0.0
5925,19012,6670,6670,0,1.0,0.0
5926,19013,35130,35130,0,1.0,0.0
5927,19014,21206,21206,0,1.0,0.0
5928,19015,16632,16632,0,1.0,0.0
5929,19017,348,348,0,1.0,0.0
5930,19018,23360,23360,0,1.0,0.0
5931,19020,55493,55493,0,1.0,0.0
5932,19021,10074,10074,0,1.0,0.0
5933,19022,3669,3669,0,1.0,0.0
5934,19023,22164,22164,0,1.0,0.0
5935,19025,5395,5395,0,1.0,0.0
5936,19026,30738,30738,0,1.0,0.0
5937,19027,19067,19067,0,1.0,0.0
5938,19029,3971,3971,0,1.0,0.0
5939,19030,12122,12122,0,1.0,0.0
5940,19031,4700,4700,0,1.0,0.0
5941,19032,6606,6606,0,1.0,0.0
5942,19033,7777,7777,0,1.0,0.0
5943,19034,5999,5999,0,1.0,0.0
5944,19035,3780,3780,0,1.0,0.0
5945,19036,12942,12942,0,1.0,0.0
5946,19038,31595,31595,0,1.0,0.0
5947,19040,20536,20536,0,1.0,0.0
5948,19041,6248,6248,0,1.0,0.0
5949,19043,2664,2664,0,1.0,0.0
5950,19044,15853,15853,0,1.0,0.0
5951,19046,17809,17809,0,1.0,0.0
5952,19047,35056,35056,0,1.0,0.0
5953,19050,28073,28073,0,1.0,0.0
5954,19053,25966,25966,0,1.0,0.0
5955,19054,17437,17437,0,1.0,0.0
5956,19055,13924,13924,0,1.0,0.0
5957,19056,15486,15486,0,1.0,0.0
5958,19057,17191,17191,0,1.0,0.0
5959,19060,11368,11368,0,1.0,0.0
5960,19061,19997,19997,0,1.0,0.0
5961,19063,35704,35476,228,0.994,0.006
5962,19064,24459,24459,0,1.0,0.0
5963,19066,5864,5864,0,1.0,0.0
5964,19067,51334,51323,11,1.0,0.0
5965,19070,7277,7277,0,1.0,0.0
5966,19072,9539,9539,0,1.0,0.0
5967,19073,18332,17885,447,0.976,0.024
5968,19074,5890,5890,0,1.0,0.0
5969,19075,7354,7354,0,1.0,0.0
5970,19076,6525,6525,0,1.0,0.0
5971,19078,11067,11067,0,1.0,0.0
5972,19079,9168,9168,0,1.0,0.0
5973,19081,10337,10337,0,1.0,0.0
5974,19082,40997,40997,0,1.0,0.0
5975,19083,35878,35878,0,1.0,0.0
5976,19085,8932,8932,0,1.0,0.0
5977,19086,11420,11420,0,1.0,0.0
5978,19087,32225,32225,0,1.0,0.0
5979,19090,18832,18832,0,1.0,0.0
5980,19094,4406,4406,0,1.0,0.0
5981,19095,7063,7063,0,1.0,0.0
5982,19096,13572,13572,0,1.0,0.0
5983,19102,4705,4705,0,1.0,0.0
5984,19103,21908,21908,0,1.0,0.0
5985,19104,51808,51808,0,1.0,0.0
5986,19106,11740,11740,0,1.0,0.0
5987,19107,14875,14875,0,1.0,0.0
5988,19109,0,0,0,,
5989,19111,63090,63090,0,1.0,0.0
5990,19112,13,13,0,1.0,0.0
5991,19113,120,120,0,1.0,0.0
5992,19114,30907,30907,0,1.0,0.0
5993,19115,33207,33207,0,1.0,0.0
5994,19116,33112,33112,0,1.0,0.0
5995,19118,9808,9808,0,1.0,0.0
5996,19119,27035,27035,0,1.0,0.0
5997,19120,68104,68104,0,1.0,0.0
5998,19121,36572,36572,0,1.0,0.0
5999,19122,21653,21653,0,1.0,0.0
6000,19123,13416,13416,0,1.0,0.0
6001,19124,66691,66691,0,1.0,0.0
6002,19125,22958,22958,0,1.0,0.0
6003,19126,15758,15758,0,1.0,0.0
6004,19127,5913,5913,0,1.0,0.0
6005,19128,35239,35239,0,1.0,0.0
6006,19129,10975,10975,0,1.0,0.0
6007,19130,24870,24870,0,1.0,0.0
6008,19131,43172,43172,0,1.0,0.0
6009,19132,36268,36268,0,1.0,0.0
6010,19133,26063,26063,0,1.0,0.0
6011,19134,60675,60675,0,1.0,0.0
6012,19135,33091,33091,0,1.0,0.0
6013,19136,40647,40647,0,1.0,0.0
6014,19137,8638,8638,0,1.0,0.0
6015,19138,32273,32273,0,1.0,0.0
6016,19139,41271,41271,0,1.0,0.0
6017,19140,54133,54133,0,1.0,0.0
6018,19141,31376,31376,0,1.0,0.0
6019,19142,29595,29595,0,1.0,0.0
6020,19143,64849,64849,0,1.0,0.0
6021,19144,43329,43329,0,1.0,0.0
6022,19145,47261,47261,0,1.0,0.0
6023,19146,35113,35113,0,1.0,0.0
6024,19147,36228,36228,0,1.0,0.0
6025,19148,49732,49732,0,1.0,0.0
6026,19149,55006,55006,0,1.0,0.0
6027,19150,23378,23378,0,1.0,0.0
6028,19151,29883,29883,0,1.0,0.0
6029,19152,33293,33293,0,1.0,0.0
6030,19153,12259,12259,0,1.0,0.0
6031,19154,34196,34196,0,1.0,0.0
6032,19301,6402,6318,84,0.987,0.013
6033,19310,3066,1728,1338,0.564,0.436
6034,19311,8584,8004,580,0.932,0.068
6035,19312,11539,11286,253,0.978,0.022
6036,19316,186,152,34,0.817,0.183
6037,19317,9530,6466,3064,0.678,0.322
6038,19319,1130,1130,0,1.0,0.0
6039,19320,52342,45763,6579,0.874,0.126
6040,19330,5421,418,5003,0.077,0.923
6041,19333,6895,6895,0,1.0,0.0
6042,19335,46984,45852,1132,0.976,0.024
6043,19341,16709,16709,0,1.0,0.0
6044,19342,18099,17505,594,0.967,0.033
6045,19343,8142,4393,3749,0.54,0.46
6046,19344,11919,6941,4978,0.582,0.418
6047,19345,689,689,0,1.0,0.0
6048,19348,22232,19738,2494,0.888,0.112
6049,19350,10921,8261,2660,0.756,0.244
6050,19352,10622,8415,2207,0.792,0.208
6051,19355,24760,21246,3514,0.858,0.142
6052,19358,526,526,0,1.0,0.0
6053,19362,5815,1483,4332,0.255,0.745
6054,19363,17055,11180,5875,0.656,0.344
6055,19365,7006,4414,2592,0.63,0.37
6056,19367,171,159,12,0.93,0.07
6057,19372,1360,1360,0,1.0,0.0
6058,19373,4273,4273,0,1.0,0.0
6059,19374,1252,1106,146,0.883,0.117
6060,19375,104,35,69,0.337,0.663
6061,19380,49534,48842,692,0.986,0.014
6062,19382,52388,49571,2817,0.946,0.054
6063,19383,3169,3169,0,1.0,0.0
6064,19390,13425,11559,1866,0.861,0.139
6065,19401,41753,41753,0,1.0,0.0
6066,19403,44260,43320,940,0.979,0.021
6067,19405,5127,5127,0,1.0,0.0
6068,19406,23441,23441,0,1.0,0.0
6069,19422,18506,18506,0,1.0,0.0
6070,19425,13922,10830,3092,0.778,0.222
6071,19426,38831,36883,1948,0.95,0.05
6072,19428,16580,16580,0,1.0,0.0
6073,19435,100,0,100,0.0,1.0
6074,19436,640,640,0,1.0,0.0
6075,19437,757,757,0,1.0,0.0
6076,19438,23765,21926,1839,0.923,0.077
6077,19440,18038,17670,368,0.98,0.02
6078,19442,45,45,0,1.0,0.0
6079,19444,10519,10519,0,1.0,0.0
6080,19446,55138,54832,306,0.994,0.006
6081,19453,1483,1483,0,1.0,0.0
6082,19454,27870,27870,0,1.0,0.0
6083,19456,737,737,0,1.0,0.0
6084,19457,125,107,18,0.856,0.144
6085,19460,40154,37858,2296,0.943,0.057
6086,19462,14658,14658,0,1.0,0.0
6087,19464,45788,45347,441,0.99,0.01
6088,19465,17038,13577,3461,0.797,0.203
6089,19468,25536,25500,36,0.999,0.001
6090,19472,74,0,74,0.0,1.0
6091,19473,15726,12183,3543,0.775,0.225
6092,19474,733,733,0,1.0,0.0
6093,19475,11283,9301,1982,0.824,0.176
6094,19477,146,146,0,1.0,0.0
6095,19492,717,555,162,0.774,0.226
6096,19501,1047,928,119,0.886,0.114
6097,19503,1142,1062,80,0.93,0.07
6098,19504,4998,1202,3796,0.24,0.76
6099,19505,3226,1859,1367,0.576,0.424
6100,19506,7356,0,7356,0.0,1.0
6101,19507,3280,0,3280,0.0,1.0
6102,19508,15725,10028,5697,0.638,0.362
6103,19510,7639,6638,1001,0.869,0.131
6104,19511,215,0,215,0.0,1.0
6105,19512,16954,10477,6477,0.618,0.382
6106,19518,14734,12070,2664,0.819,0.181
6107,19519,101,101,0,1.0,0.0
6108,19520,5465,1253,4212,0.229,0.771
6109,19522,14229,6832,7397,0.48,0.52
6110,19523,250,0,250,0.0,1.0
6111,19525,14107,13140,967,0.931,0.069
6112,19526,11039,6796,4243,0.616,0.384
6113,19529,3131,0,3131,0.0,1.0
6114,19530,16432,10142,6290,0.617,0.383
6115,19533,7686,5256,2430,0.684,0.316
6116,19534,2041,0,2041,0.0,1.0
6117,19535,23,0,23,0.0,1.0
6118,19536,490,0,490,0.0,1.0
6119,19538,64,0,64,0.0,1.0
6120,19539,4597,1215,3382,0.264,0.736
6121,19540,11723,5584,6139,0.476,0.524
6122,19541,4403,1561,2842,0.355,0.645
6123,19542,67,67,0,1.0,0.0
6124,19543,5905,2444,3461,0.414,0.586
6125,19544,196,191,5,0.974,0.026
6126,19545,428,428,0,1.0,0.0
6127,19547,4222,1479,2743,0.35,0.65
6128,19549,326,284,42,0.871,0.129
6129,19550,641,0,641,0.0,1.0
6130,19551,5034,2653,2381,0.527,0.473
6131,19554,374,0,374,0.0,1.0
6132,19555,3406,1908,1498,0.56,0.44
6133,19559,362,0,362,0.0,1.0
6134,19560,7805,6506,1299,0.834,0.166
6135,19562,2622,2576,46,0.982,0.018
6136,19564,90,0,90,0.0,1.0
6137,19565,8531,6010,2521,0.704,0.296
6138,19567,5388,3466,1922,0.643,0.357
6139,19601,32998,32949,49,0.999,0.001
6140,19602,17900,17895,5,1.0,0.0
6141,19604,27658,27658,0,1.0,0.0
6142,19605,18985,18368,617,0.968,0.032
6143,19606,34416,31540,2876,0.916,0.084
6144,19607,22544,21868,676,0.97,0.03
6145,19608,22719,19600,3119,0.863,0.137
6146,19609,9946,9946,0,1.0,0.0
6147,19610,15258,15230,28,0.998,0.002
6148,19611,10589,10589,0,1.0,0.0
6149,19701,39194,37861,1333,0.966,0.034
6150,19702,51899,51690,209,0.996,0.004
6151,19703,14471,14471,0,1.0,0.0
6152,19706,1822,0,1822,0.0,1.0
6153,19707,16483,15684,799,0.952,0.048
6154,19709,35107,26868,8239,0.765,0.235
6155,19710,41,0,41,0.0,1.0
6156,19711,51322,50151,1171,0.977,0.023
6157,19713,30408,30408,0,1.0,0.0
6158,19716,1568,1568,0,1.0,0.0
6159,19717,3770,3770,0,1.0,0.0
6160,19720,59250,59139,111,0.998,0.002
6161,19730,451,385,66,0.854,0.146
6162,19731,252,0,252,0.0,1.0
6163,19732,25,0,25,0.0,1.0
6164,19733,110,110,0,1.0,0.0
6165,19734,11651,6483,5168,0.556,0.444
6166,19735,12,0,12,0.0,1.0
6167,19736,32,18,14,0.562,0.438
6168,19801,16286,16286,0,1.0,0.0
6169,19802,24621,24621,0,1.0,0.0
6170,19803,21364,20935,429,0.98,0.02
6171,19804,17944,17944,0,1.0,0.0
6172,19805,40937,40937,0,1.0,0.0
6173,19806,9560,9560,0,1.0,0.0
6174,19807,7405,4649,2756,0.628,0.372
6175,19808,38442,38442,0,1.0,0.0
6176,19809,14049,14049,0,1.0,0.0
6177,19810,25011,25011,0,1.0,0.0
6178,19901,35055,31925,3130,0.911,0.089
6179,19902,283,283,0,1.0,0.0
6180,19904,34132,29022,5110,0.85,0.15
6181,19930,2768,2701,67,0.976,0.024
6182,19931,211,0,211,0.0,1.0
6183,19933,8535,3624,4911,0.425,0.575
6184,19934,12805,8370,4435,0.654,0.346
6185,19936,302,302,0,1.0,0.0
6186,19938,8357,2762,5595,0.331,0.669
6187,19939,5979,3399,2580,0.568,0.432
6188,19940,5574,2040,3534,0.366,0.634
6189,19941,2522,0,2522,0.0,1.0
6190,19943,11425,5857,5568,0.513,0.487
6191,19944,620,525,95,0.847,0.153
6192,19945,6862,3299,3563,0.481,0.519
6193,19946,4420,2536,1884,0.574,0.426
6194,19947,18799,9034,9765,0.481,0.519
6195,19950,6951,263,6688,0.038,0.962
6196,19951,1733,537,1196,0.31,0.69
6197,19952,10220,4448,5772,0.435,0.565
6198,19953,4386,0,4386,0.0,1.0
6199,19954,1464,407,1057,0.278,0.722
6200,19955,72,0,72,0.0,1.0
6201,19956,15500,6341,9159,0.409,0.591
6202,19958,19650,13416,6234,0.683,0.317
6203,19960,6295,3296,2999,0.524,0.476
6204,19962,10206,9941,265,0.974,0.026
6205,19963,19206,14043,5163,0.731,0.269
6206,19964,1340,0,1340,0.0,1.0
6207,19966,24601,17399,7202,0.707,0.293
6208,19967,354,351,3,0.992,0.008
6209,19968,9549,3894,5655,0.408,0.592
6210,19970,6170,5579,591,0.904,0.096
6211,19971,12385,11997,388,0.969,0.031
6212,19973,23838,15926,7912,0.668,0.332
6213,19975,8253,3621,4632,0.439,0.561
6214,19977,22984,19298,3686,0.84,0.16
6215,19979,632,473,159,0.748,0.252
6216,20001,38551,38551,0,1.0,0.0
6217,20002,52370,52370,0,1.0,0.0
6218,20003,26454,26454,0,1.0,0.0
6219,20004,1622,1622,0,1.0,0.0
6220,20005,12775,12775,0,1.0,0.0
6221,20006,3227,3227,0,1.0,0.0
6222,20007,26866,26866,0,1.0,0.0
6223,20008,27525,27525,0,1.0,0.0
6224,20009,47992,47992,0,1.0,0.0
6225,20010,30138,30138,0,1.0,0.0
6226,20011,58536,58536,0,1.0,0.0
6227,20012,13414,13414,0,1.0,0.0
6228,20015,15332,15332,0,1.0,0.0
6229,20016,32519,32519,0,1.0,0.0
6230,20017,17735,17735,0,1.0,0.0
6231,20018,16894,16894,0,1.0,0.0
6232,20019,54358,54358,0,1.0,0.0
6233,20020,49864,49864,0,1.0,0.0
6234,20024,11510,11510,0,1.0,0.0
6235,20032,35653,35653,0,1.0,0.0
6236,20036,5435,5435,0,1.0,0.0
6237,20037,14642,14642,0,1.0,0.0
6238,20045,0,0,0,,
6239,20052,470,470,0,1.0,0.0
6240,20053,0,0,0,,
6241,20057,3888,3888,0,1.0,0.0
6242,20064,1890,1890,0,1.0,0.0
6243,20105,11315,10050,1265,0.888,0.112
6244,20106,5142,0,5142,0.0,1.0
6245,20109,37265,37056,209,0.994,0.006
6246,20110,43876,43876,0,1.0,0.0
6247,20111,30590,30404,186,0.994,0.006
6248,20112,25833,24508,1325,0.949,0.051
6249,20115,5838,0,5838,0.0,1.0
6250,20117,2693,0,2693,0.0,1.0
6251,20118,7,0,7,0.0,1.0
6252,20119,3946,0,3946,0.0,1.0
6253,20120,40695,39816,879,0.978,0.022
6254,20121,27988,27618,370,0.987,0.013
6255,20124,14857,10573,4284,0.712,0.288
6256,20129,618,78,540,0.126,0.874
6257,20130,281,0,281,0.0,1.0
6258,20132,15900,8018,7882,0.504,0.496
6259,20135,2834,0,2834,0.0,1.0
6260,20136,28498,28031,467,0.984,0.016
6261,20137,1510,30,1480,0.02,0.98
6262,20139,217,0,217,0.0,1.0
6263,20141,6131,2786,3345,0.454,0.546
6264,20143,1216,0,1216,0.0,1.0
6265,20144,1012,0,1012,0.0,1.0
6266,20147,54086,54084,2,1.0,0.0
6267,20148,28310,27237,1073,0.962,0.038
6268,20151,21374,21341,33,0.998,0.002
6269,20152,24946,24263,683,0.973,0.027
6270,20155,29411,27815,1596,0.946,0.054
6271,20158,4288,2555,1733,0.596,0.404
6272,20164,37747,37747,0,1.0,0.0
6273,20165,32383,32383,0,1.0,0.0
6274,20166,9521,8293,1228,0.871,0.129
6275,20169,19801,14996,4805,0.757,0.243
6276,20170,41236,41236,0,1.0,0.0
6277,20171,45887,45887,0,1.0,0.0
6278,20175,27169,20433,6736,0.752,0.248
6279,20176,46506,42085,4421,0.905,0.095
6280,20180,6549,1775,4774,0.271,0.729
6281,20181,7877,1391,6486,0.177,0.823
6282,20184,839,0,839,0.0,1.0
6283,20186,14557,9577,4980,0.658,0.342
6284,20187,15252,11512,3740,0.755,0.245
6285,20190,17529,17529,0,1.0,0.0
6286,20191,29128,29128,0,1.0,0.0
6287,20194,13165,13165,0,1.0,0.0
6288,20197,1840,0,1840,0.0,1.0
6289,20198,2492,0,2492,0.0,1.0
6290,20202,0,0,0,,
6291,20204,0,0,0,,
6292,20228,0,0,0,,
6293,20230,0,0,0,,
6294,20240,0,0,0,,
6295,20245,0,0,0,,
6296,20260,0,0,0,,
6297,20307,353,353,0,1.0,0.0
6298,20317,903,903,0,1.0,0.0
6299,20319,84,84,0,1.0,0.0
6300,20373,131,131,0,1.0,0.0
6301,20390,584,584,0,1.0,0.0
6302,20405,0,0,0,,
6303,20418,0,0,0,,
6304,20427,0,0,0,,
6305,20506,0,0,0,,
6306,20510,0,0,0,,
6307,20520,0,0,0,,
6308,20535,8,8,0,1.0,0.0
6309,20540,0,0,0,,
6310,20551,0,0,0,,
6311,20553,0,0,0,,
6312,20560,0,0,0,,
6313,20565,0,0,0,,
6314,20566,0,0,0,,
6315,20593,0,0,0,,
6316,20601,24156,19675,4481,0.814,0.186
6317,20602,24955,24625,330,0.987,0.013
6318,20603,28967,28961,6,1.0,0.0
6319,20606,431,0,431,0.0,1.0
6320,20607,9802,7759,2043,0.792,0.208
6321,20608,919,0,919,0.0,1.0
6322,20609,1120,0,1120,0.0,1.0
6323,20611,1078,0,1078,0.0,1.0
6324,20612,261,0,261,0.0,1.0
6325,20613,11860,5221,6639,0.44,0.56
6326,20615,405,0,405,0.0,1.0
6327,20616,5857,5246,611,0.896,0.104
6328,20617,781,0,781,0.0,1.0
6329,20618,607,0,607,0.0,1.0
6330,20619,10503,8734,1769,0.832,0.168
6331,20620,1443,824,619,0.571,0.429
6332,20621,1373,0,1373,0.0,1.0
6333,20622,4900,0,4900,0.0,1.0
6334,20623,2744,2657,87,0.968,0.032
6335,20624,1282,0,1282,0.0,1.0
6336,20625,1062,0,1062,0.0,1.0
6337,20626,373,0,373,0.0,1.0
6338,20628,594,0,594,0.0,1.0
6339,20629,535,535,0,1.0,0.0
6340,20630,348,0,348,0.0,1.0
6341,20632,347,0,347,0.0,1.0
6342,20634,5927,5171,756,0.872,0.128
6343,20636,9937,2236,7701,0.225,0.775
6344,20637,5423,161,5262,0.03,0.97
6345,20639,14227,3210,11017,0.226,0.774
6346,20640,10438,6470,3968,0.62,0.38
6347,20645,857,0,857,0.0,1.0
6348,20646,18890,10784,8106,0.571,0.429
6349,20650,13717,4737,8980,0.345,0.655
6350,20653,24481,20844,3637,0.851,0.149
6351,20657,20483,18557,1926,0.906,0.094
6352,20658,854,0,854,0.0,1.0
6353,20659,23498,7055,16443,0.3,0.7
6354,20660,97,0,97,0.0,1.0
6355,20662,2934,0,2934,0.0,1.0
6356,20664,2987,495,2492,0.166,0.834
6357,20667,494,364,130,0.737,0.263
6358,20670,1014,963,51,0.95,0.05
6359,20674,830,0,830,0.0,1.0
6360,20675,1671,682,989,0.408,0.592
6361,20676,3871,729,3142,0.188,0.812
6362,20677,2322,0,2322,0.0,1.0
6363,20678,11045,5294,5751,0.479,0.521
6364,20680,1119,0,1119,0.0,1.0
6365,20684,1125,0,1125,0.0,1.0
6366,20685,6471,3105,3366,0.48,0.52
6367,20686,1332,1208,124,0.907,0.093
6368,20687,313,0,313,0.0,1.0
6369,20688,1828,1828,0,1.0,0.0
6370,20689,1694,214,1480,0.126,0.874
6371,20690,740,0,740,0.0,1.0
6372,20692,1051,0,1051,0.0,1.0
6373,20693,1088,0,1088,0.0,1.0
6374,20695,6794,6268,526,0.923,0.077
6375,20701,2,2,0,1.0,0.0
6376,20705,26188,25863,325,0.988,0.012
6377,20706,38692,38692,0,1.0,0.0
6378,20707,31538,31459,79,0.997,0.003
6379,20708,25546,25386,160,0.994,0.006
6380,20710,9313,9313,0,1.0,0.0
6381,20711,6643,1550,5093,0.233,0.767
6382,20712,9031,9031,0,1.0,0.0
6383,20714,4345,4073,272,0.937,0.063
6384,20715,26382,26329,53,0.998,0.002
6385,20716,20787,20197,590,0.972,0.028
6386,20720,21031,20995,36,0.998,0.002
6387,20721,27016,27016,0,1.0,0.0
6388,20722,5711,5711,0,1.0,0.0
6389,20723,28972,28925,47,0.998,0.002
6390,20724,16093,15926,167,0.99,0.01
6391,20732,9919,9169,750,0.924,0.076
6392,20733,2672,2270,402,0.85,0.15
6393,20735,35421,34071,1350,0.962,0.038
6394,20736,8904,4893,4011,0.55,0.45
6395,20737,20684,20684,0,1.0,0.0
6396,20740,28780,28780,0,1.0,0.0
6397,20742,7808,7808,0,1.0,0.0
6398,20743,38621,38621,0,1.0,0.0
6399,20744,50722,50722,0,1.0,0.0
6400,20745,28451,28451,0,1.0,0.0
6401,20746,28838,28838,0,1.0,0.0
6402,20747,40054,40054,0,1.0,0.0
6403,20748,38792,38792,0,1.0,0.0
6404,20751,2343,2178,165,0.93,0.07
6405,20754,6951,3428,3523,0.493,0.507
6406,20755,9302,9302,0,1.0,0.0
6407,20758,721,29,692,0.04,0.96
6408,20759,3355,2625,730,0.782,0.218
6409,20762,2973,2973,0,1.0,0.0
6410,20763,2664,2664,0,1.0,0.0
6411,20764,4176,4176,0,1.0,0.0
6412,20765,514,514,0,1.0,0.0
6413,20769,6604,6602,2,1.0,0.0
6414,20770,25173,25147,26,0.999,0.001
6415,20772,42625,37697,4928,0.884,0.116
6416,20774,43013,41805,1208,0.972,0.028
6417,20776,3289,0,3289,0.0,1.0
6418,20777,3314,2328,986,0.702,0.298
6419,20778,2009,1474,535,0.734,0.266
6420,20779,1182,172,1010,0.146,0.854
6421,20781,11440,11440,0,1.0,0.0
6422,20782,30560,30560,0,1.0,0.0
6423,20783,44487,44487,0,1.0,0.0
6424,20784,29449,29449,0,1.0,0.0
6425,20785,35052,35052,0,1.0,0.0
6426,20794,14098,14098,0,1.0,0.0
6427,20812,255,255,0,1.0,0.0
6428,20814,27642,27642,0,1.0,0.0
6429,20815,29082,29082,0,1.0,0.0
6430,20816,16208,16208,0,1.0,0.0
6431,20817,36240,36240,0,1.0,0.0
6432,20818,1962,1962,0,1.0,0.0
6433,20832,24965,24964,1,1.0,0.0
6434,20833,7735,4979,2756,0.644,0.356
6435,20837,5789,4620,1169,0.798,0.202
6436,20838,259,0,259,0.0,1.0
6437,20839,214,0,214,0.0,1.0
6438,20841,10460,8838,1622,0.845,0.155
6439,20842,1824,0,1824,0.0,1.0
6440,20850,46340,46340,0,1.0,0.0
6441,20851,14191,14191,0,1.0,0.0
6442,20852,40365,40365,0,1.0,0.0
6443,20853,29673,29673,0,1.0,0.0
6444,20854,49611,49361,250,0.995,0.005
6445,20855,14295,13045,1250,0.913,0.087
6446,20860,2396,1895,501,0.791,0.209
6447,20861,1875,943,932,0.503,0.497
6448,20862,343,0,343,0.0,1.0
6449,20866,13344,12805,539,0.96,0.04
6450,20868,790,364,426,0.461,0.539
6451,20871,13130,10991,2139,0.837,0.163
6452,20872,13104,11063,2041,0.844,0.156
6453,20874,57367,55445,1922,0.966,0.034
6454,20876,25496,24641,855,0.966,0.034
6455,20877,34321,34321,0,1.0,0.0
6456,20878,62446,61594,852,0.986,0.014
6457,20879,24360,24360,0,1.0,0.0
6458,20880,450,450,0,1.0,0.0
6459,20882,14063,10608,3455,0.754,0.246
6460,20886,33282,33282,0,1.0,0.0
6461,20895,19054,19054,0,1.0,0.0
6462,20896,906,906,0,1.0,0.0
6463,20899,142,142,0,1.0,0.0
6464,20901,34832,34832,0,1.0,0.0
6465,20902,48841,48841,0,1.0,0.0
6466,20903,23625,23625,0,1.0,0.0
6467,20904,54612,54612,0,1.0,0.0
6468,20905,18044,17848,196,0.989,0.011
6469,20906,64696,64696,0,1.0,0.0
6470,20910,37445,37445,0,1.0,0.0
6471,20912,24807,24807,0,1.0,0.0
6472,21001,21487,19205,2282,0.894,0.106
6473,21005,2112,2066,46,0.978,0.022
6474,21009,29766,29766,0,1.0,0.0
6475,21010,104,0,104,0.0,1.0
6476,21012,21317,21317,0,1.0,0.0
6477,21013,4653,1209,3444,0.26,0.74
6478,21014,36047,36047,0,1.0,0.0
6479,21015,27763,23637,4126,0.851,0.149
6480,21017,7062,7062,0,1.0,0.0
6481,21028,3460,0,3460,0.0,1.0
6482,21029,11333,9914,1419,0.875,0.125
6483,21030,24355,21782,2573,0.894,0.106
6484,21031,4,4,0,1.0,0.0
6485,21032,8848,5912,2936,0.668,0.332
6486,21034,3387,0,3387,0.0,1.0
6487,21035,7815,2279,5536,0.292,0.708
6488,21036,2114,373,1741,0.176,0.824
6489,21037,20618,19839,779,0.962,0.038
6490,21040,24420,24420,0,1.0,0.0
6491,21042,38076,34322,3754,0.901,0.099
6492,21043,42246,42246,0,1.0,0.0
6493,21044,41704,41704,0,1.0,0.0
6494,21045,38288,38288,0,1.0,0.0
6495,21046,15080,15080,0,1.0,0.0
6496,21047,11873,10047,1826,0.846,0.154
6497,21048,10650,6881,3769,0.646,0.354
6498,21050,18202,15268,2934,0.839,0.161
6499,21051,279,0,279,0.0,1.0
6500,21052,303,303,0,1.0,0.0
6501,21053,3305,41,3264,0.012,0.988
6502,21054,10127,8419,1708,0.831,0.169
6503,21056,267,0,267,0.0,1.0
6504,21057,4112,1204,2908,0.293,0.707
6505,21060,29223,29218,5,1.0,0.0
6506,21061,53684,53684,0,1.0,0.0
6507,21071,497,328,169,0.66,0.34
6508,21074,15084,9397,5687,0.623,0.377
6509,21075,26344,26344,0,1.0,0.0
6510,21076,12952,12952,0,1.0,0.0
6511,21077,224,224,0,1.0,0.0
6512,21078,17603,14834,2769,0.843,0.157
6513,21082,654,0,654,0.0,1.0
6514,21084,7652,2214,5438,0.289,0.711
6515,21085,16171,14756,1415,0.912,0.088
6516,21087,5451,3147,2304,0.577,0.423
6517,21090,9784,9784,0,1.0,0.0
6518,21093,36465,36195,270,0.993,0.007
6519,21102,11751,5319,6432,0.453,0.547
6520,21104,4601,2162,2439,0.47,0.53
6521,21105,65,0,65,0.0,1.0
6522,21108,17964,16994,970,0.946,0.054
6523,21111,4903,101,4802,0.021,0.979
6524,21113,30469,30132,337,0.989,0.011
6525,21114,25225,25225,0,1.0,0.0
6526,21117,53778,51435,2343,0.956,0.044
6527,21120,6967,0,6967,0.0,1.0
6528,21122,60576,59228,1348,0.978,0.022
6529,21128,12802,12802,0,1.0,0.0
6530,21130,187,187,0,1.0,0.0
6531,21131,7253,3820,3433,0.527,0.473
6532,21132,2634,0,2634,0.0,1.0
6533,21133,29998,29365,633,0.979,0.021
6534,21136,33781,28388,5393,0.84,0.16
6535,21140,3457,3457,0,1.0,0.0
6536,21144,31884,31219,665,0.979,0.021
6537,21146,26705,26705,0,1.0,0.0
6538,21152,5544,2795,2749,0.504,0.496
6539,21153,323,133,190,0.412,0.588
6540,21154,6464,0,6464,0.0,1.0
6541,21155,2371,514,1857,0.217,0.783
6542,21156,358,177,181,0.494,0.506
6543,21157,36920,24413,12507,0.661,0.339
6544,21158,20234,10452,9782,0.517,0.483
6545,21160,2408,0,2408,0.0,1.0
6546,21161,5490,0,5490,0.0,1.0
6547,21162,3655,3315,340,0.907,0.093
6548,21163,7026,4726,2300,0.673,0.327
6549,21201,16972,16972,0,1.0,0.0
6550,21202,22832,22832,0,1.0,0.0
6551,21204,20253,20253,0,1.0,0.0
6552,21205,16146,16146,0,1.0,0.0
6553,21206,50846,50846,0,1.0,0.0
6554,21207,48133,48133,0,1.0,0.0
6555,21208,33917,33659,258,0.992,0.008
6556,21209,26465,26465,0,1.0,0.0
6557,21210,14292,14292,0,1.0,0.0
6558,21211,17351,17351,0,1.0,0.0
6559,21212,32322,32322,0,1.0,0.0
6560,21213,32733,32733,0,1.0,0.0
6561,21214,20564,20564,0,1.0,0.0
6562,21215,60161,60161,0,1.0,0.0
6563,21216,32071,32071,0,1.0,0.0
6564,21217,37111,37111,0,1.0,0.0
6565,21218,49796,49796,0,1.0,0.0
6566,21219,9379,9169,210,0.978,0.022
6567,21220,39199,39095,104,0.997,0.003
6568,21221,42154,41399,755,0.982,0.018
6569,21222,55786,55786,0,1.0,0.0
6570,21223,26366,26366,0,1.0,0.0
6571,21224,49134,49134,0,1.0,0.0
6572,21225,33545,33545,0,1.0,0.0
6573,21226,7561,7330,231,0.969,0.031
6574,21227,33534,33534,0,1.0,0.0
6575,21228,47577,47577,0,1.0,0.0
6576,21229,45213,45213,0,1.0,0.0
6577,21230,33568,33568,0,1.0,0.0
6578,21231,15748,15748,0,1.0,0.0
6579,21234,69752,69752,0,1.0,0.0
6580,21236,38474,38474,0,1.0,0.0
6581,21237,30059,30059,0,1.0,0.0
6582,21239,28793,28793,0,1.0,0.0
6583,21240,0,0,0,,
6584,21244,34611,33807,804,0.977,0.023
6585,21250,3205,3205,0,1.0,0.0
6586,21251,934,934,0,1.0,0.0
6587,21252,2872,2872,0,1.0,0.0
6588,21286,19206,18673,533,0.972,0.028
6589,21401,36012,35258,754,0.979,0.021
6590,21402,5217,5217,0,1.0,0.0
6591,21403,30269,30269,0,1.0,0.0
6592,21405,544,208,336,0.382,0.618
6593,21409,20064,20064,0,1.0,0.0
6594,21502,44400,37806,6594,0.851,0.149
6595,21520,2074,0,2074,0.0,1.0
6596,21521,1265,883,382,0.698,0.302
6597,21522,141,0,141,0.0,1.0
6598,21523,286,105,181,0.367,0.633
6599,21524,626,428,198,0.684,0.316
6600,21529,631,513,118,0.813,0.187
6601,21530,1591,0,1591,0.0,1.0
6602,21531,2227,0,2227,0.0,1.0
6603,21532,15620,10740,4880,0.688,0.312
6604,21536,4121,0,4121,0.0,1.0
6605,21538,716,0,716,0.0,1.0
6606,21539,2819,1597,1222,0.567,0.433
6607,21540,65,56,9,0.862,0.138
6608,21541,1546,0,1546,0.0,1.0
6609,21542,483,0,483,0.0,1.0
6610,21543,140,132,8,0.943,0.057
6611,21545,1940,0,1940,0.0,1.0
6612,21550,14194,4720,9474,0.333,0.667
6613,21555,1936,0,1936,0.0,1.0
6614,21557,1895,43,1852,0.023,0.977
6615,21561,2627,21,2606,0.008,0.992
6616,21562,3141,2426,715,0.772,0.228
6617,21601,23597,17103,6494,0.725,0.275
6618,21607,583,0,583,0.0,1.0
6619,21610,378,0,378,0.0,1.0
6620,21612,492,0,492,0.0,1.0
6621,21613,17330,14255,3075,0.823,0.177
6622,21617,9907,4285,5622,0.433,0.567
6623,21619,5848,3990,1858,0.682,0.318
6624,21620,12853,7153,5700,0.557,0.443
6625,21622,558,0,558,0.0,1.0
6626,21623,2111,0,2111,0.0,1.0
6627,21624,143,0,143,0.0,1.0
6628,21625,2719,0,2719,0.0,1.0
6629,21626,120,0,120,0.0,1.0
6630,21627,18,0,18,0.0,1.0
6631,21628,556,0,556,0.0,1.0
6632,21629,9555,4771,4784,0.499,0.501
6633,21631,2731,0,2731,0.0,1.0
6634,21632,6353,3190,3163,0.502,0.498
6635,21634,305,0,305,0.0,1.0
6636,21635,2098,0,2098,0.0,1.0
6637,21636,1186,0,1186,0.0,1.0
6638,21638,4934,2496,2438,0.506,0.494
6639,21639,4408,0,4408,0.0,1.0
6640,21640,1632,0,1632,0.0,1.0
6641,21641,117,0,117,0.0,1.0
6642,21643,5979,0,5979,0.0,1.0
6643,21644,111,0,111,0.0,1.0
6644,21645,1039,0,1039,0.0,1.0
6645,21647,289,0,289,0.0,1.0
6646,21648,255,0,255,0.0,1.0
6647,21649,1858,0,1858,0.0,1.0
6648,21650,238,0,238,0.0,1.0
6649,21651,2898,0,2898,0.0,1.0
6650,21652,183,0,183,0.0,1.0
6651,21653,114,0,114,0.0,1.0
6652,21654,1236,0,1236,0.0,1.0
6653,21655,5009,0,5009,0.0,1.0
6654,21657,777,0,777,0.0,1.0
6655,21658,3862,0,3862,0.0,1.0
6656,21659,1551,0,1551,0.0,1.0
6657,21660,4063,0,4063,0.0,1.0
6658,21661,2653,0,2653,0.0,1.0
6659,21662,555,0,555,0.0,1.0
6660,21663,3308,0,3308,0.0,1.0
6661,21664,539,0,539,0.0,1.0
6662,21665,287,0,287,0.0,1.0
6663,21666,12309,9367,2942,0.761,0.239
6664,21667,310,0,310,0.0,1.0
6665,21668,1904,0,1904,0.0,1.0
6666,21669,229,0,229,0.0,1.0
6667,21671,756,0,756,0.0,1.0
6668,21672,241,0,241,0.0,1.0
6669,21673,3136,29,3107,0.009,0.991
6670,21675,105,0,105,0.0,1.0
6671,21676,398,0,398,0.0,1.0
6672,21677,440,0,440,0.0,1.0
6673,21678,2301,0,2301,0.0,1.0
6674,21679,483,0,483,0.0,1.0
6675,21701,35293,31818,3475,0.902,0.098
6676,21702,38847,35863,2984,0.923,0.077
6677,21703,32854,30228,2626,0.92,0.08
6678,21704,13321,10627,2694,0.798,0.202
6679,21705,8,8,0,1.0,0.0
6680,21710,4515,901,3614,0.2,0.8
6681,21711,1029,0,1029,0.0,1.0
6682,21713,9502,4909,4593,0.517,0.483
6683,21714,99,99,0,1.0,0.0
6684,21716,4885,4885,0,1.0,0.0
6685,21717,54,19,35,0.352,0.648
6686,21718,151,0,151,0.0,1.0
6687,21719,1548,1185,363,0.766,0.234
6688,21722,5545,0,5545,0.0,1.0
6689,21723,803,0,803,0.0,1.0
6690,21727,5850,3928,1922,0.671,0.329
6691,21733,1163,169,994,0.145,0.855
6692,21734,771,771,0,1.0,0.0
6693,21737,1458,798,660,0.547,0.453
6694,21738,3268,1747,1521,0.535,0.465
6695,21740,61859,54517,7342,0.881,0.119
6696,21742,31444,27106,4338,0.862,0.138
6697,21746,1883,1883,0,1.0,0.0
6698,21750,3766,0,3766,0.0,1.0
6699,21754,6323,4474,1849,0.708,0.292
6700,21755,5591,2792,2799,0.499,0.501
6701,21756,3612,0,3612,0.0,1.0
6702,21757,3036,103,2933,0.034,0.966
6703,21758,4921,1835,3086,0.373,0.627
6704,21762,249,0,249,0.0,1.0
6705,21766,700,0,700,0.0,1.0
6706,21767,991,991,0,1.0,0.0
6707,21769,11236,6996,4240,0.623,0.377
6708,21770,5164,3999,1165,0.774,0.226
6709,21771,29563,16352,13211,0.553,0.447
6710,21773,5460,0,5460,0.0,1.0
6711,21774,11662,10378,1284,0.89,0.11
6712,21776,5735,42,5693,0.007,0.993
6713,21777,1470,0,1470,0.0,1.0
6714,21778,1094,0,1094,0.0,1.0
6715,21779,983,0,983,0.0,1.0
6716,21780,1625,8,1617,0.005,0.995
6717,21781,136,0,136,0.0,1.0
6718,21782,4097,1395,2702,0.34,0.66
6719,21783,9130,4946,4184,0.542,0.458
6720,21784,37941,27989,9952,0.738,0.262
6721,21787,10693,6599,4094,0.617,0.383
6722,21788,11622,6863,4759,0.591,0.409
6723,21790,100,0,100,0.0,1.0
6724,21791,5281,0,5281,0.0,1.0
6725,21793,9775,8269,1506,0.846,0.154
6726,21794,2434,856,1578,0.352,0.648
6727,21795,9233,6114,3119,0.662,0.338
6728,21797,8839,0,8839,0.0,1.0
6729,21798,2345,1144,1201,0.488,0.512
6730,21801,29961,26939,3022,0.899,0.101
6731,21802,89,89,0,1.0,0.0
6732,21804,38491,34929,3562,0.907,0.093
6733,21810,487,123,364,0.253,0.747
6734,21811,22550,17960,4590,0.796,0.204
6735,21813,2852,52,2800,0.018,0.982
6736,21814,380,0,380,0.0,1.0
6737,21817,5236,3600,1636,0.688,0.312
6738,21821,991,0,991,0.0,1.0
6739,21822,1930,239,1691,0.124,0.876
6740,21824,198,0,198,0.0,1.0
6741,21826,4837,4662,175,0.964,0.036
6742,21829,527,0,527,0.0,1.0
6743,21830,4026,1696,2330,0.421,0.579
6744,21835,507,0,507,0.0,1.0
6745,21837,2614,0,2614,0.0,1.0
6746,21838,1736,0,1736,0.0,1.0
6747,21840,375,0,375,0.0,1.0
6748,21841,860,0,860,0.0,1.0
6749,21842,11089,10947,142,0.987,0.013
6750,21849,3238,322,2916,0.099,0.901
6751,21850,2790,0,2790,0.0,1.0
6752,21851,7315,4329,2986,0.592,0.408
6753,21853,11126,7072,4054,0.636,0.364
6754,21856,1035,0,1035,0.0,1.0
6755,21861,757,0,757,0.0,1.0
6756,21862,106,0,106,0.0,1.0
6757,21863,5029,0,5029,0.0,1.0
6758,21864,611,0,611,0.0,1.0
6759,21865,470,0,470,0.0,1.0
6760,21866,78,0,78,0.0,1.0
6761,21867,114,0,114,0.0,1.0
6762,21869,1006,0,1006,0.0,1.0
6763,21871,2124,84,2040,0.04,0.96
6764,21872,718,0,718,0.0,1.0
6765,21874,2210,0,2210,0.0,1.0
6766,21875,6467,4494,1973,0.695,0.305
6767,21890,3240,3240,0,1.0,0.0
6768,21901,15875,10888,4987,0.686,0.314
6769,21902,471,394,77,0.837,0.163
6770,21903,5687,4957,730,0.872,0.128
6771,21904,7252,3930,3322,0.542,0.458
6772,21911,11004,4207,6797,0.382,0.618
6773,21912,1240,0,1240,0.0,1.0
6774,21913,663,0,663,0.0,1.0
6775,21914,765,669,96,0.875,0.125
6776,21915,3030,443,2587,0.146,0.854
6777,21916,37,0,37,0.0,1.0
6778,21917,2520,1349,1171,0.535,0.465
6779,21918,4284,536,3748,0.125,0.875
6780,21919,3467,0,3467,0.0,1.0
6781,21920,257,240,17,0.934,0.066
6782,21921,44471,30926,13545,0.695,0.305
6783,21930,94,0,94,0.0,1.0
6784,22003,55990,55990,0,1.0,0.0
6785,22015,43102,43102,0,1.0,0.0
6786,22025,17379,17342,37,0.998,0.002
6787,22026,14258,14258,0,1.0,0.0
6788,22027,2362,2362,0,1.0,0.0
6789,22030,55066,54993,73,0.999,0.001
6790,22031,29795,29795,0,1.0,0.0
6791,22032,29377,29377,0,1.0,0.0
6792,22033,37691,37691,0,1.0,0.0
6793,22035,0,0,0,,
6794,22039,18364,14783,3581,0.805,0.195
6795,22041,27989,27989,0,1.0,0.0
6796,22042,33537,33537,0,1.0,0.0
6797,22043,24302,24302,0,1.0,0.0
6798,22044,14092,14092,0,1.0,0.0
6799,22046,16235,16235,0,1.0,0.0
6800,22060,8878,8257,621,0.93,0.07
6801,22066,18099,15699,2400,0.867,0.133
6802,22079,32059,29923,2136,0.933,0.067
6803,22101,29887,29720,167,0.994,0.006
6804,22102,21985,21432,553,0.975,0.025
6805,22124,17558,17558,0,1.0,0.0
6806,22125,711,711,0,1.0,0.0
6807,22134,6862,6448,414,0.94,0.06
6808,22150,27105,27105,0,1.0,0.0
6809,22151,17456,17456,0,1.0,0.0
6810,22152,28550,28550,0,1.0,0.0
6811,22153,31285,31285,0,1.0,0.0
6812,22172,8699,8536,163,0.981,0.019
6813,22180,23491,23491,0,1.0,0.0
6814,22181,14879,14879,0,1.0,0.0
6815,22182,24863,24863,0,1.0,0.0
6816,22185,0,0,0,,
6817,22191,57598,57598,0,1.0,0.0
6818,22192,53394,52934,460,0.991,0.009
6819,22193,73047,73047,0,1.0,0.0
6820,22201,33476,33476,0,1.0,0.0
6821,22202,22543,22543,0,1.0,0.0
6822,22203,21850,21850,0,1.0,0.0
6823,22204,47233,47233,0,1.0,0.0
6824,22205,17087,17087,0,1.0,0.0
6825,22206,19051,19051,0,1.0,0.0
6826,22207,30920,30920,0,1.0,0.0
6827,22209,12314,12314,0,1.0,0.0
6828,22211,648,648,0,1.0,0.0
6829,22213,2936,2936,0,1.0,0.0
6830,22214,0,0,0,,
6831,22301,11162,11162,0,1.0,0.0
6832,22302,16485,16485,0,1.0,0.0
6833,22303,12601,12601,0,1.0,0.0
6834,22304,44300,44300,0,1.0,0.0
6835,22305,15440,15440,0,1.0,0.0
6836,22306,32326,32326,0,1.0,0.0
6837,22307,9581,9581,0,1.0,0.0
6838,22308,12737,12737,0,1.0,0.0
6839,22309,33220,33220,0,1.0,0.0
6840,22310,29609,29609,0,1.0,0.0
6841,22311,17560,17560,0,1.0,0.0
6842,22312,30614,30614,0,1.0,0.0
6843,22314,29653,29653,0,1.0,0.0
6844,22315,26202,26202,0,1.0,0.0
6845,22401,24286,24003,283,0.988,0.012
6846,22405,29152,22875,6277,0.785,0.215
6847,22406,20757,11531,9226,0.556,0.444
6848,22407,54962,48280,6682,0.878,0.122
6849,22408,26851,24753,2098,0.922,0.078
6850,22427,3286,0,3286,0.0,1.0
6851,22432,394,0,394,0.0,1.0
6852,22433,232,0,232,0.0,1.0
6853,22435,2439,0,2439,0.0,1.0
6854,22436,746,0,746,0.0,1.0
6855,22437,725,0,725,0.0,1.0
6856,22438,463,0,463,0.0,1.0
6857,22443,8083,3693,4390,0.457,0.543
6858,22448,599,599,0,1.0,0.0
6859,22454,1796,0,1796,0.0,1.0
6860,22460,1876,0,1876,0.0,1.0
6861,22469,1921,0,1921,0.0,1.0
6862,22473,5099,0,5099,0.0,1.0
6863,22476,369,0,369,0.0,1.0
6864,22480,714,0,714,0.0,1.0
6865,22482,2993,0,2993,0.0,1.0
6866,22485,23004,5724,17280,0.249,0.751
6867,22488,1398,0,1398,0.0,1.0
6868,22503,4334,0,4334,0.0,1.0
6869,22504,263,0,263,0.0,1.0
6870,22508,12696,9231,3465,0.727,0.273
6871,22509,31,0,31,0.0,1.0
6872,22511,1240,0,1240,0.0,1.0
6873,22514,2603,0,2603,0.0,1.0
6874,22520,5402,0,5402,0.0,1.0
6875,22529,335,0,335,0.0,1.0
6876,22530,126,0,126,0.0,1.0
6877,22534,2796,0,2796,0.0,1.0
6878,22535,580,0,580,0.0,1.0
6879,22538,307,0,307,0.0,1.0
6880,22539,2063,0,2063,0.0,1.0
6881,22542,1950,0,1950,0.0,1.0
6882,22546,15850,6165,9685,0.389,0.611
6883,22548,73,0,73,0.0,1.0
6884,22551,19242,1116,18126,0.058,0.942
6885,22553,13935,8680,5255,0.623,0.377
6886,22554,51463,44580,6883,0.866,0.134
6887,22556,25675,22866,2809,0.891,0.109
6888,22560,6704,2534,4170,0.378,0.622
6889,22567,3163,0,3163,0.0,1.0
6890,22572,7470,0,7470,0.0,1.0
6891,22576,1785,0,1785,0.0,1.0
6892,22578,2510,0,2510,0.0,1.0
6893,22579,155,0,155,0.0,1.0
6894,22580,5160,0,5160,0.0,1.0
6895,22601,27813,27813,0,1.0,0.0
6896,22602,28443,18091,10352,0.636,0.364
6897,22603,13910,5834,8076,0.419,0.581
6898,22610,1842,0,1842,0.0,1.0
6899,22611,8757,4277,4480,0.488,0.512
6900,22620,2348,0,2348,0.0,1.0
6901,22623,670,0,670,0.0,1.0
6902,22624,2565,12,2553,0.005,0.995
6903,22625,3641,0,3641,0.0,1.0
6904,22627,637,0,637,0.0,1.0
6905,22630,30292,16783,13509,0.554,0.446
6906,22637,1970,0,1970,0.0,1.0
6907,22639,560,0,560,0.0,1.0
6908,22640,532,0,532,0.0,1.0
6909,22641,361,0,361,0.0,1.0
6910,22642,4414,1855,2559,0.42,0.58
6911,22643,197,0,197,0.0,1.0
6912,22644,2177,488,1689,0.224,0.776
6913,22645,3880,0,3880,0.0,1.0
6914,22646,205,0,205,0.0,1.0
6915,22650,978,0,978,0.0,1.0
6916,22652,1399,0,1399,0.0,1.0
6917,22654,640,0,640,0.0,1.0
6918,22655,19328,16504,2824,0.854,0.146
6919,22656,2381,1187,1194,0.499,0.501
6920,22657,10956,7015,3941,0.64,0.36
6921,22660,1689,106,1583,0.063,0.937
6922,22663,1536,8,1528,0.005,0.995
6923,22664,8753,5031,3722,0.575,0.425
6924,22701,31444,17778,13666,0.565,0.435
6925,22709,874,0,874,0.0,1.0
6926,22711,92,0,92,0.0,1.0
6927,22712,8415,4652,3763,0.553,0.447
6928,22713,1406,0,1406,0.0,1.0
6929,22714,1129,0,1129,0.0,1.0
6930,22715,1082,0,1082,0.0,1.0
6931,22716,853,0,853,0.0,1.0
6932,22718,534,0,534,0.0,1.0
6933,22719,395,0,395,0.0,1.0
6934,22720,1059,0,1059,0.0,1.0
6935,22722,273,0,273,0.0,1.0
6936,22723,128,0,128,0.0,1.0
6937,22724,2282,0,2282,0.0,1.0
6938,22726,776,0,776,0.0,1.0
6939,22727,5547,0,5547,0.0,1.0
6940,22728,3310,0,3310,0.0,1.0
6941,22729,1338,0,1338,0.0,1.0
6942,22730,115,0,115,0.0,1.0
6943,22731,139,0,139,0.0,1.0
6944,22732,191,0,191,0.0,1.0
6945,22733,1469,0,1469,0.0,1.0
6946,22734,3187,1969,1218,0.618,0.382
6947,22735,2277,0,2277,0.0,1.0
6948,22736,732,0,732,0.0,1.0
6949,22737,2936,0,2936,0.0,1.0
6950,22738,1149,0,1149,0.0,1.0
6951,22740,1313,0,1313,0.0,1.0
6952,22741,182,0,182,0.0,1.0
6953,22742,1926,0,1926,0.0,1.0
6954,22743,204,0,204,0.0,1.0
6955,22747,1132,0,1132,0.0,1.0
6956,22749,349,0,349,0.0,1.0
6957,22801,37989,36228,1761,0.954,0.046
6958,22802,26293,18867,7426,0.718,0.282
6959,22807,3311,3311,0,1.0,0.0
6960,22810,863,0,863,0.0,1.0
6961,22811,500,0,500,0.0,1.0
6962,22812,8927,5735,3192,0.642,0.358
6963,22815,8355,4005,4350,0.479,0.521
6964,22820,214,0,214,0.0,1.0
6965,22821,5753,1536,4217,0.267,0.733
6966,22824,6018,1392,4626,0.231,0.769
6967,22827,10388,3136,7252,0.302,0.698
6968,22830,1773,0,1773,0.0,1.0
6969,22831,813,0,813,0.0,1.0
6970,22832,1091,0,1091,0.0,1.0
6971,22834,1250,0,1250,0.0,1.0
6972,22835,11634,4770,6864,0.41,0.59
6973,22840,4354,521,3833,0.12,0.88
6974,22841,2791,408,2383,0.146,0.854
6975,22842,5063,0,5063,0.0,1.0
6976,22843,2458,0,2458,0.0,1.0
6977,22844,4528,0,4528,0.0,1.0
6978,22845,33,0,33,0.0,1.0
6979,22846,1855,699,1156,0.377,0.623
6980,22847,1066,0,1066,0.0,1.0
6981,22849,5044,0,5044,0.0,1.0
6982,22850,899,0,899,0.0,1.0
6983,22851,5956,0,5956,0.0,1.0
6984,22853,4367,2223,2144,0.509,0.491
6985,22901,32532,27133,5399,0.834,0.166
6986,22902,21223,18400,2823,0.867,0.133
6987,22903,38229,31773,6456,0.831,0.169
6988,22904,4633,4633,0,1.0,0.0
6989,22911,15971,11489,4482,0.719,0.281
6990,22920,4186,0,4186,0.0,1.0
6991,22922,1993,0,1993,0.0,1.0
6992,22923,5035,1317,3718,0.262,0.738
6993,22931,382,0,382,0.0,1.0
6994,22932,7488,4377,3111,0.585,0.415
6995,22935,926,0,926,0.0,1.0
6996,22936,4853,81,4772,0.017,0.983
6997,22937,1486,0,1486,0.0,1.0
6998,22938,1444,0,1444,0.0,1.0
6999,22939,5398,3613,1785,0.669,0.331
7000,22940,1119,0,1119,0.0,1.0
7001,22942,8113,187,7926,0.023,0.977
7002,22943,444,0,444,0.0,1.0
7003,22946,244,0,244,0.0,1.0
7004,22947,4198,0,4198,0.0,1.0
7005,22948,305,0,305,0.0,1.0
7006,22949,1300,0,1300,0.0,1.0
7007,22952,2029,0,2029,0.0,1.0
7008,22958,1637,0,1637,0.0,1.0
7009,22959,1578,0,1578,0.0,1.0
7010,22960,10722,4715,6007,0.44,0.56
7011,22963,15401,9528,5873,0.619,0.381
7012,22964,261,0,261,0.0,1.0
7013,22967,1956,0,1956,0.0,1.0
7014,22968,9815,6360,3455,0.648,0.352
7015,22969,1437,0,1437,0.0,1.0
7016,22971,1735,0,1735,0.0,1.0
7017,22972,439,0,439,0.0,1.0
7018,22973,6191,1299,4892,0.21,0.79
7019,22974,5385,0,5385,0.0,1.0
7020,22976,339,0,339,0.0,1.0
7021,22980,31451,24674,6777,0.785,0.215
7022,22989,112,0,112,0.0,1.0
7023,23002,10439,0,10439,0.0,1.0
7024,23004,851,0,851,0.0,1.0
7025,23005,15227,8774,6453,0.576,0.424
7026,23009,6279,0,6279,0.0,1.0
7027,23011,1429,0,1429,0.0,1.0
7028,23015,4249,0,4249,0.0,1.0
7029,23021,345,0,345,0.0,1.0
7030,23022,930,0,930,0.0,1.0
7031,23023,323,0,323,0.0,1.0
7032,23024,8120,0,8120,0.0,1.0
7033,23025,233,0,233,0.0,1.0
7034,23027,1413,0,1413,0.0,1.0
7035,23030,5128,0,5128,0.0,1.0
7036,23032,283,0,283,0.0,1.0
7037,23035,1473,0,1473,0.0,1.0
7038,23038,1775,0,1775,0.0,1.0
7039,23039,1056,0,1056,0.0,1.0
7040,23040,4661,0,4661,0.0,1.0
7041,23043,1692,0,1692,0.0,1.0
7042,23045,96,0,96,0.0,1.0
7043,23047,1952,0,1952,0.0,1.0
7044,23050,598,0,598,0.0,1.0
7045,23055,915,0,915,0.0,1.0
7046,23056,458,0,458,0.0,1.0
7047,23059,31919,29231,2688,0.916,0.084
7048,23060,33417,33417,0,1.0,0.0
7049,23061,21208,4177,17031,0.197,0.803
7050,23062,2340,2318,22,0.991,0.009
7051,23063,5278,0,5278,0.0,1.0
7052,23064,131,0,131,0.0,1.0
7053,23065,1909,0,1909,0.0,1.0
7054,23066,471,0,471,0.0,1.0
7055,23068,257,0,257,0.0,1.0
7056,23069,3197,0,3197,0.0,1.0
7057,23070,431,0,431,0.0,1.0
7058,23071,1563,0,1563,0.0,1.0
7059,23072,11541,6543,4998,0.567,0.433
7060,23075,9819,9135,684,0.93,0.07
7061,23076,606,0,606,0.0,1.0
7062,23079,437,0,437,0.0,1.0
7063,23083,1732,0,1732,0.0,1.0
7064,23084,1799,0,1799,0.0,1.0
7065,23085,364,0,364,0.0,1.0
7066,23086,3247,0,3247,0.0,1.0
7067,23089,4914,0,4914,0.0,1.0
7068,23091,309,0,309,0.0,1.0
7069,23092,584,0,584,0.0,1.0
7070,23093,12694,0,12694,0.0,1.0
7071,23102,2659,0,2659,0.0,1.0
7072,23103,4634,0,4634,0.0,1.0
7073,23106,976,0,976,0.0,1.0
7074,23108,161,0,161,0.0,1.0
7075,23109,1821,0,1821,0.0,1.0
7076,23110,794,0,794,0.0,1.0
7077,23111,36490,28891,7599,0.792,0.208
7078,23112,46982,45924,1058,0.977,0.023
7079,23113,23848,22688,1160,0.951,0.049
7080,23114,17449,17164,285,0.984,0.016
7081,23115,146,0,146,0.0,1.0
7082,23116,27228,21529,5699,0.791,0.209
7083,23117,9141,0,9141,0.0,1.0
7084,23119,295,0,295,0.0,1.0
7085,23120,5971,2346,3625,0.393,0.607
7086,23123,1860,0,1860,0.0,1.0
7087,23124,3185,0,3185,0.0,1.0
7088,23125,223,0,223,0.0,1.0
7089,23126,534,0,534,0.0,1.0
7090,23128,1045,0,1045,0.0,1.0
7091,23129,374,0,374,0.0,1.0
7092,23130,268,0,268,0.0,1.0
7093,23138,953,0,953,0.0,1.0
7094,23139,24425,0,24425,0.0,1.0
7095,23140,5175,0,5175,0.0,1.0
7096,23141,6471,0,6471,0.0,1.0
7097,23146,3093,0,3093,0.0,1.0
7098,23148,1827,0,1827,0.0,1.0
7099,23149,3190,0,3190,0.0,1.0
7100,23150,12045,8115,3930,0.674,0.326
7101,23153,1334,0,1334,0.0,1.0
7102,23156,1555,0,1555,0.0,1.0
7103,23160,2708,0,2708,0.0,1.0
7104,23161,173,0,173,0.0,1.0
7105,23163,220,0,220,0.0,1.0
7106,23168,6115,2681,3434,0.438,0.562
7107,23169,1325,0,1325,0.0,1.0
7108,23173,2820,2820,0,1.0,0.0
7109,23175,1907,0,1907,0.0,1.0
7110,23176,656,0,656,0.0,1.0
7111,23177,616,0,616,0.0,1.0
7112,23180,441,0,441,0.0,1.0
7113,23181,5426,2675,2751,0.493,0.507
7114,23185,46370,44203,2167,0.953,0.047
7115,23187,267,267,0,1.0,0.0
7116,23188,38733,32344,6389,0.835,0.165
7117,23192,7067,0,7067,0.0,1.0
7118,23219,3781,3781,0,1.0,0.0
7119,23220,35545,35545,0,1.0,0.0
7120,23221,13680,13680,0,1.0,0.0
7121,23222,24563,24563,0,1.0,0.0
7122,23223,47677,46244,1433,0.97,0.03
7123,23224,33461,33461,0,1.0,0.0
7124,23225,39169,39169,0,1.0,0.0
7125,23226,15805,15793,12,0.999,0.001
7126,23227,24440,24440,0,1.0,0.0
7127,23228,34198,34198,0,1.0,0.0
7128,23229,32283,32230,53,0.998,0.002
7129,23230,5852,5852,0,1.0,0.0
7130,23231,34685,27534,7151,0.794,0.206
7131,23233,28908,28597,311,0.989,0.011
7132,23234,42989,42989,0,1.0,0.0
7133,23235,30165,30165,0,1.0,0.0
7134,23236,25822,25822,0,1.0,0.0
7135,23237,21192,21120,72,0.997,0.003
7136,23238,25134,23817,1317,0.948,0.052
7137,23250,0,0,0,,
7138,23294,17558,17558,0,1.0,0.0
7139,23301,1831,0,1831,0.0,1.0
7140,23302,155,0,155,0.0,1.0
7141,23303,741,0,741,0.0,1.0
7142,23304,71,71,0,1.0,0.0
7143,23306,1088,0,1088,0.0,1.0
7144,23307,769,0,769,0.0,1.0
7145,23308,2106,0,2106,0.0,1.0
7146,23310,4736,0,4736,0.0,1.0
7147,23313,78,0,78,0.0,1.0
7148,23314,6991,4894,2097,0.7,0.3
7149,23315,1525,0,1525,0.0,1.0
7150,23316,342,0,342,0.0,1.0
7151,23320,51797,51198,599,0.988,0.012
7152,23321,33653,32460,1193,0.965,0.035
7153,23322,60473,46987,13486,0.777,0.223
7154,23323,35906,34236,1670,0.953,0.047
7155,23324,22851,22851,0,1.0,0.0
7156,23325,17592,17592,0,1.0,0.0
7157,23336,2941,0,2941,0.0,1.0
7158,23337,377,0,377,0.0,1.0
7159,23347,671,0,671,0.0,1.0
7160,23350,3403,0,3403,0.0,1.0
7161,23354,207,0,207,0.0,1.0
7162,23356,1246,0,1246,0.0,1.0
7163,23357,776,0,776,0.0,1.0
7164,23358,152,0,152,0.0,1.0
7165,23359,776,0,776,0.0,1.0
7166,23389,137,0,137,0.0,1.0
7167,23395,645,0,645,0.0,1.0
7168,23398,153,0,153,0.0,1.0
7169,23401,212,0,212,0.0,1.0
7170,23405,973,0,973,0.0,1.0
7171,23407,411,0,411,0.0,1.0
7172,23408,77,0,77,0.0,1.0
7173,23409,84,0,84,0.0,1.0
7174,23410,2015,0,2015,0.0,1.0
7175,23413,840,0,840,0.0,1.0
7176,23414,100,0,100,0.0,1.0
7177,23415,1893,0,1893,0.0,1.0
7178,23416,356,0,356,0.0,1.0
7179,23417,4047,0,4047,0.0,1.0
7180,23418,863,0,863,0.0,1.0
7181,23420,2376,0,2376,0.0,1.0
7182,23421,4255,0,4255,0.0,1.0
7183,23422,278,0,278,0.0,1.0
7184,23423,344,0,344,0.0,1.0
7185,23426,225,0,225,0.0,1.0
7186,23427,243,0,243,0.0,1.0
7187,23430,17281,9537,7744,0.552,0.448
7188,23432,1538,0,1538,0.0,1.0
7189,23433,1218,1218,0,1.0,0.0
7190,23434,47670,38461,9209,0.807,0.193
7191,23435,27053,25671,1382,0.949,0.051
7192,23436,942,874,68,0.928,0.072
7193,23437,4283,0,4283,0.0,1.0
7194,23438,1818,0,1818,0.0,1.0
7195,23440,727,0,727,0.0,1.0
7196,23441,171,0,171,0.0,1.0
7197,23442,1059,0,1059,0.0,1.0
7198,23451,41544,41501,43,0.999,0.001
7199,23452,59321,59321,0,1.0,0.0
7200,23453,35960,35960,0,1.0,0.0
7201,23454,60283,60277,6,1.0,0.0
7202,23455,47938,47938,0,1.0,0.0
7203,23456,51748,49365,2383,0.954,0.046
7204,23457,4289,0,4289,0.0,1.0
7205,23459,1091,1091,0,1.0,0.0
7206,23460,1201,1201,0,1.0,0.0
7207,23461,287,287,0,1.0,0.0
7208,23462,61973,61973,0,1.0,0.0
7209,23464,72359,72359,0,1.0,0.0
7210,23480,328,0,328,0.0,1.0
7211,23486,140,0,140,0.0,1.0
7212,23487,6298,0,6298,0.0,1.0
7213,23488,201,0,201,0.0,1.0
7214,23502,20678,20678,0,1.0,0.0
7215,23503,30856,30856,0,1.0,0.0
7216,23504,23483,23483,0,1.0,0.0
7217,23505,28503,28503,0,1.0,0.0
7218,23507,25818,25818,0,1.0,0.0
7219,23508,20263,20263,0,1.0,0.0
7220,23509,12817,12817,0,1.0,0.0
7221,23510,7031,7031,0,1.0,0.0
7222,23511,2457,2457,0,1.0,0.0
7223,23513,29595,29595,0,1.0,0.0
7224,23517,4484,4484,0,1.0,0.0
7225,23518,28095,28095,0,1.0,0.0
7226,23523,7793,7793,0,1.0,0.0
7227,23551,930,930,0,1.0,0.0
7228,23601,25127,25127,0,1.0,0.0
7229,23602,39676,39676,0,1.0,0.0
7230,23603,3899,3861,38,0.99,0.01
7231,23604,5720,5707,13,0.998,0.002
7232,23605,13854,13854,0,1.0,0.0
7233,23606,29283,29283,0,1.0,0.0
7234,23607,24519,24519,0,1.0,0.0
7235,23608,42917,42917,0,1.0,0.0
7236,23651,696,696,0,1.0,0.0
7237,23661,14113,14113,0,1.0,0.0
7238,23662,12150,11360,790,0.935,0.065
7239,23663,14495,14495,0,1.0,0.0
7240,23664,10194,9915,279,0.973,0.027
7241,23665,5120,5120,0,1.0,0.0
7242,23666,49825,49825,0,1.0,0.0
7243,23669,43148,43085,63,0.999,0.001
7244,23690,3032,2773,259,0.915,0.085
7245,23691,127,0,127,0.0,1.0
7246,23692,18846,18677,169,0.991,0.009
7247,23693,23292,23249,43,0.998,0.002
7248,23696,3669,3301,368,0.9,0.1
7249,23701,25161,25161,0,1.0,0.0
7250,23702,11424,11424,0,1.0,0.0
7251,23703,25739,25739,0,1.0,0.0
7252,23704,18716,18716,0,1.0,0.0
7253,23707,14236,14236,0,1.0,0.0
7254,23708,181,181,0,1.0,0.0
7255,23709,78,78,0,1.0,0.0
7256,23801,3393,3233,160,0.953,0.047
7257,23803,40542,34809,5733,0.859,0.141
7258,23805,19490,13234,6256,0.679,0.321
7259,23806,2251,2251,0,1.0,0.0
7260,23821,1597,0,1597,0.0,1.0
7261,23824,7214,3232,3982,0.448,0.552
7262,23827,1443,0,1443,0.0,1.0
7263,23828,395,0,395,0.0,1.0
7264,23829,2622,0,2622,0.0,1.0
7265,23830,1491,0,1491,0.0,1.0
7266,23831,33079,32444,635,0.981,0.019
7267,23832,33739,32396,1343,0.96,0.04
7268,23833,2297,0,2297,0.0,1.0
7269,23834,25612,25289,323,0.987,0.013
7270,23836,11444,10753,691,0.94,0.06
7271,23837,4298,58,4240,0.013,0.987
7272,23838,15341,7306,8035,0.476,0.524
7273,23839,741,0,741,0.0,1.0
7274,23840,1858,0,1858,0.0,1.0
7275,23841,3479,0,3479,0.0,1.0
7276,23842,6906,491,6415,0.071,0.929
7277,23843,654,0,654,0.0,1.0
7278,23844,788,0,788,0.0,1.0
7279,23845,356,0,356,0.0,1.0
7280,23846,933,0,933,0.0,1.0
7281,23847,16962,7143,9819,0.421,0.579
7282,23850,1051,0,1051,0.0,1.0
7283,23851,13715,9151,4564,0.667,0.333
7284,23856,1033,0,1033,0.0,1.0
7285,23857,525,0,525,0.0,1.0
7286,23860,31970,28307,3663,0.885,0.115
7287,23866,2237,0,2237,0.0,1.0
7288,23867,2189,0,2189,0.0,1.0
7289,23868,7367,4032,3335,0.547,0.453
7290,23872,2376,0,2376,0.0,1.0
7291,23874,1004,0,1004,0.0,1.0
7292,23875,10878,6451,4427,0.593,0.407
7293,23876,456,0,456,0.0,1.0
7294,23878,1118,0,1118,0.0,1.0
7295,23879,679,0,679,0.0,1.0
7296,23881,2176,0,2176,0.0,1.0
7297,23882,2516,0,2516,0.0,1.0
7298,23883,2551,0,2551,0.0,1.0
7299,23884,93,0,93,0.0,1.0
7300,23885,2807,0,2807,0.0,1.0
7301,23887,574,0,574,0.0,1.0
7302,23888,2275,0,2275,0.0,1.0
7303,23889,581,0,581,0.0,1.0
7304,23890,4249,0,4249,0.0,1.0
7305,23891,2358,0,2358,0.0,1.0
7306,23893,454,0,454,0.0,1.0
7307,23894,673,0,673,0.0,1.0
7308,23897,595,0,595,0.0,1.0
7309,23898,2223,0,2223,0.0,1.0
7310,23899,351,0,351,0.0,1.0
7311,23901,16399,6972,9427,0.425,0.575
7312,23909,2027,2027,0,1.0,0.0
7313,23915,1220,0,1220,0.0,1.0
7314,23917,3684,0,3684,0.0,1.0
7315,23919,2666,0,2666,0.0,1.0
7316,23920,3489,251,3238,0.072,0.928
7317,23921,1991,0,1991,0.0,1.0
7318,23922,3785,2041,1744,0.539,0.461
7319,23923,2592,0,2592,0.0,1.0
7320,23924,6232,2666,3566,0.428,0.572
7321,23927,4381,0,4381,0.0,1.0
7322,23930,5690,2282,3408,0.401,0.599
7323,23934,681,0,681,0.0,1.0
7324,23936,8212,0,8212,0.0,1.0
7325,23937,1970,0,1970,0.0,1.0
7326,23938,407,0,407,0.0,1.0
7327,23942,1112,0,1112,0.0,1.0
7328,23943,225,0,225,0.0,1.0
7329,23944,4261,0,4261,0.0,1.0
7330,23947,4293,0,4293,0.0,1.0
7331,23950,3348,593,2755,0.177,0.823
7332,23952,217,0,217,0.0,1.0
7333,23954,2017,0,2017,0.0,1.0
7334,23958,3170,0,3170,0.0,1.0
7335,23959,1264,0,1264,0.0,1.0
7336,23960,1990,0,1990,0.0,1.0
7337,23962,670,0,670,0.0,1.0
7338,23963,587,0,587,0.0,1.0
7339,23964,1138,0,1138,0.0,1.0
7340,23966,2337,0,2337,0.0,1.0
7341,23967,1118,0,1118,0.0,1.0
7342,23968,837,0,837,0.0,1.0
7343,23970,8254,3990,4264,0.483,0.517
7344,23974,5012,0,5012,0.0,1.0
7345,23976,230,0,230,0.0,1.0
7346,24011,219,219,0,1.0,0.0
7347,24012,29015,28300,715,0.975,0.025
7348,24013,8684,8684,0,1.0,0.0
7349,24014,16570,13694,2876,0.826,0.174
7350,24015,15255,15255,0,1.0,0.0
7351,24016,9047,9047,0,1.0,0.0
7352,24017,23392,23392,0,1.0,0.0
7353,24018,36432,31579,4853,0.867,0.133
7354,24019,26502,25787,715,0.973,0.027
7355,24020,455,455,0,1.0,0.0
7356,24053,2715,0,2715,0.0,1.0
7357,24054,6797,325,6472,0.048,0.952
7358,24055,13674,4067,9607,0.297,0.703
7359,24058,324,0,324,0.0,1.0
7360,24059,872,0,872,0.0,1.0
7361,24060,53311,45813,7498,0.859,0.141
7362,24064,4963,2118,2845,0.427,0.573
7363,24065,6141,10,6131,0.002,0.998
7364,24066,4883,0,4883,0.0,1.0
7365,24067,2230,0,2230,0.0,1.0
7366,24069,1879,0,1879,0.0,1.0
7367,24070,1363,0,1363,0.0,1.0
7368,24072,1298,0,1298,0.0,1.0
7369,24073,29793,24223,5570,0.813,0.187
7370,24076,972,0,972,0.0,1.0
7371,24077,932,890,42,0.955,0.045
7372,24078,7115,6890,225,0.968,0.032
7373,24079,1766,0,1766,0.0,1.0
7374,24082,419,0,419,0.0,1.0
7375,24083,2587,1997,590,0.772,0.228
7376,24084,11304,6394,4910,0.566,0.434
7377,24085,2182,44,2138,0.02,0.98
7378,24086,210,0,210,0.0,1.0
7379,24087,3914,717,3197,0.183,0.817
7380,24088,5408,0,5408,0.0,1.0
7381,24089,2640,845,1795,0.32,0.68
7382,24090,4781,0,4781,0.0,1.0
7383,24091,7215,0,7215,0.0,1.0
7384,24092,3063,0,3063,0.0,1.0
7385,24093,192,0,192,0.0,1.0
7386,24095,4677,0,4677,0.0,1.0
7387,24101,6132,0,6132,0.0,1.0
7388,24102,1697,0,1697,0.0,1.0
7389,24104,3469,0,3469,0.0,1.0
7390,24105,500,0,500,0.0,1.0
7391,24112,32646,20505,12141,0.628,0.372
7392,24120,1860,0,1860,0.0,1.0
7393,24121,10501,0,10501,0.0,1.0
7394,24122,1683,0,1683,0.0,1.0
7395,24124,4352,2096,2256,0.482,0.518
7396,24127,4261,0,4261,0.0,1.0
7397,24128,1872,0,1872,0.0,1.0
7398,24130,8,0,8,0.0,1.0
7399,24131,140,0,140,0.0,1.0
7400,24132,460,0,460,0.0,1.0
7401,24133,2626,0,2626,0.0,1.0
7402,24134,5741,2698,3043,0.47,0.53
7403,24136,3393,0,3393,0.0,1.0
7404,24137,2582,0,2582,0.0,1.0
7405,24138,1613,0,1613,0.0,1.0
7406,24139,575,0,575,0.0,1.0
7407,24141,20668,16018,4650,0.775,0.225
7408,24142,2470,2470,0,1.0,0.0
7409,24147,1201,848,353,0.706,0.294
7410,24148,8013,2336,5677,0.292,0.708
7411,24149,3339,0,3339,0.0,1.0
7412,24150,693,186,507,0.268,0.732
7413,24151,20000,5844,14156,0.292,0.708
7414,24153,37761,32682,5079,0.865,0.135
7415,24161,471,0,471,0.0,1.0
7416,24162,2421,22,2399,0.009,0.991
7417,24165,1613,0,1613,0.0,1.0
7418,24167,345,0,345,0.0,1.0
7419,24168,187,123,64,0.658,0.342
7420,24171,8250,0,8250,0.0,1.0
7421,24174,2539,135,2404,0.053,0.947
7422,24175,8818,2571,6247,0.292,0.708
7423,24176,1360,0,1360,0.0,1.0
7424,24179,18616,12724,5892,0.683,0.317
7425,24184,4705,194,4511,0.041,0.959
7426,24185,854,0,854,0.0,1.0
7427,24201,17116,17116,0,1.0,0.0
7428,24202,12905,4454,8451,0.345,0.655
7429,24210,16840,9850,6990,0.585,0.415
7430,24211,9922,1951,7971,0.197,0.803
7431,24216,2939,1363,1576,0.464,0.536
7432,24217,406,0,406,0.0,1.0
7433,24219,11265,6422,4843,0.57,0.43
7434,24220,895,0,895,0.0,1.0
7435,24221,938,0,938,0.0,1.0
7436,24224,6734,0,6734,0.0,1.0
7437,24225,1697,0,1697,0.0,1.0
7438,24226,1433,0,1433,0.0,1.0
7439,24228,7016,0,7016,0.0,1.0
7440,24230,9597,3280,6317,0.342,0.658
7441,24236,3085,0,3085,0.0,1.0
7442,24237,1192,0,1192,0.0,1.0
7443,24239,113,0,113,0.0,1.0
7444,24243,2222,0,2222,0.0,1.0
7445,24244,5723,0,5723,0.0,1.0
7446,24245,1129,0,1129,0.0,1.0
7447,24246,455,455,0,1.0,0.0
7448,24248,2596,0,2596,0.0,1.0
7449,24250,1319,0,1319,0.0,1.0
7450,24251,8773,2559,6214,0.292,0.708
7451,24256,3491,0,3491,0.0,1.0
7452,24258,1624,0,1624,0.0,1.0
7453,24260,5734,0,5734,0.0,1.0
7454,24263,7950,0,7950,0.0,1.0
7455,24265,930,0,930,0.0,1.0
7456,24266,9521,3375,6146,0.354,0.646
7457,24269,324,0,324,0.0,1.0
7458,24270,582,0,582,0.0,1.0
7459,24271,2689,0,2689,0.0,1.0
7460,24272,527,0,527,0.0,1.0
7461,24273,6262,4666,1596,0.745,0.255
7462,24277,5849,0,5849,0.0,1.0
7463,24279,5541,0,5541,0.0,1.0
7464,24280,823,0,823,0.0,1.0
7465,24281,2487,0,2487,0.0,1.0
7466,24282,727,0,727,0.0,1.0
7467,24283,2171,0,2171,0.0,1.0
7468,24290,1874,1584,290,0.845,0.155
7469,24292,535,0,535,0.0,1.0
7470,24293,10791,5743,5048,0.532,0.468
7471,24301,14366,9668,4698,0.673,0.327
7472,24311,1977,782,1195,0.396,0.604
7473,24312,2401,0,2401,0.0,1.0
7474,24313,884,0,884,0.0,1.0
7475,24314,1560,0,1560,0.0,1.0
7476,24315,3774,0,3774,0.0,1.0
7477,24316,50,0,50,0.0,1.0
7478,24317,3858,38,3820,0.01,0.99
7479,24318,639,0,639,0.0,1.0
7480,24319,6979,0,6979,0.0,1.0
7481,24322,174,0,174,0.0,1.0
7482,24323,644,0,644,0.0,1.0
7483,24324,2013,0,2013,0.0,1.0
7484,24325,1039,0,1039,0.0,1.0
7485,24326,1058,0,1058,0.0,1.0
7486,24328,1726,0,1726,0.0,1.0
7487,24330,3401,0,3401,0.0,1.0
7488,24333,17996,6806,11190,0.378,0.622
7489,24340,5657,0,5657,0.0,1.0
7490,24343,9267,0,9267,0.0,1.0
7491,24347,1931,0,1931,0.0,1.0
7492,24348,3958,0,3958,0.0,1.0
7493,24350,1261,0,1261,0.0,1.0
7494,24351,668,0,668,0.0,1.0
7495,24352,890,0,890,0.0,1.0
7496,24354,15315,7178,8137,0.469,0.531
7497,24360,6169,0,6169,0.0,1.0
7498,24361,5431,0,5431,0.0,1.0
7499,24363,1365,0,1365,0.0,1.0
7500,24366,781,0,781,0.0,1.0
7501,24368,4953,0,4953,0.0,1.0
7502,24370,6572,0,6572,0.0,1.0
7503,24374,787,0,787,0.0,1.0
7504,24375,1611,0,1611,0.0,1.0
7505,24377,348,0,348,0.0,1.0
7506,24378,1229,0,1229,0.0,1.0
7507,24380,2639,0,2639,0.0,1.0
7508,24381,3816,109,3707,0.029,0.971
7509,24382,14366,7212,7154,0.502,0.498
7510,24401,35499,26462,9037,0.745,0.255
7511,24411,112,0,112,0.0,1.0
7512,24412,131,0,131,0.0,1.0
7513,24413,178,0,178,0.0,1.0
7514,24415,41,0,41,0.0,1.0
7515,24416,8807,6487,2320,0.737,0.263
7516,24421,3868,0,3868,0.0,1.0
7517,24422,6315,4410,1905,0.698,0.302
7518,24426,14329,8430,5899,0.588,0.412
7519,24430,2643,0,2643,0.0,1.0
7520,24431,2656,0,2656,0.0,1.0
7521,24432,336,0,336,0.0,1.0
7522,24433,99,0,99,0.0,1.0
7523,24435,1925,0,1925,0.0,1.0
7524,24437,904,0,904,0.0,1.0
7525,24439,1253,0,1253,0.0,1.0
7526,24440,2916,0,2916,0.0,1.0
7527,24441,6140,3959,2181,0.645,0.355
7528,24442,120,0,120,0.0,1.0
7529,24445,2673,0,2673,0.0,1.0
7530,24448,376,350,26,0.931,0.069
7531,24450,16741,8811,7930,0.526,0.474
7532,24457,270,0,270,0.0,1.0
7533,24458,442,0,442,0.0,1.0
7534,24459,818,0,818,0.0,1.0
7535,24460,1530,0,1530,0.0,1.0
7536,24464,213,0,213,0.0,1.0
7537,24465,1382,0,1382,0.0,1.0
7538,24467,2212,534,1678,0.241,0.759
7539,24471,1355,116,1239,0.086,0.914
7540,24472,2271,0,2271,0.0,1.0
7541,24473,922,0,922,0.0,1.0
7542,24474,544,507,37,0.932,0.068
7543,24476,280,0,280,0.0,1.0
7544,24477,10573,6623,3950,0.626,0.374
7545,24479,1537,0,1537,0.0,1.0
7546,24482,4872,3407,1465,0.699,0.301
7547,24483,587,0,587,0.0,1.0
7548,24484,741,0,741,0.0,1.0
7549,24485,389,0,389,0.0,1.0
7550,24486,3490,1988,1502,0.57,0.43
7551,24487,320,0,320,0.0,1.0
7552,24501,26757,24160,2597,0.903,0.097
7553,24502,43426,42902,524,0.988,0.012
7554,24503,19331,14353,4978,0.742,0.258
7555,24504,9777,6603,3174,0.675,0.325
7556,24517,5693,3544,2149,0.623,0.377
7557,24520,2450,0,2450,0.0,1.0
7558,24521,10576,346,10230,0.033,0.967
7559,24522,9213,0,9213,0.0,1.0
7560,24523,18952,6694,12258,0.353,0.647
7561,24526,1593,0,1593,0.0,1.0
7562,24527,3027,700,2327,0.231,0.769
7563,24528,3200,0,3200,0.0,1.0
7564,24529,1724,0,1724,0.0,1.0
7565,24530,1088,0,1088,0.0,1.0
7566,24531,9203,0,9203,0.0,1.0
7567,24534,1740,0,1740,0.0,1.0
7568,24536,194,0,194,0.0,1.0
7569,24538,4742,0,4742,0.0,1.0
7570,24539,134,0,134,0.0,1.0
7571,24540,32170,25777,6393,0.801,0.199
7572,24541,28221,22578,5643,0.8,0.2
7573,24549,4292,0,4292,0.0,1.0
7574,24550,7258,1600,5658,0.22,0.78
7575,24551,20667,14900,5767,0.721,0.279
7576,24553,1902,0,1902,0.0,1.0
7577,24554,3995,0,3995,0.0,1.0
7578,24555,2140,0,2140,0.0,1.0
7579,24556,3053,0,3053,0.0,1.0
7580,24557,7977,0,7977,0.0,1.0
7581,24558,6347,577,5770,0.091,0.909
7582,24562,426,0,426,0.0,1.0
7583,24563,5489,1084,4405,0.197,0.803
7584,24565,1026,0,1026,0.0,1.0
7585,24566,1402,0,1402,0.0,1.0
7586,24569,1064,0,1064,0.0,1.0
7587,24570,20,0,20,0.0,1.0
7588,24571,1979,35,1944,0.018,0.982
7589,24572,16395,9890,6505,0.603,0.397
7590,24574,3977,935,3042,0.235,0.765
7591,24577,5239,0,5239,0.0,1.0
7592,24578,1056,0,1056,0.0,1.0
7593,24579,1389,0,1389,0.0,1.0
7594,24580,613,0,613,0.0,1.0
7595,24581,23,0,23,0.0,1.0
7596,24586,5562,98,5464,0.018,0.982
7597,24588,9647,362,9285,0.038,0.962
7598,24589,2271,0,2271,0.0,1.0
7599,24590,8074,0,8074,0.0,1.0
7600,24592,13934,7729,6205,0.555,0.445
7601,24593,1963,0,1963,0.0,1.0
7602,24594,1651,0,1651,0.0,1.0
7603,24595,679,585,94,0.862,0.138
7604,24597,1257,0,1257,0.0,1.0
7605,24598,1984,0,1984,0.0,1.0
7606,24599,606,0,606,0.0,1.0
7607,24601,77,0,77,0.0,1.0
7608,24602,962,0,962,0.0,1.0
7609,24603,978,0,978,0.0,1.0
7610,24604,342,0,342,0.0,1.0
7611,24605,9301,6492,2809,0.698,0.302
7612,24606,170,0,170,0.0,1.0
7613,24607,462,0,462,0.0,1.0
7614,24609,7630,1533,6097,0.201,0.799
7615,24612,229,172,57,0.751,0.249
7616,24613,911,178,733,0.195,0.805
7617,24614,8061,0,8061,0.0,1.0
7618,24620,2774,0,2774,0.0,1.0
7619,24622,1028,0,1028,0.0,1.0
7620,24628,295,0,295,0.0,1.0
7621,24630,6774,2788,3986,0.412,0.588
7622,24631,2843,0,2843,0.0,1.0
7623,24634,574,0,574,0.0,1.0
7624,24635,1650,0,1650,0.0,1.0
7625,24637,3410,1034,2376,0.303,0.697
7626,24639,3533,1209,2324,0.342,0.658
7627,24641,5953,5618,335,0.944,0.056
7628,24646,750,0,750,0.0,1.0
7629,24649,2760,22,2738,0.008,0.992
7630,24651,6314,2681,3633,0.425,0.575
7631,24656,3404,0,3404,0.0,1.0
7632,24657,321,0,321,0.0,1.0
7633,24701,20786,14994,5792,0.721,0.279
7634,24712,2063,1350,713,0.654,0.346
7635,24714,257,0,257,0.0,1.0
7636,24715,594,0,594,0.0,1.0
7637,24716,508,0,508,0.0,1.0
7638,24719,223,0,223,0.0,1.0
7639,24724,66,0,66,0.0,1.0
7640,24726,566,0,566,0.0,1.0
7641,24729,149,0,149,0.0,1.0
7642,24731,255,0,255,0.0,1.0
7643,24733,853,0,853,0.0,1.0
7644,24736,902,0,902,0.0,1.0
7645,24737,243,0,243,0.0,1.0
7646,24738,308,96,212,0.312,0.688
7647,24740,30435,20463,9972,0.672,0.328
7648,24747,3006,0,3006,0.0,1.0
7649,24801,3858,2449,1409,0.635,0.365
7650,24808,675,0,675,0.0,1.0
7651,24811,599,0,599,0.0,1.0
7652,24813,511,0,511,0.0,1.0
7653,24815,559,0,559,0.0,1.0
7654,24816,151,0,151,0.0,1.0
7655,24817,954,0,954,0.0,1.0
7656,24818,1409,0,1409,0.0,1.0
7657,24822,955,113,842,0.118,0.882
7658,24823,383,0,383,0.0,1.0
7659,24826,150,0,150,0.0,1.0
7660,24827,1501,0,1501,0.0,1.0
7661,24828,927,0,927,0.0,1.0
7662,24830,139,0,139,0.0,1.0
7663,24831,250,0,250,0.0,1.0
7664,24834,412,0,412,0.0,1.0
7665,24836,800,576,224,0.72,0.28
7666,24839,1523,0,1523,0.0,1.0
7667,24843,158,0,158,0.0,1.0
7668,24844,1810,0,1810,0.0,1.0
7669,24845,282,0,282,0.0,1.0
7670,24846,244,0,244,0.0,1.0
7671,24847,293,0,293,0.0,1.0
7672,24848,262,0,262,0.0,1.0
7673,24849,337,0,337,0.0,1.0
7674,24850,1093,0,1093,0.0,1.0
7675,24851,419,0,419,0.0,1.0
7676,24853,793,37,756,0.047,0.953
7677,24854,550,0,550,0.0,1.0
7678,24857,984,682,302,0.693,0.307
7679,24860,552,167,385,0.303,0.697
7680,24861,307,0,307,0.0,1.0
7681,24862,651,0,651,0.0,1.0
7682,24866,240,0,240,0.0,1.0
7683,24867,409,0,409,0.0,1.0
7684,24868,1686,0,1686,0.0,1.0
7685,24869,351,0,351,0.0,1.0
7686,24870,2874,1683,1191,0.586,0.414
7687,24871,309,0,309,0.0,1.0
7688,24872,783,0,783,0.0,1.0
7689,24873,600,0,600,0.0,1.0
7690,24874,2729,0,2729,0.0,1.0
7691,24878,337,36,301,0.107,0.893
7692,24879,657,0,657,0.0,1.0
7693,24880,356,0,356,0.0,1.0
7694,24881,601,0,601,0.0,1.0
7695,24882,483,0,483,0.0,1.0
7696,24884,265,0,265,0.0,1.0
7697,24887,67,0,67,0.0,1.0
7698,24888,167,0,167,0.0,1.0
7699,24892,1513,0,1513,0.0,1.0
7700,24894,388,0,388,0.0,1.0
7701,24898,198,0,198,0.0,1.0
7702,24901,9128,5078,4050,0.556,0.444
7703,24910,5383,2632,2751,0.489,0.511
7704,24915,590,0,590,0.0,1.0
7705,24916,558,0,558,0.0,1.0
7706,24918,1677,0,1677,0.0,1.0
7707,24920,346,0,346,0.0,1.0
7708,24924,512,0,512,0.0,1.0
7709,24925,935,0,935,0.0,1.0
7710,24927,365,0,365,0.0,1.0
7711,24931,1544,0,1544,0.0,1.0
7712,24934,503,0,503,0.0,1.0
7713,24935,688,0,688,0.0,1.0
7714,24938,1518,0,1518,0.0,1.0
7715,24941,1059,0,1059,0.0,1.0
7716,24944,401,0,401,0.0,1.0
7717,24945,393,0,393,0.0,1.0
7718,24946,1533,0,1533,0.0,1.0
7719,24951,1489,0,1489,0.0,1.0
7720,24954,3514,0,3514,0.0,1.0
7721,24957,346,0,346,0.0,1.0
7722,24962,186,0,186,0.0,1.0
7723,24963,4095,1285,2810,0.314,0.686
7724,24966,1286,0,1286,0.0,1.0
7725,24970,4575,1881,2694,0.411,0.589
7726,24974,299,0,299,0.0,1.0
7727,24976,1005,0,1005,0.0,1.0
7728,24977,441,0,441,0.0,1.0
7729,24981,631,0,631,0.0,1.0
7730,24983,2443,0,2443,0.0,1.0
7731,24984,185,0,185,0.0,1.0
7732,24986,5216,2674,2542,0.513,0.487
7733,24991,521,0,521,0.0,1.0
7734,25002,112,55,57,0.491,0.509
7735,25003,2782,0,2782,0.0,1.0
7736,25005,264,0,264,0.0,1.0
7737,25007,604,0,604,0.0,1.0
7738,25008,210,0,210,0.0,1.0
7739,25009,1153,0,1153,0.0,1.0
7740,25011,800,766,34,0.958,0.042
7741,25015,4691,3266,1425,0.696,0.304
7742,25019,575,0,575,0.0,1.0
7743,25021,305,0,305,0.0,1.0
7744,25022,153,0,153,0.0,1.0
7745,25024,586,0,586,0.0,1.0
7746,25025,230,0,230,0.0,1.0
7747,25028,381,0,381,0.0,1.0
7748,25030,414,0,414,0.0,1.0
7749,25031,615,554,61,0.901,0.099
7750,25033,2234,55,2179,0.025,0.975
7751,25035,1112,863,249,0.776,0.224
7752,25036,468,73,395,0.156,0.844
7753,25039,1304,824,480,0.632,0.368
7754,25040,546,546,0,1.0,0.0
7755,25043,1659,0,1659,0.0,1.0
7756,25044,384,0,384,0.0,1.0
7757,25045,5801,1473,4328,0.254,0.746
7758,25047,411,0,411,0.0,1.0
7759,25048,38,0,38,0.0,1.0
7760,25049,630,0,630,0.0,1.0
7761,25051,164,0,164,0.0,1.0
7762,25053,4296,1552,2744,0.361,0.639
7763,25054,426,343,83,0.805,0.195
7764,25057,337,0,337,0.0,1.0
7765,25059,678,0,678,0.0,1.0
7766,25060,618,0,618,0.0,1.0
7767,25061,756,401,355,0.53,0.47
7768,25062,230,0,230,0.0,1.0
7769,25063,1797,0,1797,0.0,1.0
7770,25064,9962,9649,313,0.969,0.031
7771,25067,1120,938,182,0.838,0.162
7772,25070,1683,1322,361,0.786,0.214
7773,25071,11697,5464,6233,0.467,0.533
7774,25075,976,191,785,0.196,0.804
7775,25076,298,89,209,0.299,0.701
7776,25081,1251,0,1251,0.0,1.0
7777,25082,1673,0,1673,0.0,1.0
7778,25083,672,0,672,0.0,1.0
7779,25085,830,0,830,0.0,1.0
7780,25086,928,841,87,0.906,0.094
7781,25088,164,0,164,0.0,1.0
7782,25090,203,168,35,0.828,0.172
7783,25093,207,0,207,0.0,1.0
7784,25102,349,244,105,0.699,0.301
7785,25103,366,31,335,0.085,0.915
7786,25106,642,252,390,0.393,0.607
7787,25107,739,103,636,0.139,0.861
7788,25108,692,0,692,0.0,1.0
7789,25109,661,631,30,0.955,0.045
7790,25110,599,5,594,0.008,0.992
7791,25111,694,0,694,0.0,1.0
7792,25112,166,166,0,1.0,0.0
7793,25113,957,0,957,0.0,1.0
7794,25114,557,0,557,0.0,1.0
7795,25115,90,56,34,0.622,0.378
7796,25118,998,0,998,0.0,1.0
7797,25119,444,0,444,0.0,1.0
7798,25121,972,0,972,0.0,1.0
7799,25123,3535,0,3535,0.0,1.0
7800,25124,1214,0,1214,0.0,1.0
7801,25125,1011,0,1011,0.0,1.0
7802,25126,58,0,58,0.0,1.0
7803,25130,3846,2850,996,0.741,0.259
7804,25132,276,0,276,0.0,1.0
7805,25133,922,0,922,0.0,1.0
7806,25134,423,231,192,0.546,0.454
7807,25136,1798,1623,175,0.903,0.097
7808,25139,440,0,440,0.0,1.0
7809,25140,1012,0,1012,0.0,1.0
7810,25141,195,0,195,0.0,1.0
7811,25142,416,0,416,0.0,1.0
7812,25143,8579,8355,224,0.974,0.026
7813,25148,332,0,332,0.0,1.0
7814,25149,242,0,242,0.0,1.0
7815,25152,368,0,368,0.0,1.0
7816,25154,868,0,868,0.0,1.0
7817,25156,105,0,105,0.0,1.0
7818,25159,5163,3672,1491,0.711,0.289
7819,25160,303,0,303,0.0,1.0
7820,25161,369,0,369,0.0,1.0
7821,25162,571,544,27,0.953,0.047
7822,25164,1257,0,1257,0.0,1.0
7823,25165,612,0,612,0.0,1.0
7824,25168,2503,699,1804,0.279,0.721
7825,25169,516,0,516,0.0,1.0
7826,25173,452,0,452,0.0,1.0
7827,25174,420,0,420,0.0,1.0
7828,25177,24084,21156,2928,0.878,0.122
7829,25180,83,0,83,0.0,1.0
7830,25181,1853,0,1853,0.0,1.0
7831,25183,73,0,73,0.0,1.0
7832,25185,1042,0,1042,0.0,1.0
7833,25186,881,790,91,0.897,0.103
7834,25187,719,0,719,0.0,1.0
7835,25193,477,0,477,0.0,1.0
7836,25201,55,0,55,0.0,1.0
7837,25202,1370,666,704,0.486,0.514
7838,25203,89,0,89,0.0,1.0
7839,25204,211,0,211,0.0,1.0
7840,25205,391,177,214,0.453,0.547
7841,25206,601,0,601,0.0,1.0
7842,25208,992,0,992,0.0,1.0
7843,25209,1227,0,1227,0.0,1.0
7844,25211,135,0,135,0.0,1.0
7845,25213,5512,3411,2101,0.619,0.381
7846,25214,614,46,568,0.075,0.925
7847,25234,1200,0,1200,0.0,1.0
7848,25235,949,0,949,0.0,1.0
7849,25239,1732,0,1732,0.0,1.0
7850,25241,1710,747,963,0.437,0.563
7851,25243,899,0,899,0.0,1.0
7852,25244,732,0,732,0.0,1.0
7853,25245,739,0,739,0.0,1.0
7854,25247,509,486,23,0.955,0.045
7855,25248,3090,0,3090,0.0,1.0
7856,25251,429,0,429,0.0,1.0
7857,25252,1071,0,1071,0.0,1.0
7858,25253,2051,162,1889,0.079,0.921
7859,25259,699,0,699,0.0,1.0
7860,25260,1577,1330,247,0.843,0.157
7861,25261,335,0,335,0.0,1.0
7862,25262,898,0,898,0.0,1.0
7863,25264,441,0,441,0.0,1.0
7864,25265,1564,1496,68,0.957,0.043
7865,25266,797,0,797,0.0,1.0
7866,25267,758,0,758,0.0,1.0
7867,25268,871,0,871,0.0,1.0
7868,25270,972,0,972,0.0,1.0
7869,25271,9304,3446,5858,0.37,0.63
7870,25275,2287,0,2287,0.0,1.0
7871,25276,7752,2986,4766,0.385,0.615
7872,25285,595,0,595,0.0,1.0
7873,25286,1692,0,1692,0.0,1.0
7874,25287,1272,639,633,0.502,0.498
7875,25301,2771,2771,0,1.0,0.0
7876,25302,15078,14250,828,0.945,0.055
7877,25303,7112,7112,0,1.0,0.0
7878,25304,8773,8379,394,0.955,0.045
7879,25305,0,0,0,,
7880,25306,6417,3231,3186,0.504,0.496
7881,25309,13356,10021,3335,0.75,0.25
7882,25311,10815,8795,2020,0.813,0.187
7883,25312,14886,6484,8402,0.436,0.564
7884,25313,13436,10787,2649,0.803,0.197
7885,25314,14542,13317,1225,0.916,0.084
7886,25315,3255,2943,312,0.904,0.096
7887,25320,6084,2226,3858,0.366,0.634
7888,25401,14622,14593,29,0.998,0.002
7889,25403,12591,7768,4823,0.617,0.383
7890,25404,19551,15893,3658,0.813,0.187
7891,25405,12029,11104,925,0.923,0.077
7892,25411,12633,0,12633,0.0,1.0
7893,25413,7508,4327,3181,0.576,0.424
7894,25414,17024,13290,3734,0.781,0.219
7895,25419,9251,7920,1331,0.856,0.144
7896,25420,4024,0,4024,0.0,1.0
7897,25422,1700,0,1700,0.0,1.0
7898,25425,12835,4017,8818,0.313,0.687
7899,25427,14322,1313,13009,0.092,0.908
7900,25428,10776,7444,3332,0.691,0.309
7901,25430,8112,1425,6687,0.176,0.824
7902,25431,453,0,453,0.0,1.0
7903,25432,121,0,121,0.0,1.0
7904,25434,2521,0,2521,0.0,1.0
7905,25437,212,0,212,0.0,1.0
7906,25438,6266,5494,772,0.877,0.123
7907,25442,1925,795,1130,0.413,0.587
7908,25443,7445,3461,3984,0.465,0.535
7909,25444,605,0,605,0.0,1.0
7910,25446,1463,0,1463,0.0,1.0
7911,25501,1130,0,1130,0.0,1.0
7912,25502,1034,0,1034,0.0,1.0
7913,25503,729,0,729,0.0,1.0
7914,25504,12661,8282,4379,0.654,0.346
7915,25505,477,0,477,0.0,1.0
7916,25506,5037,0,5037,0.0,1.0
7917,25507,987,987,0,1.0,0.0
7918,25508,9837,1861,7976,0.189,0.811
7919,25510,5074,3433,1641,0.677,0.323
7920,25511,1092,0,1092,0.0,1.0
7921,25512,1237,0,1237,0.0,1.0
7922,25514,4024,622,3402,0.155,0.845
7923,25515,2335,1,2334,0.0,1.0
7924,25517,2071,0,2071,0.0,1.0
7925,25520,1561,0,1561,0.0,1.0
7926,25521,1101,0,1101,0.0,1.0
7927,25523,2647,0,2647,0.0,1.0
7928,25524,3486,0,3486,0.0,1.0
7929,25526,21902,16638,5264,0.76,0.24
7930,25529,1013,0,1013,0.0,1.0
7931,25530,5877,4217,1660,0.718,0.282
7932,25534,282,0,282,0.0,1.0
7933,25535,2783,500,2283,0.18,0.82
7934,25537,1993,530,1463,0.266,0.734
7935,25540,290,0,290,0.0,1.0
7936,25541,9350,4997,4353,0.534,0.466
7937,25545,4512,2422,2090,0.537,0.463
7938,25547,969,100,869,0.103,0.897
7939,25550,9077,5195,3882,0.572,0.428
7940,25555,2325,0,2325,0.0,1.0
7941,25557,1754,0,1754,0.0,1.0
7942,25559,2152,0,2152,0.0,1.0
7943,25560,7997,5154,2843,0.644,0.356
7944,25564,1250,0,1250,0.0,1.0
7945,25565,651,0,651,0.0,1.0
7946,25567,924,0,924,0.0,1.0
7947,25570,6640,0,6640,0.0,1.0
7948,25571,2206,0,2206,0.0,1.0
7949,25573,970,0,970,0.0,1.0
7950,25601,5206,4136,1070,0.794,0.206
7951,25606,964,0,964,0.0,1.0
7952,25607,1140,0,1140,0.0,1.0
7953,25608,1004,0,1004,0.0,1.0
7954,25611,682,0,682,0.0,1.0
7955,25617,999,0,999,0.0,1.0
7956,25621,2155,0,2155,0.0,1.0
7957,25624,480,229,251,0.477,0.523
7958,25625,1452,340,1112,0.234,0.766
7959,25628,539,0,539,0.0,1.0
7960,25630,683,0,683,0.0,1.0
7961,25632,834,74,760,0.089,0.911
7962,25634,771,0,771,0.0,1.0
7963,25635,1227,0,1227,0.0,1.0
7964,25637,936,811,125,0.866,0.134
7965,25638,1148,573,575,0.499,0.501
7966,25639,608,78,530,0.128,0.872
7967,25644,536,89,447,0.166,0.834
7968,25646,940,774,166,0.823,0.177
7969,25647,768,295,473,0.384,0.616
7970,25649,1397,240,1157,0.172,0.828
7971,25650,547,0,547,0.0,1.0
7972,25651,737,0,737,0.0,1.0
7973,25652,1608,781,827,0.486,0.514
7974,25653,459,175,284,0.381,0.619
7975,25654,310,102,208,0.329,0.671
7976,25661,6837,2754,4083,0.403,0.597
7977,25666,654,0,654,0.0,1.0
7978,25669,887,0,887,0.0,1.0
7979,25670,5829,0,5829,0.0,1.0
7980,25671,1286,0,1286,0.0,1.0
7981,25672,408,0,408,0.0,1.0
7982,25674,3202,0,3202,0.0,1.0
7983,25676,1250,0,1250,0.0,1.0
7984,25678,1595,0,1595,0.0,1.0
7985,25688,448,0,448,0.0,1.0
7986,25690,249,0,249,0.0,1.0
7987,25692,1021,0,1021,0.0,1.0
7988,25696,295,0,295,0.0,1.0
7989,25699,200,0,200,0.0,1.0
7990,25701,23284,19377,3907,0.832,0.168
7991,25702,7788,6750,1038,0.867,0.133
7992,25703,6751,6751,0,1.0,0.0
7993,25704,16441,12607,3834,0.767,0.233
7994,25705,20711,19862,849,0.959,0.041
7995,25801,33590,30120,3470,0.897,0.103
7996,25810,261,0,261,0.0,1.0
7997,25811,154,0,154,0.0,1.0
7998,25812,1902,0,1902,0.0,1.0
7999,25813,8063,3705,4358,0.46,0.54
8000,25817,784,0,784,0.0,1.0
8001,25818,472,472,0,1.0,0.0
8002,25820,437,0,437,0.0,1.0
8003,25823,2176,0,2176,0.0,1.0
8004,25825,2390,0,2390,0.0,1.0
8005,25826,296,0,296,0.0,1.0
8006,25827,2488,1791,697,0.72,0.28
8007,25831,1421,0,1421,0.0,1.0
8008,25832,3994,3004,990,0.752,0.248
8009,25836,488,310,178,0.635,0.365
8010,25837,391,0,391,0.0,1.0
8011,25839,691,0,691,0.0,1.0
8012,25840,8179,3500,4679,0.428,0.572
8013,25841,575,0,575,0.0,1.0
8014,25843,791,0,791,0.0,1.0
8015,25844,1417,0,1417,0.0,1.0
8016,25845,627,0,627,0.0,1.0
8017,25846,363,212,151,0.584,0.416
8018,25848,443,0,443,0.0,1.0
8019,25849,266,0,266,0.0,1.0
8020,25853,182,0,182,0.0,1.0
8021,25854,1101,0,1101,0.0,1.0
8022,25855,209,209,0,1.0,0.0
8023,25857,308,0,308,0.0,1.0
8024,25862,266,0,266,0.0,1.0
8025,25864,309,0,309,0.0,1.0
8026,25865,1475,0,1475,0.0,1.0
8027,25868,432,0,432,0.0,1.0
8028,25870,103,0,103,0.0,1.0
8029,25871,695,695,0,1.0,0.0
8030,25873,607,607,0,1.0,0.0
8031,25875,486,0,486,0.0,1.0
8032,25876,128,0,128,0.0,1.0
8033,25878,930,655,275,0.704,0.296
8034,25879,359,141,218,0.393,0.607
8035,25880,6928,4690,2238,0.677,0.323
8036,25882,2033,0,2033,0.0,1.0
8037,25901,11920,9605,2315,0.806,0.194
8038,25902,420,0,420,0.0,1.0
8039,25904,365,0,365,0.0,1.0
8040,25906,287,0,287,0.0,1.0
8041,25907,123,0,123,0.0,1.0
8042,25908,172,0,172,0.0,1.0
8043,25911,55,55,0,1.0,0.0
8044,25913,397,0,397,0.0,1.0
8045,25915,311,0,311,0.0,1.0
8046,25916,202,0,202,0.0,1.0
8047,25917,2139,785,1354,0.367,0.633
8048,25918,4430,1746,2684,0.394,0.606
8049,25920,221,0,221,0.0,1.0
8050,25921,2157,1720,437,0.797,0.203
8051,25922,299,0,299,0.0,1.0
8052,25928,375,0,375,0.0,1.0
8053,25932,339,0,339,0.0,1.0
8054,25936,43,0,43,0.0,1.0
8055,25938,1287,0,1287,0.0,1.0
8056,25942,162,0,162,0.0,1.0
8057,25951,6208,2635,3573,0.424,0.576
8058,25958,851,0,851,0.0,1.0
8059,25962,3806,0,3806,0.0,1.0
8060,25969,973,0,973,0.0,1.0
8061,25971,1130,0,1130,0.0,1.0
8062,25972,299,0,299,0.0,1.0
8063,25976,2663,0,2663,0.0,1.0
8064,25977,155,0,155,0.0,1.0
8065,25978,606,0,606,0.0,1.0
8066,25979,893,0,893,0.0,1.0
8067,25981,951,0,951,0.0,1.0
8068,25984,1886,0,1886,0.0,1.0
8069,25985,430,0,430,0.0,1.0
8070,25989,280,0,280,0.0,1.0
8071,26003,43002,34823,8179,0.81,0.19
8072,26030,516,0,516,0.0,1.0
8073,26031,1755,1404,351,0.8,0.2
8074,26032,1243,0,1243,0.0,1.0
8075,26033,3044,0,3044,0.0,1.0
8076,26034,4905,3280,1625,0.669,0.331
8077,26035,2491,548,1943,0.22,0.78
8078,26036,425,0,425,0.0,1.0
8079,26037,6642,6557,85,0.987,0.013
8080,26038,2855,1660,1195,0.581,0.419
8081,26039,1061,0,1061,0.0,1.0
8082,26040,2103,1924,179,0.915,0.085
8083,26041,16183,10484,5699,0.648,0.352
8084,26047,6222,76,6146,0.012,0.988
8085,26050,1575,1358,217,0.862,0.138
8086,26055,1756,63,1693,0.036,0.964
8087,26056,93,0,93,0.0,1.0
8088,26059,3082,772,2310,0.25,0.75
8089,26060,1881,0,1881,0.0,1.0
8090,26062,21801,20116,1685,0.923,0.077
8091,26070,8441,3372,5069,0.399,0.601
8092,26074,1184,0,1184,0.0,1.0
8093,26075,505,0,505,0.0,1.0
8094,26101,29999,28106,1893,0.937,0.063
8095,26104,16769,11872,4897,0.708,0.292
8096,26105,12333,11960,373,0.97,0.03
8097,26133,1415,0,1415,0.0,1.0
8098,26134,888,866,22,0.975,0.025
8099,26136,644,0,644,0.0,1.0
8100,26137,939,0,939,0.0,1.0
8101,26138,127,0,127,0.0,1.0
8102,26141,364,0,364,0.0,1.0
8103,26142,2574,1431,1143,0.556,0.444
8104,26143,4547,0,4547,0.0,1.0
8105,26146,1003,0,1003,0.0,1.0
8106,26147,2188,0,2188,0.0,1.0
8107,26148,245,0,245,0.0,1.0
8108,26149,2452,0,2452,0.0,1.0
8109,26150,6309,3452,2857,0.547,0.453
8110,26151,558,0,558,0.0,1.0
8111,26152,56,0,56,0.0,1.0
8112,26155,8823,5777,3046,0.655,0.345
8113,26159,2745,2636,109,0.96,0.04
8114,26160,960,0,960,0.0,1.0
8115,26161,480,0,480,0.0,1.0
8116,26164,8262,4150,4112,0.502,0.498
8117,26167,865,0,865,0.0,1.0
8118,26169,842,0,842,0.0,1.0
8119,26170,6137,2597,3540,0.423,0.577
8120,26175,3326,0,3326,0.0,1.0
8121,26178,587,0,587,0.0,1.0
8122,26180,2284,0,2284,0.0,1.0
8123,26181,6127,2222,3905,0.363,0.637
8124,26184,2361,9,2352,0.004,0.996
8125,26187,5982,4622,1360,0.773,0.227
8126,26201,19701,8731,10970,0.443,0.557
8127,26202,641,0,641,0.0,1.0
8128,26203,198,0,198,0.0,1.0
8129,26205,3690,0,3690,0.0,1.0
8130,26206,2976,0,2976,0.0,1.0
8131,26208,973,0,973,0.0,1.0
8132,26209,112,0,112,0.0,1.0
8133,26215,167,0,167,0.0,1.0
8134,26217,354,0,354,0.0,1.0
8135,26218,2583,0,2583,0.0,1.0
8136,26222,454,0,454,0.0,1.0
8137,26224,221,0,221,0.0,1.0
8138,26228,109,0,109,0.0,1.0
8139,26230,124,0,124,0.0,1.0
8140,26234,1454,0,1454,0.0,1.0
8141,26236,29,0,29,0.0,1.0
8142,26237,571,0,571,0.0,1.0
8143,26238,739,0,739,0.0,1.0
8144,26241,14591,10243,4348,0.702,0.298
8145,26250,5570,0,5570,0.0,1.0
8146,26253,3490,818,2672,0.234,0.766
8147,26254,303,0,303,0.0,1.0
8148,26257,957,0,957,0.0,1.0
8149,26259,176,0,176,0.0,1.0
8150,26260,1377,0,1377,0.0,1.0
8151,26261,2701,0,2701,0.0,1.0
8152,26263,316,0,316,0.0,1.0
8153,26264,642,0,642,0.0,1.0
8154,26266,252,0,252,0.0,1.0
8155,26267,369,0,369,0.0,1.0
8156,26268,82,0,82,0.0,1.0
8157,26269,1018,0,1018,0.0,1.0
8158,26270,755,0,755,0.0,1.0
8159,26271,383,0,383,0.0,1.0
8160,26273,2041,0,2041,0.0,1.0
8161,26275,744,0,744,0.0,1.0
8162,26276,356,0,356,0.0,1.0
8163,26278,591,0,591,0.0,1.0
8164,26280,1710,0,1710,0.0,1.0
8165,26282,60,0,60,0.0,1.0
8166,26283,1734,0,1734,0.0,1.0
8167,26285,304,0,304,0.0,1.0
8168,26287,3131,0,3131,0.0,1.0
8169,26288,3603,0,3603,0.0,1.0
8170,26291,165,0,165,0.0,1.0
8171,26292,836,0,836,0.0,1.0
8172,26293,600,0,600,0.0,1.0
8173,26294,729,0,729,0.0,1.0
8174,26296,177,0,177,0.0,1.0
8175,26298,96,0,96,0.0,1.0
8176,26301,30435,25483,4952,0.837,0.163
8177,26320,1000,0,1000,0.0,1.0
8178,26321,354,0,354,0.0,1.0
8179,26323,602,597,5,0.992,0.008
8180,26325,320,0,320,0.0,1.0
8181,26327,83,0,83,0.0,1.0
8182,26330,14377,10574,3803,0.735,0.265
8183,26335,1378,0,1378,0.0,1.0
8184,26337,1218,0,1218,0.0,1.0
8185,26338,629,0,629,0.0,1.0
8186,26339,255,0,255,0.0,1.0
8187,26342,509,0,509,0.0,1.0
8188,26343,445,0,445,0.0,1.0
8189,26346,972,0,972,0.0,1.0
8190,26347,2068,0,2068,0.0,1.0
8191,26348,196,0,196,0.0,1.0
8192,26349,132,0,132,0.0,1.0
8193,26351,5120,3415,1705,0.667,0.333
8194,26354,11135,5923,5212,0.532,0.468
8195,26361,263,263,0,1.0,0.0
8196,26362,3378,0,3378,0.0,1.0
8197,26366,144,127,17,0.882,0.118
8198,26369,762,646,116,0.848,0.152
8199,26372,686,24,662,0.035,0.965
8200,26374,1375,0,1375,0.0,1.0
8201,26376,463,0,463,0.0,1.0
8202,26377,700,0,700,0.0,1.0
8203,26378,3820,19,3801,0.005,0.995
8204,26384,520,0,520,0.0,1.0
8205,26385,3872,0,3872,0.0,1.0
8206,26386,2411,988,1423,0.41,0.59
8207,26404,458,193,265,0.421,0.579
8208,26405,1179,0,1179,0.0,1.0
8209,26408,2852,792,2060,0.278,0.722
8210,26410,1037,0,1037,0.0,1.0
8211,26411,707,0,707,0.0,1.0
8212,26412,546,0,546,0.0,1.0
8213,26415,4016,0,4016,0.0,1.0
8214,26416,7529,2700,4829,0.359,0.641
8215,26419,1131,0,1131,0.0,1.0
8216,26421,262,0,262,0.0,1.0
8217,26422,606,260,346,0.429,0.571
8218,26424,318,0,318,0.0,1.0
8219,26425,1216,0,1216,0.0,1.0
8220,26426,7003,253,6750,0.036,0.964
8221,26430,466,0,466,0.0,1.0
8222,26431,5950,3154,2796,0.53,0.47
8223,26435,98,0,98,0.0,1.0
8224,26436,204,0,204,0.0,1.0
8225,26437,645,0,645,0.0,1.0
8226,26438,176,176,0,1.0,0.0
8227,26440,1135,0,1135,0.0,1.0
8228,26443,258,0,258,0.0,1.0
8229,26444,3639,0,3639,0.0,1.0
8230,26447,1055,0,1055,0.0,1.0
8231,26448,1421,0,1421,0.0,1.0
8232,26451,685,0,685,0.0,1.0
8233,26452,9676,5034,4642,0.52,0.48
8234,26456,3734,0,3734,0.0,1.0
8235,26501,19616,13851,5765,0.706,0.294
8236,26505,38772,38341,431,0.989,0.011
8237,26508,29170,17108,12062,0.586,0.414
8238,26519,1836,0,1836,0.0,1.0
8239,26520,778,0,778,0.0,1.0
8240,26521,346,0,346,0.0,1.0
8241,26525,7064,0,7064,0.0,1.0
8242,26534,789,789,0,1.0,0.0
8243,26537,5721,3201,2520,0.56,0.44
8244,26541,2624,93,2531,0.035,0.965
8245,26542,2547,0,2547,0.0,1.0
8246,26543,252,168,84,0.667,0.333
8247,26547,2376,0,2376,0.0,1.0
8248,26554,41369,30464,10905,0.736,0.264
8249,26559,1269,1269,0,1.0,0.0
8250,26560,227,0,227,0.0,1.0
8251,26562,634,0,634,0.0,1.0
8252,26563,381,0,381,0.0,1.0
8253,26568,679,467,212,0.688,0.312
8254,26570,3595,0,3595,0.0,1.0
8255,26571,1833,0,1833,0.0,1.0
8256,26572,136,0,136,0.0,1.0
8257,26574,664,0,664,0.0,1.0
8258,26575,827,0,827,0.0,1.0
8259,26576,608,0,608,0.0,1.0
8260,26581,1104,0,1104,0.0,1.0
8261,26582,5335,0,5335,0.0,1.0
8262,26585,479,0,479,0.0,1.0
8263,26586,209,209,0,1.0,0.0
8264,26587,432,0,432,0.0,1.0
8265,26588,2611,1022,1589,0.391,0.609
8266,26590,791,0,791,0.0,1.0
8267,26591,1511,460,1051,0.304,0.696
8268,26601,4898,0,4898,0.0,1.0
8269,26610,1090,0,1090,0.0,1.0
8270,26611,224,0,224,0.0,1.0
8271,26615,245,0,245,0.0,1.0
8272,26617,187,0,187,0.0,1.0
8273,26619,606,0,606,0.0,1.0
8274,26621,757,0,757,0.0,1.0
8275,26623,1189,0,1189,0.0,1.0
8276,26624,2950,0,2950,0.0,1.0
8277,26627,447,0,447,0.0,1.0
8278,26629,309,0,309,0.0,1.0
8279,26631,352,0,352,0.0,1.0
8280,26636,487,0,487,0.0,1.0
8281,26638,178,0,178,0.0,1.0
8282,26651,9650,3369,6281,0.349,0.651
8283,26656,401,0,401,0.0,1.0
8284,26660,255,0,255,0.0,1.0
8285,26662,1154,0,1154,0.0,1.0
8286,26676,435,0,435,0.0,1.0
8287,26678,1247,0,1247,0.0,1.0
8288,26679,1896,0,1896,0.0,1.0
8289,26680,340,0,340,0.0,1.0
8290,26681,1486,0,1486,0.0,1.0
8291,26684,116,0,116,0.0,1.0
8292,26690,584,0,584,0.0,1.0
8293,26691,417,0,417,0.0,1.0
8294,26704,5663,0,5663,0.0,1.0
8295,26705,1077,0,1077,0.0,1.0
8296,26707,344,0,344,0.0,1.0
8297,26710,2133,0,2133,0.0,1.0
8298,26711,2655,0,2655,0.0,1.0
8299,26714,482,0,482,0.0,1.0
8300,26716,706,0,706,0.0,1.0
8301,26717,1170,0,1170,0.0,1.0
8302,26719,2785,0,2785,0.0,1.0
8303,26720,174,0,174,0.0,1.0
8304,26722,599,0,599,0.0,1.0
8305,26726,13306,6851,6455,0.515,0.485
8306,26731,382,0,382,0.0,1.0
8307,26739,889,0,889,0.0,1.0
8308,26743,1613,0,1613,0.0,1.0
8309,26750,891,889,2,0.998,0.002
8310,26753,6254,1664,4590,0.266,0.734
8311,26755,833,0,833,0.0,1.0
8312,26757,6464,0,6464,0.0,1.0
8313,26761,685,0,685,0.0,1.0
8314,26763,1540,0,1540,0.0,1.0
8315,26764,4220,0,4220,0.0,1.0
8316,26767,768,585,183,0.762,0.238
8317,26801,1118,0,1118,0.0,1.0
8318,26802,1357,0,1357,0.0,1.0
8319,26804,709,0,709,0.0,1.0
8320,26807,2947,0,2947,0.0,1.0
8321,26808,967,0,967,0.0,1.0
8322,26810,329,0,329,0.0,1.0
8323,26812,1705,0,1705,0.0,1.0
8324,26814,415,0,415,0.0,1.0
8325,26815,646,0,646,0.0,1.0
8326,26817,443,0,443,0.0,1.0
8327,26818,709,0,709,0.0,1.0
8328,26823,198,0,198,0.0,1.0
8329,26833,2309,0,2309,0.0,1.0
8330,26836,6578,2732,3846,0.415,0.585
8331,26845,898,0,898,0.0,1.0
8332,26847,6277,2545,3732,0.405,0.595
8333,26851,2180,0,2180,0.0,1.0
8334,26852,869,0,869,0.0,1.0
8335,26855,826,0,826,0.0,1.0
8336,26865,248,0,248,0.0,1.0
8337,26866,929,0,929,0.0,1.0
8338,26884,625,0,625,0.0,1.0
8339,27006,14150,7062,7088,0.499,0.501
8340,27007,2162,0,2162,0.0,1.0
8341,27009,2647,445,2202,0.168,0.832
8342,27011,5497,0,5497,0.0,1.0
8343,27012,25461,21191,4270,0.832,0.168
8344,27013,6057,0,6057,0.0,1.0
8345,27014,840,0,840,0.0,1.0
8346,27016,1936,0,1936,0.0,1.0
8347,27017,9597,0,9597,0.0,1.0
8348,27018,7655,0,7655,0.0,1.0
8349,27019,4032,453,3579,0.112,0.888
8350,27020,6421,0,6421,0.0,1.0
8351,27021,18106,11472,6634,0.634,0.366
8352,27022,1560,0,1560,0.0,1.0
8353,27023,11873,10077,1796,0.849,0.151
8354,27024,2733,0,2733,0.0,1.0
8355,27025,11138,1850,9288,0.166,0.834
8356,27027,4385,2532,1853,0.577,0.423
8357,27028,25839,5191,20648,0.201,0.799
8358,27030,38374,19419,18955,0.506,0.494
8359,27040,10893,8344,2549,0.766,0.234
8360,27041,7554,0,7554,0.0,1.0
8361,27042,834,0,834,0.0,1.0
8362,27043,6615,0,6615,0.0,1.0
8363,27045,8536,6808,1728,0.798,0.202
8364,27046,2024,0,2024,0.0,1.0
8365,27047,1191,0,1191,0.0,1.0
8366,27048,8609,116,8493,0.013,0.987
8367,27050,3893,834,3059,0.214,0.786
8368,27051,7369,5675,1694,0.77,0.23
8369,27052,10624,0,10624,0.0,1.0
8370,27053,3007,0,3007,0.0,1.0
8371,27054,2567,0,2567,0.0,1.0
8372,27055,14200,3530,10670,0.249,0.751
8373,27101,18901,18901,0,1.0,0.0
8374,27103,33208,33198,10,1.0,0.0
8375,27104,28485,28485,0,1.0,0.0
8376,27105,39568,38538,1030,0.974,0.026
8377,27106,45015,45015,0,1.0,0.0
8378,27107,46963,41076,5887,0.875,0.125
8379,27109,2539,2539,0,1.0,0.0
8380,27110,2127,2127,0,1.0,0.0
8381,27127,34138,33098,1040,0.97,0.03
8382,27201,63,0,63,0.0,1.0
8383,27203,21108,19940,1168,0.945,0.055
8384,27205,33216,9579,23637,0.288,0.712
8385,27207,3795,0,3795,0.0,1.0
8386,27208,1676,0,1676,0.0,1.0
8387,27209,3933,1856,2077,0.472,0.528
8388,27212,2580,0,2580,0.0,1.0
8389,27214,10294,3485,6809,0.339,0.661
8390,27215,38807,34137,4670,0.88,0.12
8391,27217,36954,26397,10557,0.714,0.286
8392,27229,3929,0,3929,0.0,1.0
8393,27231,2148,0,2148,0.0,1.0
8394,27233,3390,0,3390,0.0,1.0
8395,27235,4136,1939,2197,0.469,0.531
8396,27239,9079,0,9079,0.0,1.0
8397,27242,2100,0,2100,0.0,1.0
8398,27243,4337,447,3890,0.103,0.897
8399,27244,14173,8976,5197,0.633,0.367
8400,27248,4524,689,3835,0.152,0.848
8401,27249,12486,6068,6418,0.486,0.514
8402,27252,2003,0,2003,0.0,1.0
8403,27253,29827,18453,11374,0.619,0.381
8404,27258,6006,3577,2429,0.596,0.404
8405,27260,24023,24023,0,1.0,0.0
8406,27262,23934,23353,581,0.976,0.024
8407,27263,21414,17121,4293,0.8,0.2
8408,27265,46690,43896,2794,0.94,0.06
8409,27278,24286,12937,11349,0.533,0.467
8410,27281,3100,0,3100,0.0,1.0
8411,27282,15906,15595,311,0.98,0.02
8412,27283,3141,0,3141,0.0,1.0
8413,27284,51136,42515,8621,0.831,0.169
8414,27288,24071,17071,7000,0.709,0.291
8415,27291,1662,0,1662,0.0,1.0
8416,27292,39787,16104,23683,0.405,0.595
8417,27295,37211,17233,19978,0.463,0.537
8418,27298,10336,0,10336,0.0,1.0
8419,27299,5190,1113,4077,0.214,0.786
8420,27301,8750,3925,4825,0.449,0.551
8421,27302,26412,18217,8195,0.69,0.31
8422,27305,1685,0,1685,0.0,1.0
8423,27306,6176,0,6176,0.0,1.0
8424,27310,6710,4742,1968,0.707,0.293
8425,27311,3402,191,3211,0.056,0.944
8426,27312,18306,6052,12254,0.331,0.669
8427,27313,6962,1113,5849,0.16,0.84
8428,27314,1051,0,1051,0.0,1.0
8429,27315,2243,0,2243,0.0,1.0
8430,27316,6650,2262,4388,0.34,0.66
8431,27317,16959,8111,8848,0.478,0.522
8432,27320,39351,14067,25284,0.357,0.643
8433,27325,6704,0,6704,0.0,1.0
8434,27326,4008,0,4008,0.0,1.0
8435,27330,37947,24301,13646,0.64,0.36
8436,27332,30236,15804,14432,0.523,0.477
8437,27340,120,0,120,0.0,1.0
8438,27341,5360,0,5360,0.0,1.0
8439,27343,1716,0,1716,0.0,1.0
8440,27344,18022,9076,8946,0.504,0.496
8441,27349,5511,0,5511,0.0,1.0
8442,27350,6530,824,5706,0.126,0.874
8443,27355,2660,0,2660,0.0,1.0
8444,27356,3205,965,2240,0.301,0.699
8445,27357,7894,0,7894,0.0,1.0
8446,27358,14075,7346,6729,0.522,0.478
8447,27360,46084,33522,12562,0.727,0.273
8448,27370,15052,6680,8372,0.444,0.556
8449,27371,8132,3618,4514,0.445,0.555
8450,27376,9386,4478,4908,0.477,0.523
8451,27377,7104,3964,3140,0.558,0.442
8452,27379,4661,0,4661,0.0,1.0
8453,27401,21932,21932,0,1.0,0.0
8454,27403,21958,21958,0,1.0,0.0
8455,27405,44567,42416,2151,0.952,0.048
8456,27406,56458,48204,8254,0.854,0.146
8457,27407,46242,44877,1365,0.97,0.03
8458,27408,17296,17296,0,1.0,0.0
8459,27409,15621,15245,376,0.976,0.024
8460,27410,52388,52388,0,1.0,0.0
8461,27455,28706,25133,3573,0.876,0.124
8462,27501,17571,5222,12349,0.297,0.703
8463,27502,30831,29344,1487,0.952,0.048
8464,27503,3471,0,3471,0.0,1.0
8465,27504,14566,5092,9474,0.35,0.65
8466,27505,5896,122,5774,0.021,0.979
8467,27507,1929,0,1929,0.0,1.0
8468,27508,2053,0,2053,0.0,1.0
8469,27509,10167,9693,474,0.953,0.047
8470,27510,14644,14644,0,1.0,0.0
8471,27511,32029,32029,0,1.0,0.0
8472,27513,40755,40753,2,1.0,0.0
8473,27514,32110,30402,1708,0.947,0.053
8474,27516,36139,25072,11067,0.694,0.306
8475,27517,23346,17654,5692,0.756,0.244
8476,27518,19630,19630,0,1.0,0.0
8477,27519,39178,38247,931,0.976,0.024
8478,27520,36357,23939,12418,0.658,0.342
8479,27521,6035,2142,3893,0.355,0.645
8480,27522,12335,7282,5053,0.59,0.41
8481,27523,9552,6445,3107,0.675,0.325
8482,27524,12338,2685,9653,0.218,0.782
8483,27525,13338,0,13338,0.0,1.0
8484,27526,38894,29457,9437,0.757,0.243
8485,27527,18216,12171,6045,0.668,0.332
8486,27529,42128,39331,2797,0.934,0.066
8487,27530,40117,29751,10366,0.742,0.258
8488,27531,594,594,0,1.0,0.0
8489,27534,31364,22177,9187,0.707,0.293
8490,27536,17289,16652,637,0.963,0.037
8491,27537,24319,4151,20168,0.171,0.829
8492,27539,18692,18537,155,0.992,0.008
8493,27540,29363,27101,2262,0.923,0.077
8494,27541,3770,0,3770,0.0,1.0
8495,27542,9133,0,9133,0.0,1.0
8496,27544,4449,55,4394,0.012,0.988
8497,27545,23006,20133,2873,0.875,0.125
8498,27546,19471,7393,12078,0.38,0.62
8499,27549,24112,3694,20418,0.153,0.847
8500,27551,1962,0,1962,0.0,1.0
8501,27553,2937,0,2937,0.0,1.0
8502,27555,441,0,441,0.0,1.0
8503,27556,346,0,346,0.0,1.0
8504,27557,7509,0,7509,0.0,1.0
8505,27559,2288,0,2288,0.0,1.0
8506,27560,22623,22483,140,0.994,0.006
8507,27562,1938,0,1938,0.0,1.0
8508,27563,5008,0,5008,0.0,1.0
8509,27565,25255,9174,16081,0.363,0.637
8510,27568,480,480,0,1.0,0.0
8511,27569,8022,0,8022,0.0,1.0
8512,27571,3893,3440,453,0.884,0.116
8513,27572,6546,0,6546,0.0,1.0
8514,27573,11414,9254,2160,0.811,0.189
8515,27574,14373,406,13967,0.028,0.972
8516,27576,17091,7184,9907,0.42,0.58
8517,27577,22911,13201,9710,0.576,0.424
8518,27581,3049,0,3049,0.0,1.0
8519,27582,289,0,289,0.0,1.0
8520,27583,6921,0,6921,0.0,1.0
8521,27587,53078,40132,12946,0.756,0.244
8522,27589,8370,0,8370,0.0,1.0
8523,27591,19589,9966,9623,0.509,0.491
8524,27592,15244,7126,8118,0.467,0.533
8525,27596,15619,3952,11667,0.253,0.747
8526,27597,22181,6696,15485,0.302,0.698
8527,27601,9450,9450,0,1.0,0.0
8528,27603,47033,43407,3626,0.923,0.077
8529,27604,42204,41345,859,0.98,0.02
8530,27605,4495,4495,0,1.0,0.0
8531,27606,43210,43014,196,0.995,0.005
8532,27607,25188,25161,27,0.999,0.001
8533,27608,10429,10429,0,1.0,0.0
8534,27609,32964,32964,0,1.0,0.0
8535,27610,65648,63340,2308,0.965,0.035
8536,27612,35028,35011,17,1.0,0.0
8537,27613,42690,42056,634,0.985,0.015
8538,27614,31516,29036,2480,0.921,0.079
8539,27615,42166,42166,0,1.0,0.0
8540,27616,42294,41736,558,0.987,0.013
8541,27617,15199,15183,16,0.999,0.001
8542,27701,21288,21288,0,1.0,0.0
8543,27703,41937,39733,2204,0.947,0.053
8544,27704,34517,32011,2506,0.927,0.073
8545,27705,46282,42837,3445,0.926,0.074
8546,27707,45023,44803,220,0.995,0.005
8547,27709,1047,1047,0,1.0,0.0
8548,27712,20035,17417,2618,0.869,0.131
8549,27713,46660,45838,822,0.982,0.018
8550,27801,21740,16309,5431,0.75,0.25
8551,27803,21227,15335,5892,0.722,0.278
8552,27804,29058,26188,2870,0.901,0.099
8553,27805,3992,0,3992,0.0,1.0
8554,27806,2331,0,2331,0.0,1.0
8555,27807,6629,0,6629,0.0,1.0
8556,27808,2225,0,2225,0.0,1.0
8557,27809,5091,1128,3963,0.222,0.778
8558,27810,4377,0,4377,0.0,1.0
8559,27812,2593,0,2593,0.0,1.0
8560,27813,747,0,747,0.0,1.0
8561,27814,1676,0,1676,0.0,1.0
8562,27816,2516,0,2516,0.0,1.0
8563,27817,7358,1057,6301,0.144,0.856
8564,27818,1344,0,1344,0.0,1.0
8565,27819,330,0,330,0.0,1.0
8566,27820,3088,0,3088,0.0,1.0
8567,27821,358,0,358,0.0,1.0
8568,27822,8143,10,8133,0.001,0.999
8569,27823,8201,2672,5529,0.326,0.674
8570,27824,1476,0,1476,0.0,1.0
8571,27825,103,0,103,0.0,1.0
8572,27826,1379,0,1379,0.0,1.0
8573,27827,33,0,33,0.0,1.0
8574,27828,9071,4815,4256,0.531,0.469
8575,27829,1930,0,1930,0.0,1.0
8576,27830,4755,0,4755,0.0,1.0
8577,27831,3908,1049,2859,0.268,0.732
8578,27832,2847,1301,1546,0.457,0.543
8579,27834,52914,40514,12400,0.766,0.234
8580,27837,5903,995,4908,0.169,0.831
8581,27839,4001,0,4001,0.0,1.0
8582,27840,514,0,514,0.0,1.0
8583,27841,84,0,84,0.0,1.0
8584,27842,1493,0,1493,0.0,1.0
8585,27843,1157,0,1157,0.0,1.0
8586,27844,2950,0,2950,0.0,1.0
8587,27845,2394,0,2394,0.0,1.0
8588,27846,2988,0,2988,0.0,1.0
8589,27847,936,0,936,0.0,1.0
8590,27849,1544,0,1544,0.0,1.0
8591,27850,7247,0,7247,0.0,1.0
8592,27851,5268,0,5268,0.0,1.0
8593,27852,2977,0,2977,0.0,1.0
8594,27853,673,0,673,0.0,1.0
8595,27855,6456,2786,3670,0.432,0.568
8596,27856,17141,7487,9654,0.437,0.563
8597,27857,1298,0,1298,0.0,1.0
8598,27858,55781,50739,5042,0.91,0.09
8599,27860,2246,0,2246,0.0,1.0
8600,27861,71,0,71,0.0,1.0
8601,27862,877,0,877,0.0,1.0
8602,27863,11735,2571,9164,0.219,0.781
8603,27864,4779,0,4779,0.0,1.0
8604,27865,1927,0,1927,0.0,1.0
8605,27866,855,0,855,0.0,1.0
8606,27869,2258,0,2258,0.0,1.0
8607,27870,27236,20056,7180,0.736,0.264
8608,27871,4619,0,4619,0.0,1.0
8609,27872,375,0,375,0.0,1.0
8610,27873,397,0,397,0.0,1.0
8611,27874,4861,0,4861,0.0,1.0
8612,27875,517,0,517,0.0,1.0
8613,27876,1302,0,1302,0.0,1.0
8614,27878,1931,1796,135,0.93,0.07
8615,27879,311,311,0,1.0,0.0
8616,27880,3304,0,3304,0.0,1.0
8617,27881,61,0,61,0.0,1.0
8618,27882,7413,0,7413,0.0,1.0
8619,27883,3565,0,3565,0.0,1.0
8620,27884,1282,0,1282,0.0,1.0
8621,27885,984,0,984,0.0,1.0
8622,27886,21591,13581,8010,0.629,0.371
8623,27888,2560,0,2560,0.0,1.0
8624,27889,27468,15372,12096,0.56,0.44
8625,27890,2521,2044,477,0.811,0.189
8626,27891,5227,0,5227,0.0,1.0
8627,27892,15182,5361,9821,0.353,0.647
8628,27893,39723,31228,8495,0.786,0.214
8629,27896,20130,17952,2178,0.892,0.108
8630,27897,2265,0,2265,0.0,1.0
8631,27909,40699,23898,16801,0.587,0.413
8632,27910,12007,4951,7056,0.412,0.588
8633,27915,777,0,777,0.0,1.0
8634,27916,747,0,747,0.0,1.0
8635,27917,833,0,833,0.0,1.0
8636,27919,1130,0,1130,0.0,1.0
8637,27920,1326,0,1326,0.0,1.0
8638,27921,4805,7,4798,0.001,0.999
8639,27922,1030,0,1030,0.0,1.0
8640,27923,598,0,598,0.0,1.0
8641,27924,3140,0,3140,0.0,1.0
8642,27925,4217,0,4217,0.0,1.0
8643,27926,1915,0,1915,0.0,1.0
8644,27927,542,0,542,0.0,1.0
8645,27928,1986,0,1986,0.0,1.0
8646,27929,1166,0,1166,0.0,1.0
8647,27932,12562,4790,7772,0.381,0.619
8648,27935,1698,0,1698,0.0,1.0
8649,27936,1091,0,1091,0.0,1.0
8650,27937,4333,0,4333,0.0,1.0
8651,27938,1505,0,1505,0.0,1.0
8652,27939,2361,0,2361,0.0,1.0
8653,27941,536,10,526,0.019,0.981
8654,27942,901,0,901,0.0,1.0
8655,27943,504,0,504,0.0,1.0
8656,27944,11909,0,11909,0.0,1.0
8657,27946,1207,0,1207,0.0,1.0
8658,27947,1230,0,1230,0.0,1.0
8659,27948,10862,10833,29,0.997,0.003
8660,27949,6947,5013,1934,0.722,0.278
8661,27950,2006,0,2006,0.0,1.0
8662,27953,1021,313,708,0.307,0.693
8663,27954,6111,5228,883,0.856,0.144
8664,27956,340,0,340,0.0,1.0
8665,27957,1356,0,1356,0.0,1.0
8666,27958,10144,0,10144,0.0,1.0
8667,27959,2789,2710,79,0.972,0.028
8668,27960,948,0,948,0.0,1.0
8669,27962,7792,4265,3527,0.547,0.453
8670,27964,545,387,158,0.71,0.29
8671,27965,527,0,527,0.0,1.0
8672,27966,1052,0,1052,0.0,1.0
8673,27967,366,0,366,0.0,1.0
8674,27968,298,0,298,0.0,1.0
8675,27970,3409,0,3409,0.0,1.0
8676,27972,244,0,244,0.0,1.0
8677,27973,1323,0,1323,0.0,1.0
8678,27974,1285,0,1285,0.0,1.0
8679,27976,3449,0,3449,0.0,1.0
8680,27978,225,0,225,0.0,1.0
8681,27979,1719,0,1719,0.0,1.0
8682,27980,2182,0,2182,0.0,1.0
8683,27981,1643,0,1643,0.0,1.0
8684,27982,82,0,82,0.0,1.0
8685,27983,10416,3566,6850,0.342,0.658
8686,27985,283,0,283,0.0,1.0
8687,27986,2430,0,2430,0.0,1.0
8688,28001,26760,15912,10848,0.595,0.405
8689,28006,1130,317,813,0.281,0.719
8690,28007,611,0,611,0.0,1.0
8691,28009,1121,0,1121,0.0,1.0
8692,28012,20048,17933,2115,0.895,0.105
8693,28016,13463,6182,7281,0.459,0.541
8694,28017,695,695,0,1.0,0.0
8695,28018,5562,1110,4452,0.2,0.8
8696,28019,123,123,0,1.0,0.0
8697,28020,2322,0,2322,0.0,1.0
8698,28021,13612,6802,6810,0.5,0.5
8699,28023,14175,7171,7004,0.506,0.494
8700,28025,49160,36711,12449,0.747,0.253
8701,28027,55435,52589,2846,0.949,0.051
8702,28031,24390,24311,79,0.997,0.003
8703,28032,3105,3105,0,1.0,0.0
8704,28033,2749,287,2462,0.104,0.896
8705,28034,16642,9053,7589,0.544,0.456
8706,28036,14654,11740,2914,0.801,0.199
8707,28037,18287,11837,6450,0.647,0.353
8708,28039,116,116,0,1.0,0.0
8709,28040,7969,1180,6789,0.148,0.852
8710,28043,21055,13841,7214,0.657,0.343
8711,28052,34932,32186,2746,0.921,0.079
8712,28054,36270,36270,0,1.0,0.0
8713,28056,31418,26862,4556,0.855,0.145
8714,28071,2802,0,2802,0.0,1.0
8715,28072,1357,1357,0,1.0,0.0
8716,28073,5621,411,5210,0.073,0.927
8717,28075,16143,15634,509,0.968,0.032
8718,28076,722,582,140,0.806,0.194
8719,28077,482,482,0,1.0,0.0
8720,28078,52133,48461,3672,0.93,0.07
8721,28079,31979,28785,3194,0.9,0.1
8722,28080,7299,793,6506,0.109,0.891
8723,28081,25190,21837,3353,0.867,0.133
8724,28083,23820,22035,1785,0.925,0.075
8725,28086,25895,12435,13460,0.48,0.52
8726,28088,2862,2787,75,0.974,0.026
8727,28089,248,0,248,0.0,1.0
8728,28090,8342,0,8342,0.0,1.0
8729,28091,2158,0,2158,0.0,1.0
8730,28092,38570,21378,17192,0.554,0.446
8731,28097,5369,2352,3017,0.438,0.562
8732,28098,3579,3579,0,1.0,0.0
8733,28101,698,698,0,1.0,0.0
8734,28102,78,0,78,0.0,1.0
8735,28103,10311,2454,7857,0.238,0.762
8736,28104,28040,27576,464,0.983,0.017
8737,28105,39586,39586,0,1.0,0.0
8738,28107,6422,0,6422,0.0,1.0
8739,28108,54,0,54,0.0,1.0
8740,28109,387,0,387,0.0,1.0
8741,28110,50365,36262,14103,0.72,0.28
8742,28112,26311,12208,14103,0.464,0.536
8743,28114,7554,464,7090,0.061,0.939
8744,28115,34339,27318,7021,0.796,0.204
8745,28117,35454,34799,655,0.982,0.018
8746,28119,2801,0,2801,0.0,1.0
8747,28120,19807,17267,2540,0.872,0.128
8748,28124,6622,0,6622,0.0,1.0
8749,28125,2525,0,2525,0.0,1.0
8750,28127,7594,911,6683,0.12,0.88
8751,28128,7476,0,7476,0.0,1.0
8752,28129,5399,0,5399,0.0,1.0
8753,28133,2878,0,2878,0.0,1.0
8754,28134,9453,9453,0,1.0,0.0
8755,28135,6123,175,5948,0.029,0.971
8756,28137,3120,0,3120,0.0,1.0
8757,28138,10495,3833,6662,0.365,0.635
8758,28139,20111,5530,14581,0.275,0.725
8759,28144,24734,22102,2632,0.894,0.106
8760,28146,27614,12597,15017,0.456,0.544
8761,28147,24697,17278,7419,0.7,0.3
8762,28150,28098,16212,11886,0.577,0.423
8763,28152,24735,13251,11484,0.536,0.464
8764,28159,3108,3003,105,0.966,0.034
8765,28160,3929,3588,341,0.913,0.087
8766,28163,5233,573,4660,0.109,0.891
8767,28164,14085,7175,6910,0.509,0.491
8768,28166,8619,4115,4504,0.477,0.523
8769,28167,2362,0,2362,0.0,1.0
8770,28168,10230,0,10230,0.0,1.0
8771,28169,173,102,71,0.59,0.41
8772,28170,12355,5616,6739,0.455,0.545
8773,28173,45097,33698,11399,0.747,0.253
8774,28174,8608,5130,3478,0.596,0.404
8775,28202,11195,11195,0,1.0,0.0
8776,28203,11315,11315,0,1.0,0.0
8777,28204,4796,4796,0,1.0,0.0
8778,28205,43931,43931,0,1.0,0.0
8779,28206,11898,11898,0,1.0,0.0
8780,28207,9280,9280,0,1.0,0.0
8781,28208,34167,34167,0,1.0,0.0
8782,28209,20317,20317,0,1.0,0.0
8783,28210,42263,42263,0,1.0,0.0
8784,28211,28523,28523,0,1.0,0.0
8785,28212,38457,38457,0,1.0,0.0
8786,28213,37309,37309,0,1.0,0.0
8787,28214,34721,33980,741,0.979,0.021
8788,28215,53629,53368,261,0.995,0.005
8789,28216,47208,47173,35,0.999,0.001
8790,28217,24204,24204,0,1.0,0.0
8791,28226,37286,37286,0,1.0,0.0
8792,28227,49635,47925,1710,0.966,0.034
8793,28244,0,0,0,,
8794,28262,37547,37547,0,1.0,0.0
8795,28269,71048,71048,0,1.0,0.0
8796,28270,31525,31525,0,1.0,0.0
8797,28273,31478,31478,0,1.0,0.0
8798,28277,59664,59664,0,1.0,0.0
8799,28278,19283,16953,2330,0.879,0.121
8800,28280,10,10,0,1.0,0.0
8801,28282,0,0,0,,
8802,28301,17165,17165,0,1.0,0.0
8803,28303,30909,30909,0,1.0,0.0
8804,28304,37147,36991,156,0.996,0.004
8805,28305,6073,6073,0,1.0,0.0
8806,28306,39683,35468,4215,0.894,0.106
8807,28307,17631,17631,0,1.0,0.0
8808,28308,405,405,0,1.0,0.0
8809,28310,3459,3459,0,1.0,0.0
8810,28311,34567,30803,3764,0.891,0.109
8811,28312,18538,3732,14806,0.201,0.799
8812,28314,54520,54520,0,1.0,0.0
8813,28315,11681,7578,4103,0.649,0.351
8814,28318,4627,0,4627,0.0,1.0
8815,28320,9229,0,9229,0.0,1.0
8816,28323,3182,39,3143,0.012,0.988
8817,28325,508,428,80,0.843,0.157
8818,28326,17646,7354,10292,0.417,0.583
8819,28327,15433,3607,11826,0.234,0.766
8820,28328,27042,9538,17504,0.353,0.647
8821,28330,346,338,8,0.977,0.023
8822,28332,482,0,482,0.0,1.0
8823,28333,11830,5739,6091,0.485,0.515
8824,28334,24908,10486,14422,0.421,0.579
8825,28337,10670,3085,7585,0.289,0.711
8826,28338,4607,0,4607,0.0,1.0
8827,28339,6751,4337,2414,0.642,0.358
8828,28340,10765,2507,8258,0.233,0.767
8829,28341,4257,0,4257,0.0,1.0
8830,28342,298,0,298,0.0,1.0
8831,28343,1685,0,1685,0.0,1.0
8832,28344,3415,0,3415,0.0,1.0
8833,28345,12592,8417,4175,0.668,0.332
8834,28347,1983,0,1983,0.0,1.0
8835,28348,33307,29497,3810,0.886,0.114
8836,28349,3724,0,3724,0.0,1.0
8837,28350,305,0,305,0.0,1.0
8838,28351,4759,1313,3446,0.276,0.724
8839,28352,25641,17174,8467,0.67,0.33
8840,28356,5018,0,5018,0.0,1.0
8841,28357,3125,251,2874,0.08,0.92
8842,28358,38738,24357,14381,0.629,0.371
8843,28360,14263,6093,8170,0.427,0.573
8844,28363,1202,0,1202,0.0,1.0
8845,28364,14809,2674,12135,0.181,0.819
8846,28365,17144,4768,12376,0.278,0.722
8847,28366,5061,0,5061,0.0,1.0
8848,28367,87,0,87,0.0,1.0
8849,28369,2652,0,2652,0.0,1.0
8850,28371,6519,2716,3803,0.417,0.583
8851,28372,14783,6725,8058,0.455,0.545
8852,28373,2150,1247,903,0.58,0.42
8853,28374,15990,14292,1698,0.894,0.106
8854,28375,102,0,102,0.0,1.0
8855,28376,37991,25614,12377,0.674,0.326
8856,28377,12666,4185,8481,0.33,0.67
8857,28379,26388,16649,9739,0.631,0.369
8858,28382,7056,0,7056,0.0,1.0
8859,28383,8080,0,8080,0.0,1.0
8860,28384,12097,3288,8809,0.272,0.728
8861,28385,3029,0,3029,0.0,1.0
8862,28386,6319,0,6319,0.0,1.0
8863,28387,13921,12341,1580,0.887,0.113
8864,28390,19942,14445,5497,0.724,0.276
8865,28391,5302,0,5302,0.0,1.0
8866,28392,1579,0,1579,0.0,1.0
8867,28393,2005,0,2005,0.0,1.0
8868,28394,5164,0,5164,0.0,1.0
8869,28395,2375,0,2375,0.0,1.0
8870,28396,2732,0,2732,0.0,1.0
8871,28398,8112,3045,5067,0.375,0.625
8872,28399,2140,0,2140,0.0,1.0
8873,28401,22094,21678,416,0.981,0.019
8874,28403,36063,36063,0,1.0,0.0
8875,28405,29152,28843,309,0.989,0.011
8876,28409,31296,31296,0,1.0,0.0
8877,28411,31962,30581,1381,0.957,0.043
8878,28412,35573,34805,768,0.978,0.022
8879,28420,3886,8,3878,0.002,0.998
8880,28421,1521,0,1521,0.0,1.0
8881,28422,6641,0,6641,0.0,1.0
8882,28423,2290,0,2290,0.0,1.0
8883,28424,128,122,6,0.953,0.047
8884,28425,10906,3456,7450,0.317,0.683
8885,28428,6033,6033,0,1.0,0.0
8886,28429,8026,6131,1895,0.764,0.236
8887,28430,1900,0,1900,0.0,1.0
8888,28431,7102,0,7102,0.0,1.0
8889,28432,1968,0,1968,0.0,1.0
8890,28433,5050,0,5050,0.0,1.0
8891,28434,1329,0,1329,0.0,1.0
8892,28435,2490,0,2490,0.0,1.0
8893,28436,2203,0,2203,0.0,1.0
8894,28438,1845,0,1845,0.0,1.0
8895,28439,1595,0,1595,0.0,1.0
8896,28441,3198,0,3198,0.0,1.0
8897,28442,1647,0,1647,0.0,1.0
8898,28443,17512,10716,6796,0.612,0.388
8899,28444,2085,0,2085,0.0,1.0
8900,28445,5676,0,5676,0.0,1.0
8901,28447,1391,0,1391,0.0,1.0
8902,28448,1243,0,1243,0.0,1.0
8903,28449,1692,1692,0,1.0,0.0
8904,28450,2438,0,2438,0.0,1.0
8905,28451,27112,17782,9330,0.656,0.344
8906,28452,694,0,694,0.0,1.0
8907,28453,3829,0,3829,0.0,1.0
8908,28454,2545,0,2545,0.0,1.0
8909,28455,2117,0,2117,0.0,1.0
8910,28456,3658,0,3658,0.0,1.0
8911,28457,9905,726,9179,0.073,0.927
8912,28458,6444,0,6444,0.0,1.0
8913,28460,7652,3899,3753,0.51,0.49
8914,28461,16126,12191,3935,0.756,0.244
8915,28462,11680,3136,8544,0.268,0.732
8916,28463,9799,3828,5971,0.391,0.609
8917,28464,2457,359,2098,0.146,0.854
8918,28465,6531,6036,495,0.924,0.076
8919,28466,10103,3986,6117,0.395,0.605
8920,28467,8703,7302,1401,0.839,0.161
8921,28468,4375,3814,561,0.872,0.128
8922,28469,5839,3851,1988,0.66,0.34
8923,28470,10644,5304,5340,0.498,0.502
8924,28472,19658,7324,12334,0.373,0.627
8925,28478,4588,0,4588,0.0,1.0
8926,28479,4903,1854,3049,0.378,0.622
8927,28480,2473,2473,0,1.0,0.0
8928,28501,20389,14878,5511,0.73,0.27
8929,28504,21642,13168,8474,0.608,0.392
8930,28508,2737,0,2737,0.0,1.0
8931,28510,1502,0,1502,0.0,1.0
8932,28511,694,0,694,0.0,1.0
8933,28512,2896,2755,141,0.951,0.049
8934,28513,10346,5207,5139,0.503,0.497
8935,28515,2915,0,2915,0.0,1.0
8936,28516,11431,6172,5259,0.54,0.46
8937,28518,7909,0,7909,0.0,1.0
8938,28519,404,404,0,1.0,0.0
8939,28520,327,0,327,0.0,1.0
8940,28521,2287,0,2287,0.0,1.0
8941,28523,2456,0,2456,0.0,1.0
8942,28524,426,0,426,0.0,1.0
8943,28525,3132,0,3132,0.0,1.0
8944,28526,2489,0,2489,0.0,1.0
8945,28527,1140,0,1140,0.0,1.0
8946,28528,644,0,644,0.0,1.0
8947,28529,2193,0,2193,0.0,1.0
8948,28530,7332,3500,3832,0.477,0.523
8949,28531,1207,0,1207,0.0,1.0
8950,28532,23320,18632,4688,0.799,0.201
8951,28533,2952,2952,0,1.0,0.0
8952,28537,137,0,137,0.0,1.0
8953,28538,2175,0,2175,0.0,1.0
8954,28539,15469,12039,3430,0.778,0.222
8955,28540,49252,39519,9733,0.802,0.198
8956,28543,4699,4699,0,1.0,0.0
8957,28544,5368,5106,262,0.951,0.049
8958,28546,42696,38354,4342,0.898,0.102
8959,28547,21884,20216,1668,0.924,0.076
8960,28551,14093,3972,10121,0.282,0.718
8961,28552,254,0,254,0.0,1.0
8962,28553,454,0,454,0.0,1.0
8963,28554,243,0,243,0.0,1.0
8964,28555,5175,0,5175,0.0,1.0
8965,28556,963,0,963,0.0,1.0
8966,28557,14429,14175,254,0.982,0.018
8967,28560,28921,23233,5688,0.803,0.197
8968,28562,36176,29604,6572,0.818,0.182
8969,28570,21432,14504,6928,0.677,0.323
8970,28571,2585,0,2585,0.0,1.0
8971,28572,6531,0,6531,0.0,1.0
8972,28573,2176,0,2176,0.0,1.0
8973,28574,15102,2803,12299,0.186,0.814
8974,28575,316,285,31,0.902,0.098
8975,28577,522,0,522,0.0,1.0
8976,28578,6363,0,6363,0.0,1.0
8977,28579,622,0,622,0.0,1.0
8978,28580,12657,0,12657,0.0,1.0
8979,28581,214,0,214,0.0,1.0
8980,28582,1588,0,1588,0.0,1.0
8981,28583,281,0,281,0.0,1.0
8982,28584,11396,7548,3848,0.662,0.338
8983,28585,3942,0,3942,0.0,1.0
8984,28586,8218,0,8218,0.0,1.0
8985,28587,369,0,369,0.0,1.0
8986,28589,180,0,180,0.0,1.0
8987,28590,23407,20220,3187,0.864,0.136
8988,28594,3655,3655,0,1.0,0.0
8989,28601,50026,49045,981,0.98,0.02
8990,28602,28981,21403,7578,0.739,0.261
8991,28604,6249,0,6249,0.0,1.0
8992,28605,3412,0,3412,0.0,1.0
8993,28606,2158,0,2158,0.0,1.0
8994,28607,33059,22678,10381,0.686,0.314
8995,28609,5864,0,5864,0.0,1.0
8996,28610,9913,2798,7115,0.282,0.718
8997,28611,885,0,885,0.0,1.0
8998,28612,12397,5264,7133,0.425,0.575
8999,28613,22759,18925,3834,0.832,0.168
9000,28615,1876,0,1876,0.0,1.0
9001,28616,493,0,493,0.0,1.0
9002,28617,2261,0,2261,0.0,1.0
9003,28618,2352,0,2352,0.0,1.0
9004,28619,1520,1398,122,0.92,0.08
9005,28621,10472,4092,6380,0.391,0.609
9006,28622,2527,0,2527,0.0,1.0
9007,28623,1653,0,1653,0.0,1.0
9008,28624,1639,0,1639,0.0,1.0
9009,28625,36189,13621,22568,0.376,0.624
9010,28626,2714,0,2714,0.0,1.0
9011,28627,1152,0,1152,0.0,1.0
9012,28628,479,479,0,1.0,0.0
9013,28629,75,0,75,0.0,1.0
9014,28630,20041,11949,8092,0.596,0.404
9015,28631,637,0,637,0.0,1.0
9016,28634,5225,0,5225,0.0,1.0
9017,28635,3901,0,3901,0.0,1.0
9018,28636,5522,617,4905,0.112,0.888
9019,28637,1746,1746,0,1.0,0.0
9020,28638,12302,11246,1056,0.914,0.086
9021,28640,4719,1655,3064,0.351,0.649
9022,28642,5745,2355,3390,0.41,0.59
9023,28643,3521,0,3521,0.0,1.0
9024,28644,1494,0,1494,0.0,1.0
9025,28645,47703,29057,18646,0.609,0.391
9026,28646,342,0,342,0.0,1.0
9027,28647,89,0,89,0.0,1.0
9028,28649,993,0,993,0.0,1.0
9029,28650,11883,3913,7970,0.329,0.671
9030,28651,7132,1854,5278,0.26,0.74
9031,28652,46,0,46,0.0,1.0
9032,28654,3495,605,2890,0.173,0.827
9033,28655,54996,29382,25614,0.534,0.466
9034,28657,9488,0,9488,0.0,1.0
9035,28658,27022,17728,9294,0.656,0.344
9036,28659,21134,9377,11757,0.444,0.556
9037,28660,2249,0,2249,0.0,1.0
9038,28662,140,0,140,0.0,1.0
9039,28663,614,0,614,0.0,1.0
9040,28665,2571,60,2511,0.023,0.977
9041,28666,368,368,0,1.0,0.0
9042,28667,559,529,30,0.946,0.054
9043,28668,300,0,300,0.0,1.0
9044,28669,3146,0,3146,0.0,1.0
9045,28670,2719,11,2708,0.004,0.996
9046,28671,597,527,70,0.883,0.117
9047,28672,35,0,35,0.0,1.0
9048,28673,5919,1686,4233,0.285,0.715
9049,28675,6621,0,6621,0.0,1.0
9050,28676,3483,63,3420,0.018,0.982
9051,28677,32940,19241,13699,0.584,0.416
9052,28678,5226,0,5226,0.0,1.0
9053,28679,2064,0,2064,0.0,1.0
9054,28681,25910,7546,18364,0.291,0.709
9055,28682,1129,224,905,0.198,0.802
9056,28683,1697,0,1697,0.0,1.0
9057,28684,2141,0,2141,0.0,1.0
9058,28685,2076,0,2076,0.0,1.0
9059,28689,1712,0,1712,0.0,1.0
9060,28690,9295,7683,1612,0.827,0.173
9061,28692,4067,85,3982,0.021,0.979
9062,28693,1700,0,1700,0.0,1.0
9063,28694,7744,2474,5270,0.319,0.681
9064,28697,12930,6368,6562,0.492,0.508
9065,28698,2256,0,2256,0.0,1.0
9066,28701,3635,893,2742,0.246,0.754
9067,28702,366,0,366,0.0,1.0
9068,28704,18821,17376,1445,0.923,0.077
9069,28705,6715,0,6715,0.0,1.0
9070,28707,94,0,94,0.0,1.0
9071,28708,754,0,754,0.0,1.0
9072,28709,2225,0,2225,0.0,1.0
9073,28711,13209,9720,3489,0.736,0.264
9074,28712,19347,10462,8885,0.541,0.459
9075,28713,8686,0,8686,0.0,1.0
9076,28714,16753,0,16753,0.0,1.0
9077,28715,24582,16288,8294,0.663,0.337
9078,28716,17477,8625,8852,0.494,0.506
9079,28717,1729,0,1729,0.0,1.0
9080,28718,553,0,553,0.0,1.0
9081,28719,8048,0,8048,0.0,1.0
9082,28720,114,0,114,0.0,1.0
9083,28721,10063,4636,5427,0.461,0.539
9084,28722,6371,0,6371,0.0,1.0
9085,28723,11329,6332,4997,0.559,0.441
9086,28725,43,29,14,0.674,0.326
9087,28726,3203,3200,3,0.999,0.001
9088,28729,2894,2219,675,0.767,0.233
9089,28730,9133,3361,5772,0.368,0.632
9090,28731,7778,4351,3427,0.559,0.441
9091,28732,16491,12416,4075,0.753,0.247
9092,28733,21,0,21,0.0,1.0
9093,28734,27040,6781,20259,0.251,0.749
9094,28735,256,0,256,0.0,1.0
9095,28736,787,0,787,0.0,1.0
9096,28739,19786,13508,6278,0.683,0.317
9097,28740,1364,0,1364,0.0,1.0
9098,28741,3197,0,3197,0.0,1.0
9099,28742,2710,873,1837,0.322,0.678
9100,28743,2125,0,2125,0.0,1.0
9101,28745,551,545,6,0.989,0.011
9102,28746,2388,0,2388,0.0,1.0
9103,28747,2198,0,2198,0.0,1.0
9104,28748,11334,2966,8368,0.262,0.738
9105,28749,50,0,50,0.0,1.0
9106,28751,2916,0,2916,0.0,1.0
9107,28752,30600,13004,17596,0.425,0.575
9108,28753,11670,0,11670,0.0,1.0
9109,28754,7679,1948,5731,0.254,0.746
9110,28756,4504,0,4504,0.0,1.0
9111,28757,280,151,129,0.539,0.461
9112,28759,6922,2834,4088,0.409,0.591
9113,28761,7816,359,7457,0.046,0.954
9114,28762,6857,0,6857,0.0,1.0
9115,28763,2725,0,2725,0.0,1.0
9116,28766,1262,0,1262,0.0,1.0
9117,28768,6813,2601,4212,0.382,0.618
9118,28771,8558,0,8558,0.0,1.0
9119,28772,1239,223,1016,0.18,0.82
9120,28773,3378,0,3378,0.0,1.0
9121,28774,1013,0,1013,0.0,1.0
9122,28775,296,0,296,0.0,1.0
9123,28777,10638,4700,5938,0.442,0.558
9124,28778,10381,7850,2531,0.756,0.244
9125,28779,16111,4476,11635,0.278,0.722
9126,28781,939,0,939,0.0,1.0
9127,28782,6584,1585,4999,0.241,0.759
9128,28783,1593,0,1593,0.0,1.0
9129,28785,7338,802,6536,0.109,0.891
9130,28786,20714,11698,9016,0.565,0.435
9131,28787,19718,9312,10406,0.472,0.528
9132,28789,5097,0,5097,0.0,1.0
9133,28790,3205,188,3017,0.059,0.941
9134,28791,14171,14118,53,0.996,0.004
9135,28792,32689,20366,12323,0.623,0.377
9136,28801,15019,15019,0,1.0,0.0
9137,28803,28693,25680,3013,0.895,0.105
9138,28804,20507,17838,2669,0.87,0.13
9139,28805,17620,14848,2772,0.843,0.157
9140,28806,38550,36854,1696,0.956,0.044
9141,28901,5354,0,5354,0.0,1.0
9142,28902,1373,0,1373,0.0,1.0
9143,28904,8533,0,8533,0.0,1.0
9144,28905,3129,0,3129,0.0,1.0
9145,28906,18475,0,18475,0.0,1.0
9146,28909,1030,0,1030,0.0,1.0
9147,29001,2148,0,2148,0.0,1.0
9148,29003,6989,3492,3497,0.5,0.5
9149,29006,9565,3429,6136,0.358,0.642
9150,29009,2440,0,2440,0.0,1.0
9151,29010,13491,5391,8100,0.4,0.6
9152,29014,1891,0,1891,0.0,1.0
9153,29015,1738,0,1738,0.0,1.0
9154,29016,16393,8864,7529,0.541,0.459
9155,29018,3749,0,3749,0.0,1.0
9156,29020,22463,13464,8999,0.599,0.401
9157,29030,1967,0,1967,0.0,1.0
9158,29031,1349,0,1349,0.0,1.0
9159,29032,4424,82,4342,0.019,0.981
9160,29033,11603,11546,57,0.995,0.005
9161,29036,19140,13750,5390,0.718,0.282
9162,29037,824,0,824,0.0,1.0
9163,29038,2445,0,2445,0.0,1.0
9164,29039,4215,1970,2245,0.467,0.533
9165,29040,8767,4934,3833,0.563,0.437
9166,29042,5868,3781,2087,0.644,0.356
9167,29044,5652,0,5652,0.0,1.0
9168,29045,21871,12171,9700,0.556,0.444
9169,29046,237,0,237,0.0,1.0
9170,29047,3683,0,3683,0.0,1.0
9171,29048,4864,0,4864,0.0,1.0
9172,29051,951,0,951,0.0,1.0
9173,29052,2021,0,2021,0.0,1.0
9174,29053,18830,8191,10639,0.435,0.565
9175,29054,9612,0,9612,0.0,1.0
9176,29055,4337,0,4337,0.0,1.0
9177,29056,2448,0,2448,0.0,1.0
9178,29058,4746,131,4615,0.028,0.972
9179,29059,6068,0,6068,0.0,1.0
9180,29061,13717,3806,9911,0.277,0.723
9181,29062,176,0,176,0.0,1.0
9182,29063,32717,31013,1704,0.948,0.052
9183,29065,677,0,677,0.0,1.0
9184,29067,10949,0,10949,0.0,1.0
9185,29069,5020,0,5020,0.0,1.0
9186,29070,15330,1838,13492,0.12,0.88
9187,29072,49566,45637,3929,0.921,0.079
9188,29073,40775,31800,8975,0.78,0.22
9189,29074,241,0,241,0.0,1.0
9190,29075,2963,0,2963,0.0,1.0
9191,29078,15293,7821,7472,0.511,0.489
9192,29079,151,0,151,0.0,1.0
9193,29080,3240,0,3240,0.0,1.0
9194,29081,1352,0,1352,0.0,1.0
9195,29082,572,0,572,0.0,1.0
9196,29101,3023,0,3023,0.0,1.0
9197,29102,18248,4998,13250,0.274,0.726
9198,29104,1531,0,1531,0.0,1.0
9199,29105,1514,0,1514,0.0,1.0
9200,29107,3166,0,3166,0.0,1.0
9201,29108,20469,12046,8423,0.588,0.412
9202,29111,1632,0,1632,0.0,1.0
9203,29112,4712,0,4712,0.0,1.0
9204,29113,1618,0,1618,0.0,1.0
9205,29114,2190,0,2190,0.0,1.0
9206,29115,31128,20782,10346,0.668,0.332
9207,29117,1160,1160,0,1.0,0.0
9208,29118,15861,9594,6267,0.605,0.395
9209,29122,54,0,54,0.0,1.0
9210,29123,7617,0,7617,0.0,1.0
9211,29125,3072,0,3072,0.0,1.0
9212,29126,2267,0,2267,0.0,1.0
9213,29127,8333,0,8333,0.0,1.0
9214,29128,5866,0,5866,0.0,1.0
9215,29129,3164,0,3164,0.0,1.0
9216,29130,6655,0,6655,0.0,1.0
9217,29133,1044,0,1044,0.0,1.0
9218,29135,8919,0,8919,0.0,1.0
9219,29137,2539,0,2539,0.0,1.0
9220,29138,10883,3528,7355,0.324,0.676
9221,29142,4890,0,4890,0.0,1.0
9222,29145,837,0,837,0.0,1.0
9223,29146,1767,0,1767,0.0,1.0
9224,29147,0,0,0,,
9225,29148,6230,0,6230,0.0,1.0
9226,29150,40031,37266,2765,0.931,0.069
9227,29152,2393,2358,35,0.985,0.015
9228,29153,15633,7218,8415,0.462,0.538
9229,29154,28135,20483,7652,0.728,0.272
9230,29160,8255,0,8255,0.0,1.0
9231,29161,11383,2799,8584,0.246,0.754
9232,29162,4122,0,4122,0.0,1.0
9233,29163,1975,0,1975,0.0,1.0
9234,29164,4690,0,4690,0.0,1.0
9235,29166,904,0,904,0.0,1.0
9236,29168,3582,848,2734,0.237,0.763
9237,29169,22845,22845,0,1.0,0.0
9238,29170,19988,19147,841,0.958,0.042
9239,29172,9293,7864,1429,0.846,0.154
9240,29175,378,0,378,0.0,1.0
9241,29178,3377,0,3377,0.0,1.0
9242,29180,14267,5141,9126,0.36,0.64
9243,29201,20594,20594,0,1.0,0.0
9244,29202,135,135,0,1.0,0.0
9245,29203,39843,36489,3354,0.916,0.084
9246,29204,19952,19952,0,1.0,0.0
9247,29205,24822,24822,0,1.0,0.0
9248,29206,17788,17788,0,1.0,0.0
9249,29207,11592,11570,22,0.998,0.002
9250,29208,695,695,0,1.0,0.0
9251,29209,33324,32926,398,0.988,0.012
9252,29210,40356,40356,0,1.0,0.0
9253,29212,28798,28184,614,0.979,0.021
9254,29223,50141,50141,0,1.0,0.0
9255,29225,1228,1228,0,1.0,0.0
9256,29229,44229,44068,161,0.996,0.004
9257,29301,31051,30745,306,0.99,0.01
9258,29302,16571,13616,2955,0.822,0.178
9259,29303,25058,22997,2061,0.918,0.082
9260,29306,15861,13981,1880,0.881,0.119
9261,29307,18751,14983,3768,0.799,0.201
9262,29316,22281,21666,615,0.972,0.028
9263,29320,530,530,0,1.0,0.0
9264,29321,2596,667,1929,0.257,0.743
9265,29322,8781,501,8280,0.057,0.943
9266,29323,14446,4957,9489,0.343,0.657
9267,29324,167,167,0,1.0,0.0
9268,29325,15222,9930,5292,0.652,0.348
9269,29329,278,278,0,1.0,0.0
9270,29330,8401,3423,4978,0.407,0.593
9271,29331,142,0,142,0.0,1.0
9272,29332,2435,0,2435,0.0,1.0
9273,29333,374,374,0,1.0,0.0
9274,29334,11331,9719,1612,0.858,0.142
9275,29335,5654,0,5654,0.0,1.0
9276,29338,85,0,85,0.0,1.0
9277,29340,20763,11165,9598,0.538,0.462
9278,29341,19330,9679,9651,0.501,0.499
9279,29346,307,307,0,1.0,0.0
9280,29349,30129,19468,10661,0.646,0.354
9281,29351,1563,1246,317,0.797,0.203
9282,29353,4174,0,4174,0.0,1.0
9283,29355,810,0,810,0.0,1.0
9284,29356,8074,2654,5420,0.329,0.671
9285,29360,20977,10336,10641,0.493,0.507
9286,29364,592,0,592,0.0,1.0
9287,29365,10146,7713,2433,0.76,0.24
9288,29368,68,68,0,1.0,0.0
9289,29369,13044,10910,2134,0.836,0.164
9290,29370,1045,0,1045,0.0,1.0
9291,29372,4507,0,4507,0.0,1.0
9292,29373,297,0,297,0.0,1.0
9293,29374,3534,0,3534,0.0,1.0
9294,29375,95,95,0,1.0,0.0
9295,29376,6909,3109,3800,0.45,0.55
9296,29377,761,761,0,1.0,0.0
9297,29378,207,207,0,1.0,0.0
9298,29379,19186,9366,9820,0.488,0.512
9299,29384,3945,0,3945,0.0,1.0
9300,29385,7221,5861,1360,0.812,0.188
9301,29388,14470,5608,8862,0.388,0.612
9302,29401,10895,10895,0,1.0,0.0
9303,29403,20818,20818,0,1.0,0.0
9304,29404,1348,1348,0,1.0,0.0
9305,29405,26328,26328,0,1.0,0.0
9306,29406,29314,29314,0,1.0,0.0
9307,29407,34827,34827,0,1.0,0.0
9308,29409,2100,2100,0,1.0,0.0
9309,29410,17816,17774,42,0.998,0.002
9310,29412,35850,35356,494,0.986,0.014
9311,29414,31883,30821,1062,0.967,0.033
9312,29418,23540,23540,0,1.0,0.0
9313,29420,21834,21830,4,1.0,0.0
9314,29423,956,956,0,1.0,0.0
9315,29424,389,389,0,1.0,0.0
9316,29426,1741,0,1741,0.0,1.0
9317,29429,2737,346,2391,0.126,0.874
9318,29431,6071,0,6071,0.0,1.0
9319,29432,2853,0,2853,0.0,1.0
9320,29434,537,0,537,0.0,1.0
9321,29435,4122,0,4122,0.0,1.0
9322,29436,4471,0,4471,0.0,1.0
9323,29437,2380,0,2380,0.0,1.0
9324,29438,2408,0,2408,0.0,1.0
9325,29439,2399,2218,181,0.925,0.075
9326,29440,28469,12320,16149,0.433,0.567
9327,29445,53588,52622,966,0.982,0.018
9328,29446,1138,0,1138,0.0,1.0
9329,29448,2356,0,2356,0.0,1.0
9330,29449,7749,0,7749,0.0,1.0
9331,29450,3105,0,3105,0.0,1.0
9332,29451,4205,3794,411,0.902,0.098
9333,29452,394,0,394,0.0,1.0
9334,29453,1252,0,1252,0.0,1.0
9335,29455,20478,8128,12350,0.397,0.603
9336,29456,27864,27749,115,0.996,0.004
9337,29458,2713,0,2713,0.0,1.0
9338,29461,30141,15283,14858,0.507,0.493
9339,29464,43649,43164,485,0.989,0.011
9340,29466,28725,28547,178,0.994,0.006
9341,29468,2107,0,2107,0.0,1.0
9342,29469,855,0,855,0.0,1.0
9343,29470,4232,48,4184,0.011,0.989
9344,29471,1537,0,1537,0.0,1.0
9345,29472,9416,0,9416,0.0,1.0
9346,29474,2176,0,2176,0.0,1.0
9347,29475,2874,0,2874,0.0,1.0
9348,29477,6789,0,6789,0.0,1.0
9349,29479,7337,0,7337,0.0,1.0
9350,29481,1841,0,1841,0.0,1.0
9351,29482,1791,1791,0,1.0,0.0
9352,29483,66731,57559,9172,0.863,0.137
9353,29485,45057,43754,1303,0.971,0.029
9354,29487,2725,0,2725,0.0,1.0
9355,29488,22220,9502,12718,0.428,0.572
9356,29492,10262,7105,3157,0.692,0.308
9357,29493,117,0,117,0.0,1.0
9358,29501,43220,39837,3383,0.922,0.078
9359,29505,24279,19293,4986,0.795,0.205
9360,29506,20960,13995,6965,0.668,0.332
9361,29510,11060,3903,7157,0.353,0.647
9362,29511,5146,0,5146,0.0,1.0
9363,29512,19514,13006,6508,0.666,0.334
9364,29516,829,0,829,0.0,1.0
9365,29518,1232,6,1226,0.005,0.995
9366,29519,285,0,285,0.0,1.0
9367,29520,14617,8160,6457,0.558,0.442
9368,29525,2029,0,2029,0.0,1.0
9369,29526,39033,21733,17300,0.557,0.443
9370,29527,22027,8854,13173,0.402,0.598
9371,29530,2915,0,2915,0.0,1.0
9372,29532,20871,11601,9270,0.556,0.444
9373,29536,17722,9777,7945,0.552,0.448
9374,29540,5599,179,5420,0.032,0.968
9375,29541,9465,1853,7612,0.196,0.804
9376,29543,606,0,606,0.0,1.0
9377,29544,4909,0,4909,0.0,1.0
9378,29545,1657,0,1657,0.0,1.0
9379,29546,2834,0,2834,0.0,1.0
9380,29547,2917,0,2917,0.0,1.0
9381,29550,32284,15125,17159,0.468,0.532
9382,29554,9332,0,9332,0.0,1.0
9383,29555,6440,0,6440,0.0,1.0
9384,29556,12870,6095,6775,0.474,0.526
9385,29560,13664,7505,6159,0.549,0.451
9386,29563,2676,0,2676,0.0,1.0
9387,29564,985,0,985,0.0,1.0
9388,29565,7127,0,7127,0.0,1.0
9389,29566,15179,12234,2945,0.806,0.194
9390,29567,564,0,564,0.0,1.0
9391,29568,12224,1372,10852,0.112,0.888
9392,29569,15951,6,15945,0.0,1.0
9393,29570,3913,0,3913,0.0,1.0
9394,29571,15622,7464,8158,0.478,0.522
9395,29572,7893,7840,53,0.993,0.007
9396,29574,11909,5512,6397,0.463,0.537
9397,29575,15512,15512,0,1.0,0.0
9398,29576,24446,22347,2099,0.914,0.086
9399,29577,26996,26996,0,1.0,0.0
9400,29579,32180,30891,1289,0.96,0.04
9401,29580,1450,0,1450,0.0,1.0
9402,29581,4650,0,4650,0.0,1.0
9403,29582,14622,13960,662,0.955,0.045
9404,29583,5438,0,5438,0.0,1.0
9405,29584,2563,0,2563,0.0,1.0
9406,29585,13606,11532,2074,0.848,0.152
9407,29588,36499,33286,3213,0.912,0.088
9408,29590,3677,0,3677,0.0,1.0
9409,29591,5467,985,4482,0.18,0.82
9410,29592,1197,0,1197,0.0,1.0
9411,29593,1954,0,1954,0.0,1.0
9412,29594,121,0,121,0.0,1.0
9413,29596,2424,0,2424,0.0,1.0
9414,29601,10550,10550,0,1.0,0.0
9415,29605,34414,34142,272,0.992,0.008
9416,29607,34487,34127,360,0.99,0.01
9417,29609,27722,25939,1783,0.936,0.064
9418,29611,28799,27626,1173,0.959,0.041
9419,29613,2334,2334,0,1.0,0.0
9420,29614,2720,2720,0,1.0,0.0
9421,29615,35151,35151,0,1.0,0.0
9422,29617,25685,23996,1689,0.934,0.066
9423,29620,12934,5341,7593,0.413,0.587
9424,29621,39101,33150,5951,0.848,0.152
9425,29624,14610,12225,2385,0.837,0.163
9426,29625,27538,22587,4951,0.82,0.18
9427,29626,12364,5915,6449,0.478,0.522
9428,29627,18367,6860,11507,0.373,0.627
9429,29628,2759,0,2759,0.0,1.0
9430,29630,14186,8365,5821,0.59,0.41
9431,29631,13318,13200,118,0.991,0.009
9432,29634,5589,5589,0,1.0,0.0
9433,29635,1254,0,1254,0.0,1.0
9434,29638,2944,0,2944,0.0,1.0
9435,29639,1742,0,1742,0.0,1.0
9436,29640,30574,20282,10292,0.663,0.337
9437,29642,29561,23888,5673,0.808,0.192
9438,29643,2756,0,2756,0.0,1.0
9439,29644,18578,9011,9567,0.485,0.515
9440,29645,9982,0,9982,0.0,1.0
9441,29646,28159,20511,7648,0.728,0.272
9442,29649,26235,21282,4953,0.811,0.189
9443,29650,32632,32626,6,1.0,0.0
9444,29651,42844,34775,8069,0.812,0.188
9445,29653,4811,212,4599,0.044,0.956
9446,29654,9937,3505,6432,0.353,0.647
9447,29655,7796,0,7796,0.0,1.0
9448,29657,15116,6639,8477,0.439,0.561
9449,29658,333,0,333,0.0,1.0
9450,29659,118,0,118,0.0,1.0
9451,29661,5648,1421,4227,0.252,0.748
9452,29662,15090,15090,0,1.0,0.0
9453,29664,1808,0,1808,0.0,1.0
9454,29665,127,101,26,0.795,0.205
9455,29666,6590,0,6590,0.0,1.0
9456,29667,269,237,32,0.881,0.119
9457,29669,12387,3545,8842,0.286,0.714
9458,29670,8673,3930,4743,0.453,0.547
9459,29671,18030,5417,12613,0.3,0.7
9460,29672,11868,7572,4296,0.638,0.362
9461,29673,25348,15327,10021,0.605,0.395
9462,29676,5201,0,5201,0.0,1.0
9463,29678,21676,13444,8232,0.62,0.38
9464,29680,27285,24416,2869,0.895,0.105
9465,29681,46979,45084,1895,0.96,0.04
9466,29682,3818,0,3818,0.0,1.0
9467,29683,291,291,0,1.0,0.0
9468,29684,4862,490,4372,0.101,0.899
9469,29685,1230,0,1230,0.0,1.0
9470,29686,1027,0,1027,0.0,1.0
9471,29687,39561,36810,2751,0.93,0.07
9472,29689,3889,0,3889,0.0,1.0
9473,29690,20914,7359,13555,0.352,0.648
9474,29691,11333,4378,6955,0.386,0.614
9475,29692,4856,0,4856,0.0,1.0
9476,29693,14215,0,14215,0.0,1.0
9477,29696,4125,559,3566,0.136,0.864
9478,29697,12207,7143,5064,0.585,0.415
9479,29702,10059,0,10059,0.0,1.0
9480,29704,3721,1193,2528,0.321,0.679
9481,29706,19847,9351,10496,0.471,0.529
9482,29707,17742,14320,3422,0.807,0.193
9483,29708,25035,24567,468,0.981,0.019
9484,29709,6498,0,6498,0.0,1.0
9485,29710,29449,15428,14021,0.524,0.476
9486,29712,2317,0,2317,0.0,1.0
9487,29714,2927,0,2927,0.0,1.0
9488,29715,24823,23475,1348,0.946,0.054
9489,29717,1251,0,1251,0.0,1.0
9490,29718,3856,0,3856,0.0,1.0
9491,29720,46041,23910,22131,0.519,0.481
9492,29724,43,0,43,0.0,1.0
9493,29726,1750,0,1750,0.0,1.0
9494,29727,1650,0,1650,0.0,1.0
9495,29728,10301,4100,6201,0.398,0.602
9496,29729,2271,0,2271,0.0,1.0
9497,29730,52365,43475,8890,0.83,0.17
9498,29732,53781,51241,2540,0.953,0.047
9499,29733,1751,1751,0,1.0,0.0
9500,29741,2082,0,2082,0.0,1.0
9501,29742,2460,0,2460,0.0,1.0
9502,29743,1071,0,1071,0.0,1.0
9503,29745,28919,13048,15871,0.451,0.549
9504,29801,26778,19798,6980,0.739,0.261
9505,29803,36843,25059,11784,0.68,0.32
9506,29805,5864,289,5575,0.049,0.951
9507,29809,2206,1587,619,0.719,0.281
9508,29810,4990,3307,1683,0.663,0.337
9509,29812,11864,3949,7915,0.333,0.667
9510,29816,1033,981,52,0.95,0.05
9511,29817,4913,0,4913,0.0,1.0
9512,29819,1523,0,1523,0.0,1.0
9513,29821,1487,0,1487,0.0,1.0
9514,29824,8535,4562,3973,0.535,0.465
9515,29826,164,0,164,0.0,1.0
9516,29827,4624,0,4624,0.0,1.0
9517,29828,1003,1003,0,1.0,0.0
9518,29829,8651,4335,4316,0.501,0.499
9519,29831,4146,0,4146,0.0,1.0
9520,29832,5335,0,5335,0.0,1.0
9521,29834,1687,1635,52,0.969,0.031
9522,29835,6566,0,6566,0.0,1.0
9523,29836,482,0,482,0.0,1.0
9524,29838,501,0,501,0.0,1.0
9525,29840,251,0,251,0.0,1.0
9526,29841,32494,31583,911,0.972,0.028
9527,29842,7675,2528,5147,0.329,0.671
9528,29843,1291,0,1291,0.0,1.0
9529,29844,123,0,123,0.0,1.0
9530,29845,1104,0,1104,0.0,1.0
9531,29847,5480,0,5480,0.0,1.0
9532,29848,751,0,751,0.0,1.0
9533,29849,294,0,294,0.0,1.0
9534,29850,111,0,111,0.0,1.0
9535,29851,7524,5679,1845,0.755,0.245
9536,29853,6580,0,6580,0.0,1.0
9537,29856,3255,0,3255,0.0,1.0
9538,29860,14450,9027,5423,0.625,0.375
9539,29899,1244,0,1244,0.0,1.0
9540,29902,14779,13936,843,0.943,0.057
9541,29904,659,659,0,1.0,0.0
9542,29905,3054,2957,97,0.968,0.032
9543,29906,21765,19706,2059,0.905,0.095
9544,29907,12570,7864,4706,0.626,0.374
9545,29909,16394,12531,3863,0.764,0.236
9546,29910,33954,29527,4427,0.87,0.13
9547,29911,1725,0,1725,0.0,1.0
9548,29912,42,0,42,0.0,1.0
9549,29915,416,0,416,0.0,1.0
9550,29916,1533,0,1533,0.0,1.0
9551,29918,5278,0,5278,0.0,1.0
9552,29920,9481,0,9481,0.0,1.0
9553,29921,227,0,227,0.0,1.0
9554,29922,1214,0,1214,0.0,1.0
9555,29923,392,0,392,0.0,1.0
9556,29924,4331,2522,1809,0.582,0.418
9557,29926,23742,23388,354,0.985,0.015
9558,29927,8237,2957,5280,0.359,0.641
9559,29928,16110,16107,3,1.0,0.0
9560,29929,1135,0,1135,0.0,1.0
9561,29932,269,0,269,0.0,1.0
9562,29934,1172,0,1172,0.0,1.0
9563,29935,3685,3685,0,1.0,0.0
9564,29936,13354,5301,8053,0.397,0.603
9565,29939,302,0,302,0.0,1.0
9566,29940,3967,0,3967,0.0,1.0
9567,29941,497,0,497,0.0,1.0
9568,29943,477,0,477,0.0,1.0
9569,29944,5118,2018,3100,0.394,0.606
9570,29945,4841,0,4841,0.0,1.0
9571,30002,5861,5861,0,1.0,0.0
9572,30004,53033,49414,3619,0.932,0.068
9573,30005,34442,34442,0,1.0,0.0
9574,30008,29822,29822,0,1.0,0.0
9575,30009,13722,13722,0,1.0,0.0
9576,30011,14402,11285,3117,0.784,0.216
9577,30012,27258,21891,5367,0.803,0.197
9578,30013,25183,23457,1726,0.931,0.069
9579,30014,35037,20648,14389,0.589,0.411
9580,30016,51140,43668,7472,0.854,0.146
9581,30017,20160,20160,0,1.0,0.0
9582,30019,40447,37974,2473,0.939,0.061
9583,30021,21989,21989,0,1.0,0.0
9584,30022,64359,64359,0,1.0,0.0
9585,30024,64614,64614,0,1.0,0.0
9586,30025,9270,3328,5942,0.359,0.641
9587,30028,22182,14755,7427,0.665,0.335
9588,30030,26473,26473,0,1.0,0.0
9589,30032,47222,47222,0,1.0,0.0
9590,30033,30763,30763,0,1.0,0.0
9591,30034,43113,43113,0,1.0,0.0
9592,30035,20396,20396,0,1.0,0.0
9593,30038,37233,35905,1328,0.964,0.036
9594,30039,41517,41287,230,0.994,0.006
9595,30040,54653,51538,3115,0.943,0.057
9596,30041,52749,49150,3599,0.932,0.068
9597,30043,80241,80241,0,1.0,0.0
9598,30044,79701,79701,0,1.0,0.0
9599,30045,34402,33834,568,0.983,0.017
9600,30046,34523,34523,0,1.0,0.0
9601,30047,59660,59660,0,1.0,0.0
9602,30052,59451,50983,8468,0.858,0.142
9603,30054,11985,2902,9083,0.242,0.758
9604,30055,3018,0,3018,0.0,1.0
9605,30056,2500,0,2500,0.0,1.0
9606,30058,52945,52523,422,0.992,0.008
9607,30060,34562,34562,0,1.0,0.0
9608,30062,62136,62136,0,1.0,0.0
9609,30064,46076,46076,0,1.0,0.0
9610,30066,52936,52936,0,1.0,0.0
9611,30067,45182,45182,0,1.0,0.0
9612,30068,31595,31595,0,1.0,0.0
9613,30070,342,342,0,1.0,0.0
9614,30071,23005,23005,0,1.0,0.0
9615,30072,730,730,0,1.0,0.0
9616,30075,52573,52573,0,1.0,0.0
9617,30076,42678,42678,0,1.0,0.0
9618,30078,33057,33057,0,1.0,0.0
9619,30079,2960,2960,0,1.0,0.0
9620,30080,49905,49905,0,1.0,0.0
9621,30082,25905,25905,0,1.0,0.0
9622,30083,50384,50384,0,1.0,0.0
9623,30084,35921,35921,0,1.0,0.0
9624,30087,36761,36761,0,1.0,0.0
9625,30088,25257,25257,0,1.0,0.0
9626,30092,31704,31704,0,1.0,0.0
9627,30093,53351,53351,0,1.0,0.0
9628,30094,31244,28845,2399,0.923,0.077
9629,30096,62265,62265,0,1.0,0.0
9630,30097,41715,41715,0,1.0,0.0
9631,30101,54373,52344,2029,0.963,0.037
9632,30102,37470,36762,708,0.981,0.019
9633,30103,14781,4920,9861,0.333,0.667
9634,30104,4708,1361,3347,0.289,0.711
9635,30105,2294,0,2294,0.0,1.0
9636,30106,20300,20300,0,1.0,0.0
9637,30107,12908,3067,9841,0.238,0.762
9638,30108,7256,0,7256,0.0,1.0
9639,30110,13349,6504,6845,0.487,0.513
9640,30113,6218,0,6218,0.0,1.0
9641,30114,49774,40462,9312,0.813,0.187
9642,30115,35672,27604,8068,0.774,0.226
9643,30116,23156,12840,10316,0.554,0.446
9644,30117,34296,22996,11300,0.671,0.329
9645,30118,2373,2373,0,1.0,0.0
9646,30120,38085,30039,8046,0.789,0.211
9647,30121,22078,18818,3260,0.852,0.148
9648,30122,21561,20415,1146,0.947,0.053
9649,30124,2978,0,2978,0.0,1.0
9650,30125,24352,12543,11809,0.515,0.485
9651,30126,37088,37088,0,1.0,0.0
9652,30127,60347,60158,189,0.997,0.003
9653,30132,34215,22215,12000,0.649,0.351
9654,30134,43356,41198,2158,0.95,0.05
9655,30135,61912,54584,7328,0.882,0.118
9656,30137,1650,1144,506,0.693,0.307
9657,30139,3845,0,3845,0.0,1.0
9658,30141,22457,20515,1942,0.914,0.086
9659,30143,21145,6021,15124,0.285,0.715
9660,30144,52252,52252,0,1.0,0.0
9661,30145,8378,2396,5982,0.286,0.714
9662,30147,4365,2389,1976,0.547,0.453
9663,30148,453,0,453,0.0,1.0
9664,30149,1569,1435,134,0.915,0.085
9665,30152,40393,40393,0,1.0,0.0
9666,30153,18411,9044,9367,0.491,0.509
9667,30157,45123,38798,6325,0.86,0.14
9668,30161,35058,24089,10969,0.687,0.313
9669,30164,16,0,16,0.0,1.0
9670,30165,39975,30039,9936,0.751,0.249
9671,30168,24241,24206,35,0.999,0.001
9672,30170,2994,0,2994,0.0,1.0
9673,30171,3491,0,3491,0.0,1.0
9674,30173,6221,2899,3322,0.466,0.534
9675,30175,6074,1100,4974,0.181,0.819
9676,30176,7050,0,7050,0.0,1.0
9677,30177,1049,795,254,0.758,0.242
9678,30178,3468,0,3468,0.0,1.0
9679,30179,16807,5805,11002,0.345,0.655
9680,30180,34274,24652,9622,0.719,0.281
9681,30182,2666,12,2654,0.005,0.995
9682,30183,5282,0,5282,0.0,1.0
9683,30184,6847,642,6205,0.094,0.906
9684,30185,3892,0,3892,0.0,1.0
9685,30187,8740,1797,6943,0.206,0.794
9686,30188,52380,50830,1550,0.97,0.03
9687,30189,36859,36859,0,1.0,0.0
9688,30204,13493,7167,6326,0.531,0.469
9689,30205,3061,0,3061,0.0,1.0
9690,30206,2958,0,2958,0.0,1.0
9691,30213,29384,25241,4143,0.859,0.141
9692,30214,28913,24394,4519,0.844,0.156
9693,30215,33665,23372,10293,0.694,0.306
9694,30216,2159,0,2159,0.0,1.0
9695,30217,9433,0,9433,0.0,1.0
9696,30218,1974,0,1974,0.0,1.0
9697,30220,5533,2571,2962,0.465,0.535
9698,30222,4042,0,4042,0.0,1.0
9699,30223,36769,20296,16473,0.552,0.448
9700,30224,25197,16144,9053,0.641,0.359
9701,30228,38569,30835,7734,0.799,0.201
9702,30230,9103,0,9103,0.0,1.0
9703,30233,23218,5431,17787,0.234,0.766
9704,30234,1934,0,1934,0.0,1.0
9705,30236,46434,45838,596,0.987,0.013
9706,30238,34713,34512,201,0.994,0.006
9707,30240,30014,18952,11062,0.631,0.369
9708,30241,23176,15927,7249,0.687,0.313
9709,30248,23249,15620,7629,0.672,0.328
9710,30250,679,679,0,1.0,0.0
9711,30251,2342,0,2342,0.0,1.0
9712,30252,41428,30601,10827,0.739,0.261
9713,30253,49380,46742,2638,0.947,0.053
9714,30256,2826,0,2826,0.0,1.0
9715,30257,4138,0,4138,0.0,1.0
9716,30258,2622,0,2622,0.0,1.0
9717,30259,3041,0,3041,0.0,1.0
9718,30260,23244,23244,0,1.0,0.0
9719,30263,53008,34016,18992,0.642,0.358
9720,30265,31713,28885,2828,0.911,0.089
9721,30268,9090,5025,4065,0.553,0.447
9722,30269,35069,34128,941,0.973,0.027
9723,30273,14709,14709,0,1.0,0.0
9724,30274,31893,31893,0,1.0,0.0
9725,30275,19,0,19,0.0,1.0
9726,30276,13866,3659,10207,0.264,0.736
9727,30277,20270,15970,4300,0.788,0.212
9728,30281,66140,61889,4251,0.936,0.064
9729,30284,55,42,13,0.764,0.236
9730,30285,707,0,707,0.0,1.0
9731,30286,23490,14416,9074,0.614,0.386
9732,30288,8929,8929,0,1.0,0.0
9733,30289,82,42,40,0.512,0.488
9734,30290,8286,7396,890,0.893,0.107
9735,30291,21010,20802,208,0.99,0.01
9736,30292,5943,64,5879,0.011,0.989
9737,30293,2981,0,2981,0.0,1.0
9738,30294,39865,39865,0,1.0,0.0
9739,30295,4159,0,4159,0.0,1.0
9740,30296,25840,25840,0,1.0,0.0
9741,30297,27188,27188,0,1.0,0.0
9742,30303,5934,5934,0,1.0,0.0
9743,30305,22999,22999,0,1.0,0.0
9744,30306,22246,22246,0,1.0,0.0
9745,30307,18004,18004,0,1.0,0.0
9746,30308,15413,15413,0,1.0,0.0
9747,30309,21845,21845,0,1.0,0.0
9748,30310,26912,26912,0,1.0,0.0
9749,30311,32218,32218,0,1.0,0.0
9750,30312,19360,19360,0,1.0,0.0
9751,30313,9495,9495,0,1.0,0.0
9752,30314,22020,22020,0,1.0,0.0
9753,30315,33857,33857,0,1.0,0.0
9754,30316,31110,31110,0,1.0,0.0
9755,30317,11970,11970,0,1.0,0.0
9756,30318,49736,49736,0,1.0,0.0
9757,30319,38423,38423,0,1.0,0.0
9758,30322,2023,2023,0,1.0,0.0
9759,30324,24267,24267,0,1.0,0.0
9760,30326,4802,4802,0,1.0,0.0
9761,30327,22208,22208,0,1.0,0.0
9762,30328,30348,30348,0,1.0,0.0
9763,30329,28539,28539,0,1.0,0.0
9764,30331,54094,53826,268,0.995,0.005
9765,30332,2970,2970,0,1.0,0.0
9766,30334,1,1,0,1.0,0.0
9767,30336,971,966,5,0.995,0.005
9768,30337,11505,11505,0,1.0,0.0
9769,30338,33617,33617,0,1.0,0.0
9770,30339,18304,18304,0,1.0,0.0
9771,30340,29394,29394,0,1.0,0.0
9772,30341,31793,31793,0,1.0,0.0
9773,30342,29879,29879,0,1.0,0.0
9774,30344,31776,31776,0,1.0,0.0
9775,30345,23129,23129,0,1.0,0.0
9776,30346,4696,4696,0,1.0,0.0
9777,30349,67602,66620,982,0.985,0.015
9778,30350,34740,34740,0,1.0,0.0
9779,30354,14857,14857,0,1.0,0.0
9780,30360,14536,14536,0,1.0,0.0
9781,30363,2680,2680,0,1.0,0.0
9782,30401,13500,7484,6016,0.554,0.446
9783,30410,2168,0,2168,0.0,1.0
9784,30411,4371,0,4371,0.0,1.0
9785,30412,80,0,80,0.0,1.0
9786,30413,1575,0,1575,0.0,1.0
9787,30415,6780,0,6780,0.0,1.0
9788,30417,11090,4054,7036,0.366,0.634
9789,30420,1460,0,1460,0.0,1.0
9790,30421,3381,0,3381,0.0,1.0
9791,30423,120,0,120,0.0,1.0
9792,30425,1198,0,1198,0.0,1.0
9793,30426,1100,0,1100,0.0,1.0
9794,30427,12864,3161,9703,0.246,0.754
9795,30428,2766,0,2766,0.0,1.0
9796,30429,205,205,0,1.0,0.0
9797,30434,5728,3273,2455,0.571,0.429
9798,30436,11961,3866,8095,0.323,0.677
9799,30438,74,0,74,0.0,1.0
9800,30439,10877,3633,7244,0.334,0.666
9801,30441,1663,0,1663,0.0,1.0
9802,30442,7698,2827,4871,0.367,0.633
9803,30445,3285,0,3285,0.0,1.0
9804,30446,1357,0,1357,0.0,1.0
9805,30448,81,0,81,0.0,1.0
9806,30449,119,0,119,0.0,1.0
9807,30450,2583,0,2583,0.0,1.0
9808,30451,33,0,33,0.0,1.0
9809,30452,1567,0,1567,0.0,1.0
9810,30453,9703,4945,4758,0.51,0.49
9811,30454,538,0,538,0.0,1.0
9812,30455,597,0,597,0.0,1.0
9813,30456,2119,0,2119,0.0,1.0
9814,30457,6424,2832,3592,0.441,0.559
9815,30458,41139,32474,8665,0.789,0.211
9816,30460,427,427,0,1.0,0.0
9817,30461,13390,3413,9977,0.255,0.745
9818,30464,78,0,78,0.0,1.0
9819,30467,12600,3076,9524,0.244,0.756
9820,30470,517,0,517,0.0,1.0
9821,30471,4702,0,4702,0.0,1.0
9822,30473,2972,0,2972,0.0,1.0
9823,30474,16594,9548,7046,0.575,0.425
9824,30475,52,28,24,0.538,0.462
9825,30477,3070,0,3070,0.0,1.0
9826,30501,28048,27796,252,0.991,0.009
9827,30504,22463,22080,383,0.983,0.017
9828,30506,41667,26583,15084,0.638,0.362
9829,30507,28399,22078,6321,0.777,0.223
9830,30510,8291,4946,3345,0.597,0.403
9831,30511,3186,1159,2027,0.364,0.636
9832,30512,19490,0,19490,0.0,1.0
9833,30513,11172,0,11172,0.0,1.0
9834,30516,2054,0,2054,0.0,1.0
9835,30517,11963,8854,3109,0.74,0.26
9836,30518,45211,44868,343,0.992,0.008
9837,30519,39812,39706,106,0.997,0.003
9838,30520,4426,0,4426,0.0,1.0
9839,30521,4944,0,4944,0.0,1.0
9840,30522,1092,0,1092,0.0,1.0
9841,30523,12904,1887,11017,0.146,0.854
9842,30525,7364,2395,4969,0.325,0.675
9843,30527,4043,0,4043,0.0,1.0
9844,30528,22679,4399,18280,0.194,0.806
9845,30529,10920,6614,4306,0.606,0.394
9846,30530,6752,10,6742,0.001,0.999
9847,30531,11279,7557,3722,0.67,0.33
9848,30533,25296,4812,20484,0.19,0.81
9849,30534,26685,4612,22073,0.173,0.827
9850,30535,7042,1975,5067,0.28,0.72
9851,30536,8363,367,7996,0.044,0.956
9852,30537,1249,0,1249,0.0,1.0
9853,30538,2854,0,2854,0.0,1.0
9854,30540,17297,3129,14168,0.181,0.819
9855,30541,1603,0,1603,0.0,1.0
9856,30542,31946,29816,2130,0.933,0.067
9857,30543,4487,1436,3051,0.32,0.68
9858,30545,936,0,936,0.0,1.0
9859,30546,6496,0,6496,0.0,1.0
9860,30547,3268,0,3268,0.0,1.0
9861,30548,15870,11039,4831,0.696,0.304
9862,30549,22500,11431,11069,0.508,0.492
9863,30552,1697,0,1697,0.0,1.0
9864,30553,7232,0,7232,0.0,1.0
9865,30554,8535,2610,5925,0.306,0.694
9866,30555,2061,0,2061,0.0,1.0
9867,30557,4975,0,4975,0.0,1.0
9868,30558,5456,0,5456,0.0,1.0
9869,30559,4333,0,4333,0.0,1.0
9870,30560,4599,0,4599,0.0,1.0
9871,30562,1128,727,401,0.645,0.355
9872,30563,5373,1054,4319,0.196,0.804
9873,30564,4463,174,4289,0.039,0.961
9874,30565,4758,0,4758,0.0,1.0
9875,30566,7906,7863,43,0.995,0.005
9876,30567,2981,0,2981,0.0,1.0
9877,30568,1877,250,1627,0.133,0.867
9878,30571,3682,0,3682,0.0,1.0
9879,30572,1260,0,1260,0.0,1.0
9880,30573,163,0,163,0.0,1.0
9881,30575,1375,0,1375,0.0,1.0
9882,30576,2521,0,2521,0.0,1.0
9883,30577,22230,10846,11384,0.488,0.512
9884,30581,73,0,73,0.0,1.0
9885,30582,4567,0,4567,0.0,1.0
9886,30601,20835,19562,1273,0.939,0.061
9887,30602,2409,2409,0,1.0,0.0
9888,30605,39952,37823,2129,0.947,0.053
9889,30606,40225,38692,1533,0.962,0.038
9890,30607,10895,7392,3503,0.678,0.322
9891,30609,1956,1956,0,1.0,0.0
9892,30619,1440,0,1440,0.0,1.0
9893,30620,12486,10096,2390,0.809,0.191
9894,30621,5109,129,4980,0.025,0.975
9895,30622,10344,5827,4517,0.563,0.437
9896,30623,154,0,154,0.0,1.0
9897,30624,2611,0,2611,0.0,1.0
9898,30625,2438,0,2438,0.0,1.0
9899,30627,2273,0,2273,0.0,1.0
9900,30628,6556,0,6556,0.0,1.0
9901,30629,4531,0,4531,0.0,1.0
9902,30630,2438,0,2438,0.0,1.0
9903,30631,1767,0,1767,0.0,1.0
9904,30633,8474,0,8474,0.0,1.0
9905,30634,2281,0,2281,0.0,1.0
9906,30635,16109,5925,10184,0.368,0.632
9907,30641,1810,0,1810,0.0,1.0
9908,30642,11001,2759,8242,0.251,0.749
9909,30643,16382,5884,10498,0.359,0.641
9910,30646,6946,2265,4681,0.326,0.674
9911,30648,2988,0,2988,0.0,1.0
9912,30650,11708,4401,7307,0.376,0.624
9913,30655,24136,16316,7820,0.676,0.324
9914,30656,15133,5525,9608,0.365,0.635
9915,30660,1191,0,1191,0.0,1.0
9916,30662,8537,3002,5535,0.352,0.648
9917,30663,3032,0,3032,0.0,1.0
9918,30664,38,0,38,0.0,1.0
9919,30665,80,0,80,0.0,1.0
9920,30666,8659,3584,5075,0.414,0.586
9921,30667,1035,0,1035,0.0,1.0
9922,30668,1924,0,1924,0.0,1.0
9923,30669,3313,0,3313,0.0,1.0
9924,30673,7897,3457,4440,0.438,0.562
9925,30677,17065,9643,7422,0.565,0.435
9926,30678,1294,0,1294,0.0,1.0
9927,30680,37837,25933,11904,0.685,0.315
9928,30683,6749,2799,3950,0.415,0.585
9929,30701,40053,26573,13480,0.663,0.337
9930,30705,33566,11838,21728,0.353,0.647
9931,30707,16483,8777,7706,0.532,0.468
9932,30708,293,0,293,0.0,1.0
9933,30710,6661,2523,4138,0.379,0.621
9934,30711,3569,0,3569,0.0,1.0
9935,30720,26895,23211,3684,0.863,0.137
9936,30721,53601,39202,14399,0.731,0.269
9937,30725,4647,3288,1359,0.708,0.292
9938,30726,56,56,0,1.0,0.0
9939,30728,19612,7347,12265,0.375,0.625
9940,30730,1993,0,1993,0.0,1.0
9941,30731,2428,0,2428,0.0,1.0
9942,30733,2080,0,2080,0.0,1.0
9943,30734,3466,0,3466,0.0,1.0
9944,30735,6153,0,6153,0.0,1.0
9945,30736,41029,26805,14224,0.653,0.347
9946,30738,3799,0,3799,0.0,1.0
9947,30739,5571,17,5554,0.003,0.997
9948,30740,8600,3815,4785,0.444,0.556
9949,30741,29290,29117,173,0.994,0.006
9950,30742,7460,7444,16,0.998,0.002
9951,30746,1223,0,1223,0.0,1.0
9952,30747,16859,8363,8496,0.496,0.504
9953,30750,4125,2721,1404,0.66,0.34
9954,30751,91,0,91,0.0,1.0
9955,30752,9800,2794,7006,0.285,0.715
9956,30753,6697,2678,4019,0.4,0.6
9957,30755,9590,4588,5002,0.478,0.522
9958,30756,74,62,12,0.838,0.162
9959,30757,1787,212,1575,0.119,0.881
9960,30802,6321,0,6321,0.0,1.0
9961,30803,741,0,741,0.0,1.0
9962,30805,2734,135,2599,0.049,0.951
9963,30807,92,0,92,0.0,1.0
9964,30808,4615,0,4615,0.0,1.0
9965,30809,38168,35983,2185,0.943,0.057
9966,30810,2138,0,2138,0.0,1.0
9967,30812,363,363,0,1.0,0.0
9968,30813,30415,24199,6216,0.796,0.204
9969,30814,8150,2705,5445,0.332,0.668
9970,30815,39640,27165,12475,0.685,0.315
9971,30816,2109,0,2109,0.0,1.0
9972,30817,7676,0,7676,0.0,1.0
9973,30818,555,0,555,0.0,1.0
9974,30820,1205,0,1205,0.0,1.0
9975,30821,882,0,882,0.0,1.0
9976,30822,526,0,526,0.0,1.0
9977,30823,1800,0,1800,0.0,1.0
9978,30824,17201,8540,8661,0.496,0.504
9979,30828,4368,0,4368,0.0,1.0
9980,30830,13966,5830,8136,0.417,0.583
9981,30833,4043,0,4043,0.0,1.0
9982,30901,16445,16432,13,0.999,0.001
9983,30903,585,585,0,1.0,0.0
9984,30904,25666,25666,0,1.0,0.0
9985,30905,8955,8312,643,0.928,0.072
9986,30906,57748,52965,4783,0.917,0.083
9987,30907,50913,50778,135,0.997,0.003
9988,30909,41585,40404,1181,0.972,0.028
9989,30912,296,296,0,1.0,0.0
9990,31001,4816,0,4816,0.0,1.0
9991,31002,2910,0,2910,0.0,1.0
9992,31003,112,0,112,0.0,1.0
9993,31005,15102,13835,1267,0.916,0.084
9994,31006,4923,0,4923,0.0,1.0
9995,31007,1117,0,1117,0.0,1.0
9996,31008,18453,11324,7129,0.614,0.386
9997,31009,1477,0,1477,0.0,1.0
9998,31011,923,0,923,0.0,1.0
9999,31012,2683,0,2683,0.0,1.0
10000,31014,13756,6324,7432,0.46,0.54
10001,31015,21938,12416,9522,0.566,0.434
10002,31016,1517,0,1517,0.0,1.0
10003,31017,1985,0,1985,0.0,1.0
10004,31018,2837,0,2837,0.0,1.0
10005,31019,2318,0,2318,0.0,1.0
10006,31020,2541,0,2541,0.0,1.0
10007,31021,28549,18621,9928,0.652,0.348
10008,31022,1424,0,1424,0.0,1.0
10009,31023,15383,6053,9330,0.393,0.607
10010,31024,20039,3893,16146,0.194,0.806
10011,31025,1226,0,1226,0.0,1.0
10012,31027,10012,2378,7634,0.238,0.762
10013,31028,5912,5876,36,0.994,0.006
10014,31029,16287,4834,11453,0.297,0.703
10015,31030,18977,10610,8367,0.559,0.441
10016,31031,6576,0,6576,0.0,1.0
10017,31032,13993,4566,9427,0.326,0.674
10018,31033,2660,0,2660,0.0,1.0
10019,31035,1364,0,1364,0.0,1.0
10020,31036,12998,3999,8999,0.308,0.692
10021,31037,4313,2799,1514,0.649,0.351
10022,31038,761,0,761,0.0,1.0
10023,31039,74,0,74,0.0,1.0
10024,31041,988,0,988,0.0,1.0
10025,31042,1841,0,1841,0.0,1.0
10026,31044,2911,0,2911,0.0,1.0
10027,31045,73,0,73,0.0,1.0
10028,31046,3343,0,3343,0.0,1.0
10029,31047,11193,9392,1801,0.839,0.161
10030,31049,1806,0,1806,0.0,1.0
10031,31050,965,0,965,0.0,1.0
10032,31051,187,0,187,0.0,1.0
10033,31052,8652,1687,6965,0.195,0.805
10034,31054,1671,0,1671,0.0,1.0
10035,31055,8245,5948,2297,0.721,0.279
10036,31057,2182,0,2182,0.0,1.0
10037,31058,2123,0,2123,0.0,1.0
10038,31060,1915,0,1915,0.0,1.0
10039,31061,43755,29309,14446,0.67,0.33
10040,31062,495,495,0,1.0,0.0
10041,31063,5666,3247,2419,0.573,0.427
10042,31064,9450,2535,6915,0.268,0.732
10043,31065,1118,0,1118,0.0,1.0
10044,31066,1147,0,1147,0.0,1.0
10045,31067,222,0,222,0.0,1.0
10046,31068,5425,3611,1814,0.666,0.334
10047,31069,18948,13353,5595,0.705,0.295
10048,31070,998,0,998,0.0,1.0
10049,31071,1199,0,1199,0.0,1.0
10050,31072,1326,0,1326,0.0,1.0
10051,31075,2496,0,2496,0.0,1.0
10052,31076,3064,0,3064,0.0,1.0
10053,31077,1275,0,1275,0.0,1.0
10054,31078,3566,0,3566,0.0,1.0
10055,31079,2398,0,2398,0.0,1.0
10056,31081,251,0,251,0.0,1.0
10057,31082,10408,5588,4820,0.537,0.463
10058,31083,362,0,362,0.0,1.0
10059,31084,129,0,129,0.0,1.0
10060,31085,1043,0,1043,0.0,1.0
10061,31087,9656,3622,6034,0.375,0.625
10062,31088,50163,48978,1185,0.976,0.024
10063,31089,4838,1700,3138,0.351,0.649
10064,31090,1038,0,1038,0.0,1.0
10065,31091,5189,3406,1783,0.656,0.344
10066,31092,7420,3506,3914,0.473,0.527
10067,31093,28087,26860,1227,0.956,0.044
10068,31094,1114,0,1114,0.0,1.0
10069,31096,7395,3452,3943,0.467,0.533
10070,31097,1302,0,1302,0.0,1.0
10071,31098,2888,2844,44,0.985,0.015
10072,31201,8761,8761,0,1.0,0.0
10073,31204,31482,31482,0,1.0,0.0
10074,31206,29072,27970,1102,0.962,0.038
10075,31207,974,974,0,1.0,0.0
10076,31210,30968,25941,5027,0.838,0.162
10077,31211,16282,12043,4239,0.74,0.26
10078,31213,0,0,0,,
10079,31216,16109,9973,6136,0.619,0.381
10080,31217,18408,12075,6333,0.656,0.344
10081,31220,13839,7306,6533,0.528,0.472
10082,31301,4591,3961,630,0.863,0.137
10083,31302,7853,2844,5009,0.362,0.638
10084,31303,1999,0,1999,0.0,1.0
10085,31304,132,0,132,0.0,1.0
10086,31305,5989,3682,2307,0.615,0.385
10087,31307,998,0,998,0.0,1.0
10088,31308,7305,0,7305,0.0,1.0
10089,31309,1210,0,1210,0.0,1.0
10090,31312,16443,389,16054,0.024,0.976
10091,31313,40302,36989,3313,0.918,0.082
10092,31314,1931,1931,0,1.0,0.0
10093,31315,7488,7488,0,1.0,0.0
10094,31316,9749,1087,8662,0.111,0.889
10095,31318,341,0,341,0.0,1.0
10096,31320,8794,0,8794,0.0,1.0
10097,31321,6326,0,6326,0.0,1.0
10098,31322,21137,20348,789,0.963,0.037
10099,31323,1762,0,1762,0.0,1.0
10100,31324,20495,14408,6087,0.703,0.297
10101,31326,19269,12147,7122,0.63,0.37
10102,31327,195,0,195,0.0,1.0
10103,31328,3306,3202,104,0.969,0.031
10104,31329,9034,3649,5385,0.404,0.596
10105,31331,7856,0,7856,0.0,1.0
10106,31401,21696,21685,11,0.999,0.001
10107,31404,31024,31024,0,1.0,0.0
10108,31405,37207,35636,1571,0.958,0.042
10109,31406,33965,32854,1111,0.967,0.033
10110,31407,7244,6651,593,0.918,0.082
10111,31408,9952,9952,0,1.0,0.0
10112,31409,652,652,0,1.0,0.0
10113,31410,23654,22540,1114,0.953,0.047
10114,31411,8384,6153,2231,0.734,0.266
10115,31415,12091,12091,0,1.0,0.0
10116,31419,50954,48582,2372,0.953,0.047
10117,31501,15576,15138,438,0.972,0.028
10118,31503,21116,10585,10531,0.501,0.499
10119,31510,9848,3408,6440,0.346,0.654
10120,31512,2248,0,2248,0.0,1.0
10121,31513,16084,5208,10876,0.324,0.676
10122,31516,14735,3873,10862,0.263,0.737
10123,31518,704,0,704,0.0,1.0
10124,31519,3569,0,3569,0.0,1.0
10125,31520,22336,22134,202,0.991,0.009
10126,31522,14447,12226,2221,0.846,0.154
10127,31523,13229,6779,6450,0.512,0.488
10128,31524,0,0,0,,
10129,31525,28247,22111,6136,0.783,0.217
10130,31527,805,0,805,0.0,1.0
10131,31532,727,0,727,0.0,1.0
10132,31533,17494,13016,4478,0.744,0.256
10133,31535,11264,1138,10126,0.101,0.899
10134,31537,10097,5961,4136,0.59,0.41
10135,31539,14468,4594,9874,0.318,0.682
10136,31542,2811,0,2811,0.0,1.0
10137,31543,4796,0,4796,0.0,1.0
10138,31544,994,0,994,0.0,1.0
10139,31545,16133,7624,8509,0.473,0.527
10140,31546,8095,5036,3059,0.622,0.378
10141,31547,1293,1284,9,0.993,0.007
10142,31548,20020,15392,4628,0.769,0.231
10143,31549,2239,0,2239,0.0,1.0
10144,31550,780,0,780,0.0,1.0
10145,31551,1020,0,1020,0.0,1.0
10146,31552,932,0,932,0.0,1.0
10147,31553,5237,0,5237,0.0,1.0
10148,31554,7076,0,7076,0.0,1.0
10149,31555,2868,0,2868,0.0,1.0
10150,31556,67,0,67,0.0,1.0
10151,31557,3043,0,3043,0.0,1.0
10152,31558,20373,17954,2419,0.881,0.119
10153,31560,2842,0,2842,0.0,1.0
10154,31561,298,0,298,0.0,1.0
10155,31562,2177,0,2177,0.0,1.0
10156,31563,1324,0,1324,0.0,1.0
10157,31565,1841,0,1841,0.0,1.0
10158,31566,3471,0,3471,0.0,1.0
10159,31567,782,0,782,0.0,1.0
10160,31568,1273,0,1273,0.0,1.0
10161,31569,5580,0,5580,0.0,1.0
10162,31601,32730,23373,9357,0.714,0.286
10163,31602,34702,32157,2545,0.927,0.073
10164,31605,20188,15386,4802,0.762,0.238
10165,31606,3861,0,3861,0.0,1.0
10166,31620,10690,5333,5357,0.499,0.501
10167,31622,2178,0,2178,0.0,1.0
10168,31623,120,0,120,0.0,1.0
10169,31624,1273,0,1273,0.0,1.0
10170,31625,1171,0,1171,0.0,1.0
10171,31626,3463,0,3463,0.0,1.0
10172,31627,239,0,239,0.0,1.0
10173,31629,902,0,902,0.0,1.0
10174,31630,419,0,419,0.0,1.0
10175,31631,559,0,559,0.0,1.0
10176,31632,10295,3254,7041,0.316,0.684
10177,31634,5844,2690,3154,0.46,0.54
10178,31635,6560,2910,3650,0.444,0.556
10179,31636,9539,3367,6172,0.353,0.647
10180,31637,2848,0,2848,0.0,1.0
10181,31638,1045,0,1045,0.0,1.0
10182,31639,10537,4601,5936,0.437,0.563
10183,31641,1831,0,1831,0.0,1.0
10184,31642,4898,0,4898,0.0,1.0
10185,31643,8709,3769,4940,0.433,0.567
10186,31645,5147,71,5076,0.014,0.986
10187,31647,3535,1653,1882,0.468,0.532
10188,31648,1040,0,1040,0.0,1.0
10189,31649,1056,0,1056,0.0,1.0
10190,31650,3311,0,3311,0.0,1.0
10191,31698,2223,2223,0,1.0,0.0
10192,31699,621,621,0,1.0,0.0
10193,31701,20552,19132,1420,0.931,0.069
10194,31705,35565,25716,9849,0.723,0.277
10195,31707,25299,24935,364,0.986,0.014
10196,31709,16019,12332,3687,0.77,0.23
10197,31711,867,42,825,0.048,0.952
10198,31712,1263,0,1263,0.0,1.0
10199,31714,6474,3819,2655,0.59,0.41
10200,31716,2896,0,2896,0.0,1.0
10201,31719,10977,6774,4203,0.617,0.383
10202,31720,455,0,455,0.0,1.0
10203,31721,20095,14950,5145,0.744,0.256
10204,31722,494,0,494,0.0,1.0
10205,31730,9682,5177,4505,0.535,0.465
10206,31733,1580,0,1580,0.0,1.0
10207,31735,817,0,817,0.0,1.0
10208,31738,2102,0,2102,0.0,1.0
10209,31743,630,0,630,0.0,1.0
10210,31744,3202,0,3202,0.0,1.0
10211,31747,281,0,281,0.0,1.0
10212,31749,2783,0,2783,0.0,1.0
10213,31750,18687,11638,7049,0.623,0.377
10214,31756,966,0,966,0.0,1.0
10215,31757,10451,4828,5623,0.462,0.538
10216,31763,23304,14677,8627,0.63,0.37
10217,31764,1296,0,1296,0.0,1.0
10218,31765,2647,0,2647,0.0,1.0
10219,31768,23617,15142,8475,0.641,0.359
10220,31771,5666,453,5213,0.08,0.92
10221,31772,482,0,482,0.0,1.0
10222,31773,3729,0,3729,0.0,1.0
10223,31774,6714,3366,3348,0.501,0.499
10224,31775,2979,0,2979,0.0,1.0
10225,31778,2562,0,2562,0.0,1.0
10226,31779,9927,5512,4415,0.555,0.445
10227,31780,2285,0,2285,0.0,1.0
10228,31781,1752,684,1068,0.39,0.61
10229,31783,1107,0,1107,0.0,1.0
10230,31784,781,0,781,0.0,1.0
10231,31787,1488,0,1488,0.0,1.0
10232,31788,10602,3082,7520,0.291,0.709
10233,31789,1236,0,1236,0.0,1.0
10234,31790,2078,670,1408,0.322,0.678
10235,31791,12354,6001,6353,0.486,0.514
10236,31792,23835,19311,4524,0.81,0.19
10237,31793,9043,3892,5151,0.43,0.57
10238,31794,27153,19865,7288,0.732,0.268
10239,31795,2010,0,2010,0.0,1.0
10240,31796,1112,0,1112,0.0,1.0
10241,31798,983,0,983,0.0,1.0
10242,31801,3008,0,3008,0.0,1.0
10243,31803,5662,0,5662,0.0,1.0
10244,31804,5934,0,5934,0.0,1.0
10245,31805,3191,0,3191,0.0,1.0
10246,31806,4962,0,4962,0.0,1.0
10247,31807,2483,0,2483,0.0,1.0
10248,31808,6679,0,6679,0.0,1.0
10249,31810,225,0,225,0.0,1.0
10250,31811,5103,0,5103,0.0,1.0
10251,31812,565,0,565,0.0,1.0
10252,31814,272,0,272,0.0,1.0
10253,31815,3675,0,3675,0.0,1.0
10254,31816,6091,3897,2194,0.64,0.36
10255,31820,8473,4170,4303,0.492,0.508
10256,31821,250,0,250,0.0,1.0
10257,31822,5429,0,5429,0.0,1.0
10258,31823,754,0,754,0.0,1.0
10259,31824,1838,0,1838,0.0,1.0
10260,31825,2312,0,2312,0.0,1.0
10261,31826,2350,197,2153,0.084,0.916
10262,31827,2134,0,2134,0.0,1.0
10263,31829,1370,0,1370,0.0,1.0
10264,31830,2191,2,2189,0.001,0.999
10265,31831,3095,0,3095,0.0,1.0
10266,31832,217,0,217,0.0,1.0
10267,31833,6900,3361,3539,0.487,0.513
10268,31836,1154,0,1154,0.0,1.0
10269,31901,8638,8638,0,1.0,0.0
10270,31903,20128,20128,0,1.0,0.0
10271,31904,32871,31769,1102,0.966,0.034
10272,31905,16044,15737,307,0.981,0.019
10273,31906,21757,21757,0,1.0,0.0
10274,31907,55332,55332,0,1.0,0.0
10275,31909,35177,34807,370,0.989,0.011
10276,32003,27126,27126,0,1.0,0.0
10277,32008,5309,0,5309,0.0,1.0
10278,32009,3325,0,3325,0.0,1.0
10279,32011,13854,5243,8611,0.378,0.622
10280,32024,18733,1311,17422,0.07,0.93
10281,32025,22380,15028,7352,0.671,0.329
10282,32026,1959,0,1959,0.0,1.0
10283,32033,4118,0,4118,0.0,1.0
10284,32034,31008,22108,8900,0.713,0.287
10285,32038,9228,0,9228,0.0,1.0
10286,32040,7604,1605,5999,0.211,0.789
10287,32043,24632,17479,7153,0.71,0.29
10288,32044,2060,0,2060,0.0,1.0
10289,32046,9410,0,9410,0.0,1.0
10290,32052,9223,5404,3819,0.586,0.414
10291,32053,3869,0,3869,0.0,1.0
10292,32054,12307,5057,7250,0.411,0.589
10293,32055,16570,9284,7286,0.56,0.44
10294,32058,4416,0,4416,0.0,1.0
10295,32059,2377,0,2377,0.0,1.0
10296,32060,21363,584,20779,0.027,0.973
10297,32061,283,0,283,0.0,1.0
10298,32062,2449,0,2449,0.0,1.0
10299,32063,13429,9379,4050,0.698,0.302
10300,32064,6860,6410,450,0.934,0.066
10301,32065,32770,32634,136,0.996,0.004
10302,32066,7312,0,7312,0.0,1.0
10303,32068,50815,41338,9477,0.813,0.187
10304,32071,3671,0,3671,0.0,1.0
10305,32072,324,0,324,0.0,1.0
10306,32073,38920,38859,61,0.998,0.002
10307,32079,433,0,433,0.0,1.0
10308,32080,20165,19394,771,0.962,0.038
10309,32081,4524,80,4444,0.018,0.982
10310,32082,28996,27095,1901,0.934,0.066
10311,32083,4690,0,4690,0.0,1.0
10312,32084,29729,24598,5131,0.827,0.173
10313,32086,24546,21627,2919,0.881,0.119
10314,32087,5518,0,5518,0.0,1.0
10315,32091,15472,5858,9614,0.379,0.621
10316,32092,28242,15023,13219,0.532,0.468
10317,32094,2724,0,2724,0.0,1.0
10318,32095,7302,3121,4181,0.427,0.573
10319,32096,2635,0,2635,0.0,1.0
10320,32097,15616,10665,4951,0.683,0.317
10321,32102,2565,0,2565,0.0,1.0
10322,32110,7600,1928,5672,0.254,0.746
10323,32112,7713,2662,5051,0.345,0.655
10324,32113,6627,0,6627,0.0,1.0
10325,32114,32084,32083,1,1.0,0.0
10326,32117,24170,23637,533,0.978,0.022
10327,32118,16961,16961,0,1.0,0.0
10328,32119,20189,20189,0,1.0,0.0
10329,32124,5986,1190,4796,0.199,0.801
10330,32127,29413,29402,11,1.0,0.0
10331,32128,16910,14647,2263,0.866,0.134
10332,32129,20104,20104,0,1.0,0.0
10333,32130,5474,2710,2764,0.495,0.505
10334,32131,4701,1955,2746,0.416,0.584
10335,32132,7265,6453,812,0.888,0.112
10336,32133,137,0,137,0.0,1.0
10337,32134,8084,0,8084,0.0,1.0
10338,32136,7080,5027,2053,0.71,0.29
10339,32137,37821,36643,1178,0.969,0.031
10340,32139,1129,0,1129,0.0,1.0
10341,32140,1741,0,1741,0.0,1.0
10342,32141,17603,16778,825,0.953,0.047
10343,32145,5456,0,5456,0.0,1.0
10344,32147,593,0,593,0.0,1.0
10345,32148,11201,5805,5396,0.518,0.482
10346,32157,407,150,257,0.369,0.631
10347,32159,28867,25175,3692,0.872,0.128
10348,32162,45180,44387,793,0.982,0.018
10349,32164,41616,41315,301,0.993,0.007
10350,32168,23642,18660,4982,0.789,0.211
10351,32169,9816,9026,790,0.92,0.08
10352,32174,47552,40296,7256,0.847,0.153
10353,32176,14339,14339,0,1.0,0.0
10354,32177,27132,18986,8146,0.7,0.3
10355,32179,8156,2556,5600,0.313,0.687
10356,32180,4218,0,4218,0.0,1.0
10357,32181,2551,0,2551,0.0,1.0
10358,32187,1713,834,879,0.487,0.513
10359,32189,5807,2207,3600,0.38,0.62
10360,32190,1170,0,1170,0.0,1.0
10361,32193,825,0,825,0.0,1.0
10362,32195,3328,563,2765,0.169,0.831
10363,32202,7915,7915,0,1.0,0.0
10364,32204,6906,6906,0,1.0,0.0
10365,32205,28225,28225,0,1.0,0.0
10366,32206,17669,17669,0,1.0,0.0
10367,32207,33306,33306,0,1.0,0.0
10368,32208,30879,30879,0,1.0,0.0
10369,32209,34305,34305,0,1.0,0.0
10370,32210,59080,59080,0,1.0,0.0
10371,32211,30501,30501,0,1.0,0.0
10372,32212,1959,1959,0,1.0,0.0
10373,32216,34876,34876,0,1.0,0.0
10374,32217,18817,18817,0,1.0,0.0
10375,32218,53473,47448,6025,0.887,0.113
10376,32219,11886,7444,4442,0.626,0.374
10377,32220,12946,9452,3494,0.73,0.27
10378,32221,27918,26889,1029,0.963,0.037
10379,32222,8691,8513,178,0.98,0.02
10380,32223,23980,23980,0,1.0,0.0
10381,32224,38934,38756,178,0.995,0.005
10382,32225,52485,52105,380,0.993,0.007
10383,32226,15761,10852,4909,0.689,0.311
10384,32227,2149,2149,0,1.0,0.0
10385,32228,314,314,0,1.0,0.0
10386,32233,23673,23673,0,1.0,0.0
10387,32234,6606,0,6606,0.0,1.0
10388,32244,57369,57369,0,1.0,0.0
10389,32246,48789,48789,0,1.0,0.0
10390,32250,25356,25356,0,1.0,0.0
10391,32254,13570,13505,65,0.995,0.005
10392,32256,38483,38337,146,0.996,0.004
10393,32257,36430,36430,0,1.0,0.0
10394,32258,26759,26365,394,0.985,0.015
10395,32259,36917,33922,2995,0.919,0.081
10396,32266,7037,7037,0,1.0,0.0
10397,32277,29517,29517,0,1.0,0.0
10398,32301,29321,29298,23,0.999,0.001
10399,32303,47359,45052,2307,0.951,0.049
10400,32304,46145,45826,319,0.993,0.007
10401,32305,20073,13446,6627,0.67,0.33
10402,32308,21586,21543,43,0.998,0.002
10403,32309,30159,23597,6562,0.782,0.218
10404,32310,17402,12218,5184,0.702,0.298
10405,32311,17493,13270,4223,0.759,0.241
10406,32312,31869,27643,4226,0.867,0.133
10407,32317,14067,9681,4386,0.688,0.312
10408,32320,3858,2746,1112,0.712,0.288
10409,32321,6460,0,6460,0.0,1.0
10410,32322,4007,0,4007,0.0,1.0
10411,32323,217,0,217,0.0,1.0
10412,32324,5445,3375,2070,0.62,0.38
10413,32327,26953,11794,15159,0.438,0.562
10414,32328,3149,945,2204,0.3,0.7
10415,32330,804,0,804,0.0,1.0
10416,32331,4242,0,4242,0.0,1.0
10417,32332,1642,0,1642,0.0,1.0
10418,32333,11330,3059,8271,0.27,0.73
10419,32334,1904,0,1904,0.0,1.0
10420,32336,1391,0,1391,0.0,1.0
10421,32340,11808,3843,7965,0.325,0.675
10422,32343,3044,334,2710,0.11,0.89
10423,32344,13193,0,13193,0.0,1.0
10424,32346,1693,0,1693,0.0,1.0
10425,32347,8057,3045,5012,0.378,0.622
10426,32348,12442,3888,8554,0.312,0.688
10427,32350,1417,0,1417,0.0,1.0
10428,32351,17486,9292,8194,0.531,0.469
10429,32352,6638,0,6638,0.0,1.0
10430,32355,312,0,312,0.0,1.0
10431,32356,129,0,129,0.0,1.0
10432,32358,2145,0,2145,0.0,1.0
10433,32359,1721,0,1721,0.0,1.0
10434,32361,252,0,252,0.0,1.0
10435,32399,2,2,0,1.0,0.0
10436,32401,22647,22647,0,1.0,0.0
10437,32403,2995,1575,1420,0.526,0.474
10438,32404,38425,33859,4566,0.881,0.119
10439,32405,29980,29978,2,1.0,0.0
10440,32407,9347,8924,423,0.955,0.045
10441,32408,15352,15296,56,0.996,0.004
10442,32409,8691,4128,4563,0.475,0.525
10443,32410,740,0,740,0.0,1.0
10444,32413,13128,11210,1918,0.854,0.146
10445,32420,2144,0,2144,0.0,1.0
10446,32421,4497,0,4497,0.0,1.0
10447,32423,1264,0,1264,0.0,1.0
10448,32424,7994,4751,3243,0.594,0.406
10449,32425,14268,4230,10038,0.296,0.704
10450,32426,942,0,942,0.0,1.0
10451,32427,1475,0,1475,0.0,1.0
10452,32428,17412,3846,13566,0.221,0.779
10453,32430,1199,0,1199,0.0,1.0
10454,32431,4983,0,4983,0.0,1.0
10455,32432,89,0,89,0.0,1.0
10456,32433,16025,3532,12493,0.22,0.78
10457,32435,6651,2280,4371,0.343,0.657
10458,32437,679,0,679,0.0,1.0
10459,32438,4060,0,4060,0.0,1.0
10460,32439,7715,856,6859,0.111,0.889
10461,32440,7563,4037,3526,0.534,0.466
10462,32442,3699,0,3699,0.0,1.0
10463,32443,2921,0,2921,0.0,1.0
10464,32444,18985,18947,38,0.998,0.002
10465,32445,2644,0,2644,0.0,1.0
10466,32446,11075,2817,8258,0.254,0.746
10467,32447,78,78,0,1.0,0.0
10468,32448,8684,3191,5493,0.367,0.633
10469,32449,478,0,478,0.0,1.0
10470,32455,4736,0,4736,0.0,1.0
10471,32456,6966,3635,3331,0.522,0.478
10472,32459,11457,6418,5039,0.56,0.44
10473,32460,5856,2133,3723,0.364,0.636
10474,32461,13,0,13,0.0,1.0
10475,32462,3412,0,3412,0.0,1.0
10476,32463,114,0,114,0.0,1.0
10477,32464,3994,0,3994,0.0,1.0
10478,32465,9232,0,9232,0.0,1.0
10479,32466,5641,2533,3108,0.449,0.551
10480,32501,11730,11730,0,1.0,0.0
10481,32502,3298,3298,0,1.0,0.0
10482,32503,32011,32011,0,1.0,0.0
10483,32504,21441,21441,0,1.0,0.0
10484,32505,28213,28213,0,1.0,0.0
10485,32506,33846,33178,668,0.98,0.02
10486,32507,28996,28677,319,0.989,0.011
10487,32508,5852,5852,0,1.0,0.0
10488,32509,660,660,0,1.0,0.0
10489,32511,1145,1145,0,1.0,0.0
10490,32514,37399,37399,0,1.0,0.0
10491,32526,36297,32098,4199,0.884,0.116
10492,32530,38,38,0,1.0,0.0
10493,32531,5296,0,5296,0.0,1.0
10494,32533,26493,18943,7550,0.715,0.285
10495,32534,14029,14029,0,1.0,0.0
10496,32535,6326,2770,3556,0.438,0.562
10497,32536,19709,16941,2768,0.86,0.14
10498,32539,25079,15491,9588,0.618,0.382
10499,32541,15565,15565,0,1.0,0.0
10500,32542,3457,3303,154,0.955,0.045
10501,32544,1818,1818,0,1.0,0.0
10502,32547,32485,32480,5,1.0,0.0
10503,32548,19343,19343,0,1.0,0.0
10504,32550,5867,5864,3,0.999,0.001
10505,32561,7899,6608,1291,0.837,0.163
10506,32563,22406,22406,0,1.0,0.0
10507,32564,2881,0,2881,0.0,1.0
10508,32565,5719,0,5719,0.0,1.0
10509,32566,33671,33533,138,0.996,0.004
10510,32567,3510,0,3510,0.0,1.0
10511,32568,3122,0,3122,0.0,1.0
10512,32569,11235,11235,0,1.0,0.0
10513,32570,28817,18663,10154,0.648,0.352
10514,32571,28881,24578,4303,0.851,0.149
10515,32577,4625,0,4625,0.0,1.0
10516,32578,30108,29953,155,0.995,0.005
10517,32579,9997,9997,0,1.0,0.0
10518,32580,3662,3658,4,0.999,0.001
10519,32583,25586,15240,10346,0.596,0.404
10520,32601,18585,18585,0,1.0,0.0
10521,32603,6741,6741,0,1.0,0.0
10522,32605,22925,22925,0,1.0,0.0
10523,32606,21833,20621,1212,0.944,0.056
10524,32607,29750,28730,1020,0.966,0.034
10525,32608,45842,42674,3168,0.931,0.069
10526,32609,18756,14548,4208,0.776,0.224
10527,32612,5458,5458,0,1.0,0.0
10528,32615,14295,5253,9042,0.367,0.633
10529,32616,872,872,0,1.0,0.0
10530,32617,4109,356,3753,0.087,0.913
10531,32618,7732,0,7732,0.0,1.0
10532,32619,4730,0,4730,0.0,1.0
10533,32621,5584,0,5584,0.0,1.0
10534,32622,1294,0,1294,0.0,1.0
10535,32625,1838,0,1838,0.0,1.0
10536,32626,8133,0,8133,0.0,1.0
10537,32628,4850,3773,1077,0.778,0.222
10538,32631,291,0,291,0.0,1.0
10539,32639,397,0,397,0.0,1.0
10540,32640,10510,0,10510,0.0,1.0
10541,32641,14291,11648,2643,0.815,0.185
10542,32643,10936,3022,7914,0.276,0.724
10543,32648,437,0,437,0.0,1.0
10544,32653,12844,11068,1776,0.862,0.138
10545,32656,14014,6143,7871,0.438,0.562
10546,32658,308,0,308,0.0,1.0
10547,32664,510,0,510,0.0,1.0
10548,32666,5916,219,5697,0.037,0.963
10549,32667,3794,0,3794,0.0,1.0
10550,32668,5082,0,5082,0.0,1.0
10551,32669,11623,2772,8851,0.238,0.762
10552,32680,10223,0,10223,0.0,1.0
10553,32681,136,0,136,0.0,1.0
10554,32683,151,0,151,0.0,1.0
10555,32686,5003,0,5003,0.0,1.0
10556,32692,295,0,295,0.0,1.0
10557,32693,12154,2724,9430,0.224,0.776
10558,32694,2142,0,2142,0.0,1.0
10559,32696,12071,3244,8827,0.269,0.731
10560,32697,253,0,253,0.0,1.0
10561,32701,21577,21577,0,1.0,0.0
10562,32702,2705,410,2295,0.152,0.848
10563,32703,46207,45386,821,0.982,0.018
10564,32707,35335,35335,0,1.0,0.0
10565,32708,42012,42012,0,1.0,0.0
10566,32709,2566,0,2566,0.0,1.0
10567,32712,41769,38875,2894,0.931,0.069
10568,32713,19491,17329,2162,0.889,0.111
10569,32714,34862,34862,0,1.0,0.0
10570,32720,29700,24102,5598,0.812,0.188
10571,32724,31826,28946,2880,0.91,0.09
10572,32725,44905,44097,808,0.982,0.018
10573,32726,20029,19898,131,0.993,0.007
10574,32730,5354,5354,0,1.0,0.0
10575,32732,5589,0,5589,0.0,1.0
10576,32735,3903,3263,640,0.836,0.164
10577,32736,9736,1460,8276,0.15,0.85
10578,32738,43830,42530,1300,0.97,0.03
10579,32744,3588,1781,1807,0.496,0.504
10580,32746,40571,40571,0,1.0,0.0
10581,32750,22713,22713,0,1.0,0.0
10582,32751,19928,19928,0,1.0,0.0
10583,32754,11313,3599,7714,0.318,0.682
10584,32757,23746,20141,3605,0.848,0.152
10585,32759,2871,386,2485,0.134,0.866
10586,32763,21263,20038,1225,0.942,0.058
10587,32764,3120,636,2484,0.204,0.796
10588,32765,56349,54441,1908,0.966,0.034
10589,32766,15698,13107,2591,0.835,0.165
10590,32767,2622,0,2622,0.0,1.0
10591,32771,49481,48831,650,0.987,0.013
10592,32773,28787,26701,2086,0.928,0.072
10593,32776,10262,5459,4803,0.532,0.468
10594,32778,18617,17009,1608,0.914,0.086
10595,32779,27556,27032,524,0.981,0.019
10596,32780,34628,31934,2694,0.922,0.078
10597,32784,11432,4987,6445,0.436,0.564
10598,32789,24557,24557,0,1.0,0.0
10599,32792,46914,46914,0,1.0,0.0
10600,32796,20139,19397,742,0.963,0.037
10601,32798,2550,2079,471,0.815,0.185
10602,32801,12050,12050,0,1.0,0.0
10603,32803,19020,19020,0,1.0,0.0
10604,32804,17312,17312,0,1.0,0.0
10605,32805,21810,21810,0,1.0,0.0
10606,32806,24820,24820,0,1.0,0.0
10607,32807,31465,31465,0,1.0,0.0
10608,32808,46334,46334,0,1.0,0.0
10609,32809,26773,26773,0,1.0,0.0
10610,32810,32210,32210,0,1.0,0.0
10611,32811,35825,35825,0,1.0,0.0
10612,32812,32844,32844,0,1.0,0.0
10613,32814,6151,6151,0,1.0,0.0
10614,32817,35105,35105,0,1.0,0.0
10615,32818,43911,43911,0,1.0,0.0
10616,32819,24976,24976,0,1.0,0.0
10617,32820,7974,5762,2212,0.723,0.277
10618,32821,21423,21423,0,1.0,0.0
10619,32822,53029,53029,0,1.0,0.0
10620,32824,37401,36391,1010,0.973,0.027
10621,32825,53024,53024,0,1.0,0.0
10622,32826,29347,29347,0,1.0,0.0
10623,32827,6362,5064,1298,0.796,0.204
10624,32828,57881,57391,490,0.992,0.008
10625,32829,17822,16414,1408,0.921,0.079
10626,32830,26,0,26,0.0,1.0
10627,32831,2542,2500,42,0.983,0.017
10628,32832,13787,10936,2851,0.793,0.207
10629,32833,9241,6262,2979,0.678,0.322
10630,32835,39633,39633,0,1.0,0.0
10631,32836,16647,16593,54,0.997,0.003
10632,32837,51219,51219,0,1.0,0.0
10633,32839,50279,50279,0,1.0,0.0
10634,32901,24521,24521,0,1.0,0.0
10635,32903,12869,12869,0,1.0,0.0
10636,32904,26710,26549,161,0.994,0.006
10637,32905,22084,22084,0,1.0,0.0
10638,32907,41870,41755,115,0.997,0.003
10639,32908,10892,10560,332,0.97,0.03
10640,32909,30120,28909,1211,0.96,0.04
10641,32920,9848,9848,0,1.0,0.0
10642,32922,14916,14916,0,1.0,0.0
10643,32925,1222,1222,0,1.0,0.0
10644,32926,22752,21055,1697,0.925,0.075
10645,32927,28092,27040,1052,0.963,0.037
10646,32931,13567,13567,0,1.0,0.0
10647,32934,17338,16690,648,0.963,0.037
10648,32935,39082,39082,0,1.0,0.0
10649,32937,24969,24969,0,1.0,0.0
10650,32940,31999,31018,981,0.969,0.031
10651,32948,6773,5294,1479,0.782,0.218
10652,32949,2248,219,2029,0.097,0.903
10653,32950,3982,1154,2828,0.29,0.71
10654,32951,10673,10510,163,0.985,0.015
10655,32952,19881,19314,567,0.971,0.029
10656,32953,22754,18869,3885,0.829,0.171
10657,32955,36374,35746,628,0.983,0.017
10658,32958,25366,24991,375,0.985,0.015
10659,32960,20037,20037,0,1.0,0.0
10660,32962,22716,22716,0,1.0,0.0
10661,32963,14911,14156,755,0.949,0.051
10662,32966,15626,14601,1025,0.934,0.066
10663,32967,19518,17804,1714,0.912,0.088
10664,32968,12830,11269,1561,0.878,0.122
10665,32970,303,303,0,1.0,0.0
10666,32976,9079,8407,672,0.926,0.074
10667,33001,315,0,315,0.0,1.0
10668,33004,15588,15571,17,0.999,0.001
10669,33009,39341,39341,0,1.0,0.0
10670,33010,46187,46187,0,1.0,0.0
10671,33012,72248,72248,0,1.0,0.0
10672,33013,33852,33852,0,1.0,0.0
10673,33014,40654,40654,0,1.0,0.0
10674,33015,63544,63544,0,1.0,0.0
10675,33016,45342,45342,0,1.0,0.0
10676,33018,46117,45846,271,0.994,0.006
10677,33019,15107,15065,42,0.997,0.003
10678,33020,41329,41329,0,1.0,0.0
10679,33021,45921,45921,0,1.0,0.0
10680,33023,63576,63576,0,1.0,0.0
10681,33024,63916,63916,0,1.0,0.0
10682,33025,59039,59039,0,1.0,0.0
10683,33026,28498,28498,0,1.0,0.0
10684,33027,57663,57663,0,1.0,0.0
10685,33028,26696,26696,0,1.0,0.0
10686,33029,45235,45235,0,1.0,0.0
10687,33030,34110,33449,661,0.981,0.019
10688,33031,5859,2853,3006,0.487,0.513
10689,33032,34088,33516,572,0.983,0.017
10690,33033,49028,49016,12,1.0,0.0
10691,33034,18613,17622,991,0.947,0.053
10692,33035,13497,13497,0,1.0,0.0
10693,33036,3035,2819,216,0.929,0.071
10694,33037,11612,9960,1652,0.858,0.142
10695,33039,122,122,0,1.0,0.0
10696,33040,32891,32095,796,0.976,0.024
10697,33042,5829,4059,1770,0.696,0.304
10698,33043,4313,3481,832,0.807,0.193
10699,33050,8922,8169,753,0.916,0.084
10700,33051,796,796,0,1.0,0.0
10701,33054,29061,29061,0,1.0,0.0
10702,33055,43194,43194,0,1.0,0.0
10703,33056,35059,35059,0,1.0,0.0
10704,33060,32154,32154,0,1.0,0.0
10705,33062,23948,23948,0,1.0,0.0
10706,33063,51019,51019,0,1.0,0.0
10707,33064,52969,52969,0,1.0,0.0
10708,33065,51921,51921,0,1.0,0.0
10709,33066,15760,15760,0,1.0,0.0
10710,33067,26458,26458,0,1.0,0.0
10711,33068,49824,49824,0,1.0,0.0
10712,33069,25700,25700,0,1.0,0.0
10713,33070,5344,5342,2,1.0,0.0
10714,33071,36964,36964,0,1.0,0.0
10715,33073,29168,29168,0,1.0,0.0
10716,33076,29751,29751,0,1.0,0.0
10717,33101,0,0,0,,
10718,33109,594,594,0,1.0,0.0
10719,33122,1,1,0,1.0,0.0
10720,33125,52677,52677,0,1.0,0.0
10721,33126,46867,46867,0,1.0,0.0
10722,33127,28909,28909,0,1.0,0.0
10723,33128,7562,7562,0,1.0,0.0
10724,33129,13833,13833,0,1.0,0.0
10725,33130,26108,26108,0,1.0,0.0
10726,33131,14917,14917,0,1.0,0.0
10727,33132,11165,11165,0,1.0,0.0
10728,33133,31926,31926,0,1.0,0.0
10729,33134,37456,37456,0,1.0,0.0
10730,33135,36066,36066,0,1.0,0.0
10731,33136,13791,13791,0,1.0,0.0
10732,33137,19410,19410,0,1.0,0.0
10733,33138,27571,27571,0,1.0,0.0
10734,33139,38613,38613,0,1.0,0.0
10735,33140,21210,21210,0,1.0,0.0
10736,33141,35249,35249,0,1.0,0.0
10737,33142,52606,52606,0,1.0,0.0
10738,33143,31407,31407,0,1.0,0.0
10739,33144,26903,26903,0,1.0,0.0
10740,33145,29758,29758,0,1.0,0.0
10741,33146,14995,14995,0,1.0,0.0
10742,33147,46933,46933,0,1.0,0.0
10743,33149,12389,12375,14,0.999,0.001
10744,33150,27811,27811,0,1.0,0.0
10745,33154,13971,13971,0,1.0,0.0
10746,33155,43788,43773,15,1.0,0.0
10747,33156,31315,31315,0,1.0,0.0
10748,33157,63226,63134,92,0.999,0.001
10749,33158,6694,6694,0,1.0,0.0
10750,33160,40053,40053,0,1.0,0.0
10751,33161,53710,53710,0,1.0,0.0
10752,33162,43539,43539,0,1.0,0.0
10753,33165,56149,56149,0,1.0,0.0
10754,33166,23038,23038,0,1.0,0.0
10755,33167,18846,18846,0,1.0,0.0
10756,33168,25792,25792,0,1.0,0.0
10757,33169,39353,39353,0,1.0,0.0
10758,33170,12253,11465,788,0.936,0.064
10759,33172,37664,37664,0,1.0,0.0
10760,33173,33141,33141,0,1.0,0.0
10761,33174,32524,32524,0,1.0,0.0
10762,33175,53206,53206,0,1.0,0.0
10763,33176,50170,50170,0,1.0,0.0
10764,33177,53191,53034,157,0.997,0.003
10765,33178,39489,39409,80,0.998,0.002
10766,33179,41332,41332,0,1.0,0.0
10767,33180,30840,30840,0,1.0,0.0
10768,33181,18413,18413,0,1.0,0.0
10769,33182,16929,16929,0,1.0,0.0
10770,33183,35949,35949,0,1.0,0.0
10771,33184,21075,21075,0,1.0,0.0
10772,33185,27189,27189,0,1.0,0.0
10773,33186,67137,67137,0,1.0,0.0
10774,33187,16315,14059,2256,0.862,0.138
10775,33189,23828,23828,0,1.0,0.0
10776,33190,11593,11593,0,1.0,0.0
10777,33193,46044,46044,0,1.0,0.0
10778,33194,7742,7269,473,0.939,0.061
10779,33196,43620,42928,692,0.984,0.016
10780,33301,14586,14586,0,1.0,0.0
10781,33304,17724,17724,0,1.0,0.0
10782,33305,11927,11927,0,1.0,0.0
10783,33306,3397,3397,0,1.0,0.0
10784,33308,28217,28217,0,1.0,0.0
10785,33309,33705,33705,0,1.0,0.0
10786,33311,63786,63786,0,1.0,0.0
10787,33312,49343,49343,0,1.0,0.0
10788,33313,56039,56039,0,1.0,0.0
10789,33314,21885,21885,0,1.0,0.0
10790,33315,12153,12153,0,1.0,0.0
10791,33316,10044,10044,0,1.0,0.0
10792,33317,35372,35372,0,1.0,0.0
10793,33319,44420,44420,0,1.0,0.0
10794,33321,44327,44327,0,1.0,0.0
10795,33322,37858,37858,0,1.0,0.0
10796,33323,18929,18929,0,1.0,0.0
10797,33324,42847,42847,0,1.0,0.0
10798,33325,27570,27570,0,1.0,0.0
10799,33326,31257,31242,15,1.0,0.0
10800,33327,22658,22656,2,1.0,0.0
10801,33328,27415,27415,0,1.0,0.0
10802,33330,14107,14107,0,1.0,0.0
10803,33331,23204,23204,0,1.0,0.0
10804,33332,11199,10979,220,0.98,0.02
10805,33334,28749,28749,0,1.0,0.0
10806,33351,32890,32890,0,1.0,0.0
10807,33401,24879,24879,0,1.0,0.0
10808,33403,12042,12042,0,1.0,0.0
10809,33404,27489,27489,0,1.0,0.0
10810,33405,19155,19155,0,1.0,0.0
10811,33406,26312,26312,0,1.0,0.0
10812,33407,29659,29659,0,1.0,0.0
10813,33408,16921,16921,0,1.0,0.0
10814,33409,29140,29140,0,1.0,0.0
10815,33410,32570,32570,0,1.0,0.0
10816,33411,65245,65214,31,1.0,0.0
10817,33412,14414,13527,887,0.938,0.062
10818,33413,15162,15162,0,1.0,0.0
10819,33414,53718,52774,944,0.982,0.018
10820,33415,44963,44963,0,1.0,0.0
10821,33417,29156,29156,0,1.0,0.0
10822,33418,36017,35173,844,0.977,0.023
10823,33426,20082,20082,0,1.0,0.0
10824,33428,38548,38548,0,1.0,0.0
10825,33430,21427,20018,1409,0.934,0.066
10826,33431,18290,18290,0,1.0,0.0
10827,33432,18715,18715,0,1.0,0.0
10828,33433,41722,41722,0,1.0,0.0
10829,33434,19260,19260,0,1.0,0.0
10830,33435,32104,32104,0,1.0,0.0
10831,33436,41896,41896,0,1.0,0.0
10832,33437,35938,35938,0,1.0,0.0
10833,33438,459,253,206,0.551,0.449
10834,33440,19743,12833,6910,0.65,0.35
10835,33441,26838,26838,0,1.0,0.0
10836,33442,28075,28075,0,1.0,0.0
10837,33444,20221,20221,0,1.0,0.0
10838,33445,29754,29754,0,1.0,0.0
10839,33446,22088,21194,894,0.96,0.04
10840,33449,10817,9812,1005,0.907,0.093
10841,33455,19980,17039,2941,0.853,0.147
10842,33458,49396,49225,171,0.997,0.003
10843,33460,30790,30790,0,1.0,0.0
10844,33461,40748,40748,0,1.0,0.0
10845,33462,30879,30879,0,1.0,0.0
10846,33463,53766,53766,0,1.0,0.0
10847,33467,48808,48808,0,1.0,0.0
10848,33469,14449,13784,665,0.954,0.046
10849,33470,26551,22290,4261,0.84,0.16
10850,33471,6818,3205,3613,0.47,0.53
10851,33472,19100,18625,475,0.975,0.025
10852,33473,6265,5856,409,0.935,0.065
10853,33476,7669,6926,743,0.903,0.097
10854,33477,13074,13074,0,1.0,0.0
10855,33478,12704,10962,1742,0.863,0.137
10856,33480,9549,9549,0,1.0,0.0
10857,33483,12093,12093,0,1.0,0.0
10858,33484,23443,23443,0,1.0,0.0
10859,33486,21720,21720,0,1.0,0.0
10860,33487,16421,16421,0,1.0,0.0
10861,33493,4926,4852,74,0.985,0.015
10862,33496,20969,20969,0,1.0,0.0
10863,33498,14557,14557,0,1.0,0.0
10864,33503,108,0,108,0.0,1.0
10865,33510,27610,27610,0,1.0,0.0
10866,33511,52003,52003,0,1.0,0.0
10867,33513,12086,3500,8586,0.29,0.71
10868,33514,1811,0,1811,0.0,1.0
10869,33521,599,0,599,0.0,1.0
10870,33523,18313,10615,7698,0.58,0.42
10871,33525,18439,11170,7269,0.606,0.394
10872,33527,15203,10715,4488,0.705,0.295
10873,33534,12839,12651,188,0.985,0.015
10874,33538,4789,3365,1424,0.703,0.297
10875,33540,8752,5788,2964,0.661,0.339
10876,33541,19759,18367,1392,0.93,0.07
10877,33542,20824,20777,47,0.998,0.002
10878,33543,21898,20173,1725,0.921,0.079
10879,33544,22800,21256,1544,0.932,0.068
10880,33545,13996,10382,3614,0.742,0.258
10881,33547,19813,13588,6225,0.686,0.314
10882,33548,5807,5807,0,1.0,0.0
10883,33549,16132,16132,0,1.0,0.0
10884,33556,22015,18075,3940,0.821,0.179
10885,33558,20064,20019,45,0.998,0.002
10886,33559,15427,14624,803,0.948,0.052
10887,33563,25488,25287,201,0.992,0.008
10888,33565,17975,10117,7858,0.563,0.437
10889,33566,19522,18615,907,0.954,0.046
10890,33567,11505,7739,3766,0.673,0.327
10891,33569,23074,22935,139,0.994,0.006
10892,33570,20758,19441,1317,0.937,0.063
10893,33572,14117,13616,501,0.965,0.035
10894,33573,19172,18827,345,0.982,0.018
10895,33576,3784,3055,729,0.807,0.193
10896,33578,36693,36249,444,0.988,0.012
10897,33579,25723,24867,856,0.967,0.033
10898,33584,25392,24194,1198,0.953,0.047
10899,33585,1058,0,1058,0.0,1.0
10900,33592,10091,6859,3232,0.68,0.32
10901,33594,32677,32677,0,1.0,0.0
10902,33596,29283,29283,0,1.0,0.0
10903,33597,8026,127,7899,0.016,0.984
10904,33598,13665,8452,5213,0.619,0.381
10905,33602,11515,11515,0,1.0,0.0
10906,33603,19100,19100,0,1.0,0.0
10907,33604,35485,35485,0,1.0,0.0
10908,33605,17073,17073,0,1.0,0.0
10909,33606,17746,17746,0,1.0,0.0
10910,33607,23541,23541,0,1.0,0.0
10911,33609,15999,15999,0,1.0,0.0
10912,33610,39222,39077,145,0.996,0.004
10913,33611,29478,29478,0,1.0,0.0
10914,33612,44601,44601,0,1.0,0.0
10915,33613,31990,31990,0,1.0,0.0
10916,33614,46449,46449,0,1.0,0.0
10917,33615,43453,43453,0,1.0,0.0
10918,33616,13560,13560,0,1.0,0.0
10919,33617,41443,41443,0,1.0,0.0
10920,33618,25570,25570,0,1.0,0.0
10921,33619,34581,34446,135,0.996,0.004
10922,33620,5158,5158,0,1.0,0.0
10923,33621,1643,1588,55,0.967,0.033
10924,33624,37457,37457,0,1.0,0.0
10925,33625,24645,24645,0,1.0,0.0
10926,33626,27557,27557,0,1.0,0.0
10927,33629,23638,23638,0,1.0,0.0
10928,33634,20225,20225,0,1.0,0.0
10929,33635,15741,15726,15,0.999,0.001
10930,33637,15351,15338,13,0.999,0.001
10931,33647,55034,53970,1064,0.981,0.019
10932,33701,15014,15014,0,1.0,0.0
10933,33702,29664,29664,0,1.0,0.0
10934,33703,23680,23680,0,1.0,0.0
10935,33704,16098,16098,0,1.0,0.0
10936,33705,26435,26435,0,1.0,0.0
10937,33706,15901,15901,0,1.0,0.0
10938,33707,24599,24599,0,1.0,0.0
10939,33708,15447,15447,0,1.0,0.0
10940,33709,26023,26023,0,1.0,0.0
10941,33710,32780,32780,0,1.0,0.0
10942,33711,19162,19162,0,1.0,0.0
10943,33712,25066,25066,0,1.0,0.0
10944,33713,29812,29812,0,1.0,0.0
10945,33714,18531,18531,0,1.0,0.0
10946,33715,7407,7311,96,0.987,0.013
10947,33716,15424,15424,0,1.0,0.0
10948,33744,148,148,0,1.0,0.0
10949,33755,26146,26146,0,1.0,0.0
10950,33756,31275,31275,0,1.0,0.0
10951,33759,17820,17820,0,1.0,0.0
10952,33760,15133,15133,0,1.0,0.0
10953,33761,18167,18167,0,1.0,0.0
10954,33762,8499,8499,0,1.0,0.0
10955,33763,17887,17887,0,1.0,0.0
10956,33764,24045,24045,0,1.0,0.0
10957,33765,13275,13275,0,1.0,0.0
10958,33767,8007,8007,0,1.0,0.0
10959,33770,25281,25281,0,1.0,0.0
10960,33771,29839,29839,0,1.0,0.0
10961,33772,22981,22981,0,1.0,0.0
10962,33773,16826,16826,0,1.0,0.0
10963,33774,17712,17712,0,1.0,0.0
10964,33776,12402,12402,0,1.0,0.0
10965,33777,17140,17140,0,1.0,0.0
10966,33778,14263,14263,0,1.0,0.0
10967,33781,25922,25922,0,1.0,0.0
10968,33782,20850,20850,0,1.0,0.0
10969,33785,5533,5533,0,1.0,0.0
10970,33786,1669,1669,0,1.0,0.0
10971,33801,33741,32622,1119,0.967,0.033
10972,33803,27094,27042,52,0.998,0.002
10973,33805,23153,22024,1129,0.951,0.049
10974,33809,28929,24404,4525,0.844,0.156
10975,33810,44254,40557,3697,0.916,0.084
10976,33811,20980,18959,2021,0.904,0.096
10977,33812,13166,12117,1049,0.92,0.08
10978,33813,31698,31655,43,0.999,0.001
10979,33815,14267,14267,0,1.0,0.0
10980,33823,28874,27976,898,0.969,0.031
10981,33825,24942,19006,5936,0.762,0.238
10982,33827,3036,1694,1342,0.558,0.442
10983,33830,27542,22554,4988,0.819,0.181
10984,33834,7448,4124,3324,0.554,0.446
10985,33837,20234,14837,5397,0.733,0.267
10986,33838,3515,3193,322,0.908,0.092
10987,33839,2756,2756,0,1.0,0.0
10988,33841,8722,5945,2777,0.682,0.318
10989,33843,11093,7626,3467,0.687,0.313
10990,33844,33804,24972,8832,0.739,0.261
10991,33847,227,155,72,0.683,0.317
10992,33848,851,527,324,0.619,0.381
10993,33849,856,0,856,0.0,1.0
10994,33850,7519,6833,686,0.909,0.091
10995,33851,907,763,144,0.841,0.159
10996,33852,21790,16351,5439,0.75,0.25
10997,33853,11161,10893,268,0.976,0.024
10998,33854,194,0,194,0.0,1.0
10999,33855,43,0,43,0.0,1.0
11000,33856,487,0,487,0.0,1.0
11001,33857,1728,0,1728,0.0,1.0
11002,33859,10582,7521,3061,0.711,0.289
11003,33860,22886,20819,2067,0.91,0.09
11004,33865,786,0,786,0.0,1.0
11005,33867,106,0,106,0.0,1.0
11006,33868,11720,4217,7503,0.36,0.64
11007,33870,20601,18715,1886,0.908,0.092
11008,33872,14158,13400,758,0.946,0.054
11009,33873,14742,8855,5887,0.601,0.399
11010,33875,11108,7123,3985,0.641,0.359
11011,33876,4968,3381,1587,0.681,0.319
11012,33877,276,218,58,0.79,0.21
11013,33880,37798,35187,2611,0.931,0.069
11014,33881,29345,29345,0,1.0,0.0
11015,33884,28763,28210,553,0.981,0.019
11016,33890,5060,1642,3418,0.325,0.675
11017,33896,6633,5647,986,0.851,0.149
11018,33897,14117,10725,3392,0.76,0.24
11019,33898,15355,4694,10661,0.306,0.694
11020,33901,19500,19500,0,1.0,0.0
11021,33903,20776,20749,27,0.999,0.001
11022,33904,30613,30613,0,1.0,0.0
11023,33905,31203,26227,4976,0.841,0.159
11024,33907,22138,22138,0,1.0,0.0
11025,33908,38251,37888,363,0.991,0.009
11026,33909,23119,23119,0,1.0,0.0
11027,33912,15392,14417,975,0.937,0.063
11028,33913,17103,15515,1588,0.907,0.093
11029,33914,35848,35837,11,1.0,0.0
11030,33916,20134,20134,0,1.0,0.0
11031,33917,28666,24040,4626,0.839,0.161
11032,33919,27837,27837,0,1.0,0.0
11033,33920,4947,0,4947,0.0,1.0
11034,33921,1720,0,1720,0.0,1.0
11035,33922,4055,0,4055,0.0,1.0
11036,33924,761,0,761,0.0,1.0
11037,33928,20830,19809,1021,0.951,0.049
11038,33930,1075,0,1075,0.0,1.0
11039,33931,10005,9999,6,0.999,0.001
11040,33935,20383,12054,8329,0.591,0.409
11041,33936,18994,18755,239,0.987,0.013
11042,33944,298,0,298,0.0,1.0
11043,33945,57,0,57,0.0,1.0
11044,33946,2125,856,1269,0.403,0.597
11045,33947,8180,7868,312,0.962,0.038
11046,33948,15958,15627,331,0.979,0.021
11047,33950,20699,20147,552,0.973,0.027
11048,33952,28382,28382,0,1.0,0.0
11049,33953,5522,5279,243,0.956,0.044
11050,33954,9290,9252,38,0.996,0.004
11051,33955,10060,6836,3224,0.68,0.32
11052,33956,3776,0,3776,0.0,1.0
11053,33957,6469,3668,2801,0.567,0.433
11054,33960,854,0,854,0.0,1.0
11055,33965,1648,1648,0,1.0,0.0
11056,33966,8251,8223,28,0.997,0.003
11057,33967,22799,22799,0,1.0,0.0
11058,33971,19730,19620,110,0.994,0.006
11059,33972,10880,9499,1381,0.873,0.127
11060,33973,10798,10798,0,1.0,0.0
11061,33974,11982,11696,286,0.976,0.024
11062,33976,12534,12530,4,1.0,0.0
11063,33980,10322,10322,0,1.0,0.0
11064,33981,9534,8650,884,0.907,0.093
11065,33982,9176,2630,6546,0.287,0.713
11066,33983,13954,13706,248,0.982,0.018
11067,33990,28173,28173,0,1.0,0.0
11068,33991,18010,17737,273,0.985,0.015
11069,33993,20628,19705,923,0.955,0.045
11070,34101,10,0,10,0.0,1.0
11071,34102,10460,10460,0,1.0,0.0
11072,34103,12150,12150,0,1.0,0.0
11073,34104,23691,23691,0,1.0,0.0
11074,34105,13933,13933,0,1.0,0.0
11075,34108,16874,16874,0,1.0,0.0
11076,34109,23338,23338,0,1.0,0.0
11077,34110,20762,20762,0,1.0,0.0
11078,34112,27002,26317,685,0.975,0.025
11079,34113,17971,17213,758,0.958,0.042
11080,34114,13653,9135,4518,0.669,0.331
11081,34116,30005,30005,0,1.0,0.0
11082,34117,14250,10309,3941,0.723,0.277
11083,34119,25756,24954,802,0.969,0.031
11084,34120,26147,14198,11949,0.543,0.457
11085,34134,14112,14112,0,1.0,0.0
11086,34135,37315,35741,1574,0.958,0.042
11087,34137,227,0,227,0.0,1.0
11088,34138,359,0,359,0.0,1.0
11089,34139,561,0,561,0.0,1.0
11090,34140,273,0,273,0.0,1.0
11091,34141,232,0,232,0.0,1.0
11092,34142,27304,23160,4144,0.848,0.152
11093,34145,16407,16128,279,0.983,0.017
11094,34201,3682,3682,0,1.0,0.0
11095,34202,19816,18722,1094,0.945,0.055
11096,34203,34862,34862,0,1.0,0.0
11097,34205,29656,29656,0,1.0,0.0
11098,34207,29728,29728,0,1.0,0.0
11099,34208,33121,32650,471,0.986,0.014
11100,34209,31816,31366,450,0.986,0.014
11101,34210,15916,15916,0,1.0,0.0
11102,34211,2775,1116,1659,0.402,0.598
11103,34212,15146,13432,1714,0.887,0.113
11104,34215,768,768,0,1.0,0.0
11105,34216,1503,1503,0,1.0,0.0
11106,34217,5007,5007,0,1.0,0.0
11107,34219,17135,12758,4377,0.745,0.255
11108,34221,39457,37087,2370,0.94,0.06
11109,34222,11952,11951,1,1.0,0.0
11110,34223,16875,15277,1598,0.905,0.095
11111,34224,15394,15308,86,0.994,0.006
11112,34228,6888,6888,0,1.0,0.0
11113,34229,7192,7186,6,0.999,0.001
11114,34231,30268,30268,0,1.0,0.0
11115,34232,30969,30969,0,1.0,0.0
11116,34233,16653,16653,0,1.0,0.0
11117,34234,19788,19788,0,1.0,0.0
11118,34235,13640,13640,0,1.0,0.0
11119,34236,12394,12394,0,1.0,0.0
11120,34237,16304,16304,0,1.0,0.0
11121,34238,17500,17423,77,0.996,0.004
11122,34239,15038,15038,0,1.0,0.0
11123,34240,11501,6944,4557,0.604,0.396
11124,34241,13590,10743,2847,0.791,0.209
11125,34242,8865,8865,0,1.0,0.0
11126,34243,26115,26115,0,1.0,0.0
11127,34251,6351,0,6351,0.0,1.0
11128,34266,31055,17270,13785,0.556,0.444
11129,34268,220,220,0,1.0,0.0
11130,34269,3615,1251,2364,0.346,0.654
11131,34275,16245,14253,1992,0.877,0.123
11132,34285,17599,17599,0,1.0,0.0
11133,34286,17970,17136,834,0.954,0.046
11134,34287,23859,23751,108,0.995,0.005
11135,34288,10856,10288,568,0.948,0.052
11136,34289,2199,1801,398,0.819,0.181
11137,34291,7125,6204,921,0.871,0.129
11138,34292,13516,12659,857,0.937,0.063
11139,34293,33001,31530,1471,0.955,0.045
11140,34420,16287,12412,3875,0.762,0.238
11141,34428,9109,2241,6868,0.246,0.754
11142,34429,8563,6218,2345,0.726,0.274
11143,34431,7815,3729,4086,0.477,0.523
11144,34432,12273,3605,8668,0.294,0.706
11145,34433,6647,1666,4981,0.251,0.749
11146,34434,8191,6532,1659,0.797,0.203
11147,34436,7938,2731,5207,0.344,0.656
11148,34442,14568,11424,3144,0.784,0.216
11149,34445,44,0,44,0.0,1.0
11150,34446,16326,13774,2552,0.844,0.156
11151,34448,10797,4797,6000,0.444,0.556
11152,34449,2809,0,2809,0.0,1.0
11153,34450,10293,7633,2660,0.742,0.258
11154,34452,11919,9138,2781,0.767,0.233
11155,34453,10112,8098,2014,0.801,0.199
11156,34461,10562,5000,5562,0.473,0.527
11157,34465,15870,13231,2639,0.834,0.166
11158,34470,17838,17838,0,1.0,0.0
11159,34471,25152,23993,1159,0.954,0.046
11160,34472,25968,24699,1269,0.951,0.049
11161,34473,17029,14033,2996,0.824,0.176
11162,34474,16062,14526,1536,0.904,0.096
11163,34475,12177,10082,2095,0.828,0.172
11164,34476,20862,18368,2494,0.88,0.12
11165,34479,13032,11711,1321,0.899,0.101
11166,34480,19068,15369,3699,0.806,0.194
11167,34481,17536,10695,6841,0.61,0.39
11168,34482,22500,10509,11991,0.467,0.533
11169,34484,3069,1260,1809,0.411,0.589
11170,34488,10291,4003,6288,0.389,0.611
11171,34491,27454,21703,5751,0.791,0.209
11172,34498,513,0,513,0.0,1.0
11173,34601,22336,12239,10097,0.548,0.452
11174,34602,7346,0,7346,0.0,1.0
11175,34604,10003,7806,2197,0.78,0.22
11176,34606,26208,26208,0,1.0,0.0
11177,34607,8133,3745,4388,0.46,0.54
11178,34608,31099,31099,0,1.0,0.0
11179,34609,37129,37054,75,0.998,0.002
11180,34610,12907,6819,6088,0.528,0.472
11181,34613,17814,16437,1377,0.923,0.077
11182,34614,6692,1759,4933,0.263,0.737
11183,34637,6297,4896,1401,0.778,0.222
11184,34638,20048,17955,2093,0.896,0.104
11185,34639,24092,23134,958,0.96,0.04
11186,34652,24147,24147,0,1.0,0.0
11187,34653,30756,30756,0,1.0,0.0
11188,34654,21716,20708,1008,0.954,0.046
11189,34655,38464,36697,1767,0.954,0.046
11190,34661,297,0,297,0.0,1.0
11191,34667,32144,30164,1980,0.938,0.062
11192,34668,42619,41507,1112,0.974,0.026
11193,34669,12648,10659,1989,0.843,0.157
11194,34677,20842,20842,0,1.0,0.0
11195,34679,99,0,99,0.0,1.0
11196,34681,1294,1294,0,1.0,0.0
11197,34683,31268,31268,0,1.0,0.0
11198,34684,25847,25847,0,1.0,0.0
11199,34685,17286,17121,165,0.99,0.01
11200,34688,7274,5184,2090,0.713,0.287
11201,34689,26132,26132,0,1.0,0.0
11202,34690,13137,13137,0,1.0,0.0
11203,34691,21079,20969,110,0.995,0.005
11204,34695,17496,17496,0,1.0,0.0
11205,34698,37240,36988,252,0.993,0.007
11206,34705,2500,1764,736,0.706,0.294
11207,34711,51847,50024,1823,0.965,0.035
11208,34714,14685,12561,2124,0.855,0.145
11209,34715,15455,11718,3737,0.758,0.242
11210,34731,10815,8632,2183,0.798,0.202
11211,34734,3835,3835,0,1.0,0.0
11212,34736,13961,8437,5524,0.604,0.396
11213,34737,2523,939,1584,0.372,0.628
11214,34739,793,0,793,0.0,1.0
11215,34741,40828,40828,0,1.0,0.0
11216,34743,33632,33632,0,1.0,0.0
11217,34744,44142,43262,880,0.98,0.02
11218,34746,35022,32237,2785,0.92,0.08
11219,34747,13692,10842,2850,0.792,0.208
11220,34748,38246,37111,1135,0.97,0.03
11221,34753,5353,4097,1256,0.765,0.235
11222,34756,3006,2310,696,0.768,0.232
11223,34758,30879,29803,1076,0.965,0.035
11224,34759,30170,25288,4882,0.838,0.162
11225,34760,875,875,0,1.0,0.0
11226,34761,37500,37500,0,1.0,0.0
11227,34762,622,470,152,0.756,0.244
11228,34769,21399,21374,25,0.999,0.001
11229,34771,14280,9224,5056,0.646,0.354
11230,34772,22770,19620,3150,0.862,0.138
11231,34773,2983,0,2983,0.0,1.0
11232,34785,17406,7470,9936,0.429,0.571
11233,34786,28092,28092,0,1.0,0.0
11234,34787,46083,43598,2485,0.946,0.054
11235,34788,17519,14919,2600,0.852,0.148
11236,34797,1293,923,370,0.714,0.286
11237,34945,5514,1605,3909,0.291,0.709
11238,34946,6025,5834,191,0.968,0.032
11239,34947,12186,11835,351,0.971,0.029
11240,34949,7103,7067,36,0.995,0.005
11241,34950,15436,15436,0,1.0,0.0
11242,34951,14115,11241,2874,0.796,0.204
11243,34952,38285,38118,167,0.996,0.004
11244,34953,61494,61494,0,1.0,0.0
11245,34956,9874,6503,3371,0.659,0.341
11246,34957,22257,22257,0,1.0,0.0
11247,34972,20180,9926,10254,0.492,0.508
11248,34974,23661,15452,8209,0.653,0.347
11249,34981,4239,3678,561,0.868,0.132
11250,34982,24544,24492,52,0.998,0.002
11251,34983,38480,38480,0,1.0,0.0
11252,34984,13764,13764,0,1.0,0.0
11253,34986,23297,23171,126,0.995,0.005
11254,34987,6118,5088,1030,0.832,0.168
11255,34990,27707,24103,3604,0.87,0.13
11256,34994,15967,15967,0,1.0,0.0
11257,34996,10649,10649,0,1.0,0.0
11258,34997,40405,39648,757,0.981,0.019
11259,35004,10427,6676,3751,0.64,0.36
11260,35005,7942,6334,1608,0.798,0.202
11261,35006,3121,0,3121,0.0,1.0
11262,35007,26225,23735,2490,0.905,0.095
11263,35010,20816,9400,11416,0.452,0.548
11264,35013,124,124,0,1.0,0.0
11265,35014,4546,0,4546,0.0,1.0
11266,35016,16778,7933,8845,0.473,0.527
11267,35019,2117,0,2117,0.0,1.0
11268,35020,27139,27053,86,0.997,0.003
11269,35022,18888,13243,5645,0.701,0.299
11270,35023,25436,15862,9574,0.624,0.376
11271,35031,7933,0,7933,0.0,1.0
11272,35032,66,66,0,1.0,0.0
11273,35033,3403,0,3403,0.0,1.0
11274,35034,5541,3321,2220,0.599,0.401
11275,35035,1581,0,1581,0.0,1.0
11276,35036,297,244,53,0.822,0.178
11277,35040,14965,11808,3157,0.789,0.211
11278,35042,5831,2204,3627,0.378,0.622
11279,35043,9234,2174,7060,0.235,0.765
11280,35044,7713,4494,3219,0.583,0.417
11281,35045,14870,5677,9193,0.382,0.618
11282,35046,5108,0,5108,0.0,1.0
11283,35049,3996,0,3996,0.0,1.0
11284,35051,8787,2642,6145,0.301,0.699
11285,35052,277,0,277,0.0,1.0
11286,35053,2617,0,2617,0.0,1.0
11287,35054,4101,1368,2733,0.334,0.666
11288,35055,19427,14390,5037,0.741,0.259
11289,35057,12630,1125,11505,0.089,0.911
11290,35058,9936,2104,7832,0.212,0.788
11291,35060,414,400,14,0.966,0.034
11292,35061,1465,1465,0,1.0,0.0
11293,35062,7944,1809,6135,0.228,0.772
11294,35063,3866,65,3801,0.017,0.983
11295,35064,11458,11458,0,1.0,0.0
11296,35068,7232,6831,401,0.945,0.055
11297,35070,265,0,265,0.0,1.0
11298,35071,15661,13470,2191,0.86,0.14
11299,35072,5193,0,5193,0.0,1.0
11300,35073,2382,1346,1036,0.565,0.435
11301,35074,93,93,0,1.0,0.0
11302,35077,13142,3297,9845,0.251,0.749
11303,35078,2082,0,2082,0.0,1.0
11304,35079,8810,0,8810,0.0,1.0
11305,35080,15881,13892,1989,0.875,0.125
11306,35082,7,0,7,0.0,1.0
11307,35083,3268,0,3268,0.0,1.0
11308,35085,8933,0,8933,0.0,1.0
11309,35087,2115,0,2115,0.0,1.0
11310,35089,2238,0,2238,0.0,1.0
11311,35091,2719,1040,1679,0.382,0.618
11312,35094,14212,9477,4735,0.667,0.333
11313,35096,7815,0,7815,0.0,1.0
11314,35097,1748,0,1748,0.0,1.0
11315,35098,1375,0,1375,0.0,1.0
11316,35111,16140,8062,8078,0.5,0.5
11317,35112,801,0,801,0.0,1.0
11318,35114,7172,6868,304,0.958,0.042
11319,35115,14118,7167,6951,0.508,0.492
11320,35116,4240,2076,2164,0.49,0.51
11321,35117,5367,3968,1399,0.739,0.261
11322,35118,3138,1501,1637,0.478,0.522
11323,35119,116,95,21,0.819,0.181
11324,35120,13842,0,13842,0.0,1.0
11325,35121,15570,5250,10320,0.337,0.663
11326,35124,23020,22111,909,0.961,0.039
11327,35125,10456,4886,5570,0.467,0.533
11328,35126,21725,15697,6028,0.723,0.277
11329,35127,10099,9912,187,0.981,0.019
11330,35128,10197,4025,6172,0.395,0.605
11331,35130,3233,195,3038,0.06,0.94
11332,35131,4159,0,4159,0.0,1.0
11333,35133,3907,382,3525,0.098,0.902
11334,35135,1812,817,995,0.451,0.549
11335,35136,1796,0,1796,0.0,1.0
11336,35139,150,0,150,0.0,1.0
11337,35143,3281,0,3281,0.0,1.0
11338,35146,10948,2775,8173,0.253,0.747
11339,35147,5468,2770,2698,0.507,0.493
11340,35148,2702,1974,728,0.731,0.269
11341,35149,630,0,630,0.0,1.0
11342,35150,18472,12171,6301,0.659,0.341
11343,35151,7632,1260,6372,0.165,0.835
11344,35160,26822,13493,13329,0.503,0.497
11345,35171,3281,108,3173,0.033,0.967
11346,35172,2986,0,2986,0.0,1.0
11347,35173,25176,19630,5546,0.78,0.22
11348,35175,5041,8,5033,0.002,0.998
11349,35176,921,0,921,0.0,1.0
11350,35178,3378,0,3378,0.0,1.0
11351,35179,8958,388,8570,0.043,0.957
11352,35180,13794,0,13794,0.0,1.0
11353,35183,706,0,706,0.0,1.0
11354,35184,5841,46,5795,0.008,0.992
11355,35186,4931,0,4931,0.0,1.0
11356,35187,32,32,0,1.0,0.0
11357,35188,2715,1428,1287,0.526,0.474
11358,35203,3798,3798,0,1.0,0.0
11359,35204,10337,10337,0,1.0,0.0
11360,35205,19686,19686,0,1.0,0.0
11361,35206,17177,17177,0,1.0,0.0
11362,35207,9010,8817,193,0.979,0.021
11363,35208,14855,14855,0,1.0,0.0
11364,35209,29544,29544,0,1.0,0.0
11365,35210,13952,13322,630,0.955,0.045
11366,35211,26236,25301,935,0.964,0.036
11367,35212,11539,11539,0,1.0,0.0
11368,35213,13185,13185,0,1.0,0.0
11369,35214,19592,18702,890,0.955,0.045
11370,35215,46951,46125,826,0.982,0.018
11371,35216,36408,36408,0,1.0,0.0
11372,35217,13729,13408,321,0.977,0.023
11373,35218,7353,7353,0,1.0,0.0
11374,35221,4834,4834,0,1.0,0.0
11375,35222,7884,7884,0,1.0,0.0
11376,35223,11043,11043,0,1.0,0.0
11377,35224,6094,5930,164,0.973,0.027
11378,35226,31471,31217,254,0.992,0.008
11379,35228,10419,10419,0,1.0,0.0
11380,35229,940,940,0,1.0,0.0
11381,35233,1308,1308,0,1.0,0.0
11382,35234,6311,6311,0,1.0,0.0
11383,35235,19484,19484,0,1.0,0.0
11384,35242,49545,47880,1665,0.966,0.034
11385,35243,17328,17328,0,1.0,0.0
11386,35244,32390,32385,5,1.0,0.0
11387,35254,1403,1403,0,1.0,0.0
11388,35401,39878,38972,906,0.977,0.023
11389,35404,21251,20516,735,0.965,0.035
11390,35405,37661,35091,2570,0.932,0.068
11391,35406,13864,12348,1516,0.891,0.109
11392,35441,1060,0,1060,0.0,1.0
11393,35442,4972,0,4972,0.0,1.0
11394,35443,2009,0,2009,0.0,1.0
11395,35444,3699,0,3699,0.0,1.0
11396,35446,2234,0,2234,0.0,1.0
11397,35447,3460,0,3460,0.0,1.0
11398,35452,3880,674,3206,0.174,0.826
11399,35453,11127,4602,6525,0.414,0.586
11400,35456,3759,806,2953,0.214,0.786
11401,35457,82,0,82,0.0,1.0
11402,35458,594,0,594,0.0,1.0
11403,35459,872,0,872,0.0,1.0
11404,35460,834,0,834,0.0,1.0
11405,35461,1952,0,1952,0.0,1.0
11406,35462,5061,0,5061,0.0,1.0
11407,35463,1749,0,1749,0.0,1.0
11408,35464,654,0,654,0.0,1.0
11409,35466,6075,0,6075,0.0,1.0
11410,35469,221,0,221,0.0,1.0
11411,35470,5468,0,5468,0.0,1.0
11412,35473,14909,12519,2390,0.84,0.16
11413,35474,6180,2958,3222,0.479,0.521
11414,35475,14507,5107,9400,0.352,0.648
11415,35476,8106,8099,7,0.999,0.001
11416,35477,335,0,335,0.0,1.0
11417,35480,1343,0,1343,0.0,1.0
11418,35481,3668,0,3668,0.0,1.0
11419,35490,3857,294,3563,0.076,0.924
11420,35501,10424,7253,3171,0.696,0.304
11421,35503,9068,1405,7663,0.155,0.845
11422,35504,13596,5498,8098,0.404,0.596
11423,35540,2415,0,2415,0.0,1.0
11424,35541,3597,0,3597,0.0,1.0
11425,35542,1021,0,1021,0.0,1.0
11426,35543,1137,0,1137,0.0,1.0
11427,35544,673,0,673,0.0,1.0
11428,35545,100,0,100,0.0,1.0
11429,35546,3901,0,3901,0.0,1.0
11430,35548,1558,0,1558,0.0,1.0
11431,35549,4341,0,4341,0.0,1.0
11432,35550,5605,0,5605,0.0,1.0
11433,35552,1044,0,1044,0.0,1.0
11434,35553,4680,0,4680,0.0,1.0
11435,35554,1186,0,1186,0.0,1.0
11436,35555,10177,3408,6769,0.335,0.665
11437,35559,57,0,57,0.0,1.0
11438,35563,4340,0,4340,0.0,1.0
11439,35564,2361,0,2361,0.0,1.0
11440,35565,13485,3922,9563,0.291,0.709
11441,35570,11145,3207,7938,0.288,0.712
11442,35571,895,0,895,0.0,1.0
11443,35572,1131,0,1131,0.0,1.0
11444,35574,1507,0,1507,0.0,1.0
11445,35575,1018,0,1018,0.0,1.0
11446,35576,3217,0,3217,0.0,1.0
11447,35577,38,0,38,0.0,1.0
11448,35578,5833,0,5833,0.0,1.0
11449,35579,3136,0,3136,0.0,1.0
11450,35580,3791,0,3791,0.0,1.0
11451,35581,5778,0,5778,0.0,1.0
11452,35582,4093,0,4093,0.0,1.0
11453,35584,460,0,460,0.0,1.0
11454,35585,1418,0,1418,0.0,1.0
11455,35586,4469,0,4469,0.0,1.0
11456,35587,1025,0,1025,0.0,1.0
11457,35592,4664,0,4664,0.0,1.0
11458,35593,1931,0,1931,0.0,1.0
11459,35594,7794,0,7794,0.0,1.0
11460,35601,34434,34431,3,1.0,0.0
11461,35603,30545,23054,7491,0.755,0.245
11462,35610,2252,0,2252,0.0,1.0
11463,35611,25251,14907,10344,0.59,0.41
11464,35613,20546,10175,10371,0.495,0.505
11465,35614,7456,2257,5199,0.303,0.697
11466,35615,68,0,68,0.0,1.0
11467,35616,4043,0,4043,0.0,1.0
11468,35618,1870,0,1870,0.0,1.0
11469,35619,5135,0,5135,0.0,1.0
11470,35620,8868,491,8377,0.055,0.945
11471,35621,2852,0,2852,0.0,1.0
11472,35622,7388,0,7388,0.0,1.0
11473,35630,32629,32499,130,0.996,0.004
11474,35633,20877,8266,12611,0.396,0.604
11475,35634,9711,3326,6385,0.342,0.658
11476,35640,24267,13484,10783,0.556,0.444
11477,35643,2941,0,2941,0.0,1.0
11478,35645,14060,2917,11143,0.207,0.793
11479,35646,4635,0,4635,0.0,1.0
11480,35647,1030,0,1030,0.0,1.0
11481,35648,3635,0,3635,0.0,1.0
11482,35649,68,0,68,0.0,1.0
11483,35650,13971,2919,11052,0.209,0.791
11484,35651,1312,0,1312,0.0,1.0
11485,35652,8190,0,8190,0.0,1.0
11486,35653,11150,7317,3833,0.656,0.344
11487,35654,8685,2475,6210,0.285,0.715
11488,35660,9042,9042,0,1.0,0.0
11489,35661,16617,12348,4269,0.743,0.257
11490,35670,7676,0,7676,0.0,1.0
11491,35671,2107,0,2107,0.0,1.0
11492,35672,6445,0,6445,0.0,1.0
11493,35673,8199,2473,5726,0.302,0.698
11494,35674,18475,8750,9725,0.474,0.526
11495,35677,1921,0,1921,0.0,1.0
11496,35739,5146,0,5146,0.0,1.0
11497,35740,3482,2164,1318,0.621,0.379
11498,35741,2933,2160,773,0.736,0.264
11499,35744,2570,0,2570,0.0,1.0
11500,35745,288,0,288,0.0,1.0
11501,35746,856,0,856,0.0,1.0
11502,35747,5901,0,5901,0.0,1.0
11503,35748,6276,604,5672,0.096,0.904
11504,35749,20575,17141,3434,0.833,0.167
11505,35750,12783,3761,9022,0.294,0.706
11506,35751,265,0,265,0.0,1.0
11507,35752,2047,0,2047,0.0,1.0
11508,35754,5362,0,5362,0.0,1.0
11509,35755,586,0,586,0.0,1.0
11510,35756,9016,5002,4014,0.555,0.445
11511,35757,12840,12679,161,0.987,0.013
11512,35758,41875,41873,2,1.0,0.0
11513,35759,6406,4718,1688,0.736,0.264
11514,35760,5065,0,5065,0.0,1.0
11515,35761,11630,3059,8571,0.263,0.737
11516,35763,14216,10928,3288,0.769,0.231
11517,35764,653,0,653,0.0,1.0
11518,35765,4013,0,4013,0.0,1.0
11519,35766,150,0,150,0.0,1.0
11520,35768,11581,5357,6224,0.463,0.537
11521,35769,9537,4712,4825,0.494,0.506
11522,35771,3645,0,3645,0.0,1.0
11523,35772,4908,0,4908,0.0,1.0
11524,35773,13018,2320,10698,0.178,0.822
11525,35774,165,0,165,0.0,1.0
11526,35775,636,0,636,0.0,1.0
11527,35776,3395,0,3395,0.0,1.0
11528,35801,21509,21503,6,1.0,0.0
11529,35802,21297,20764,533,0.975,0.025
11530,35803,25471,24111,1360,0.947,0.053
11531,35805,22498,22498,0,1.0,0.0
11532,35806,18951,18763,188,0.99,0.01
11533,35808,1946,1529,417,0.786,0.214
11534,35810,30617,28957,1660,0.946,0.054
11535,35811,25955,22939,3016,0.884,0.116
11536,35816,15228,15228,0,1.0,0.0
11537,35824,6070,5852,218,0.964,0.036
11538,35896,636,636,0,1.0,0.0
11539,35901,20045,15994,4051,0.798,0.202
11540,35903,18088,14439,3649,0.798,0.202
11541,35904,14194,11364,2830,0.801,0.199
11542,35905,6410,2416,3994,0.377,0.623
11543,35906,9897,7355,2542,0.743,0.257
11544,35907,8345,6370,1975,0.763,0.237
11545,35950,20826,15673,5153,0.753,0.247
11546,35951,13098,4727,8371,0.361,0.639
11547,35952,7727,0,7727,0.0,1.0
11548,35953,7319,0,7319,0.0,1.0
11549,35954,12416,6203,6213,0.5,0.5
11550,35956,8842,1145,7697,0.129,0.871
11551,35957,15693,8503,7190,0.542,0.458
11552,35958,3582,0,3582,0.0,1.0
11553,35959,4836,618,4218,0.128,0.872
11554,35960,10087,2654,7433,0.263,0.737
11555,35961,6514,0,6514,0.0,1.0
11556,35962,8300,0,8300,0.0,1.0
11557,35963,1704,0,1704,0.0,1.0
11558,35966,3914,0,3914,0.0,1.0
11559,35967,16630,6810,9820,0.41,0.59
11560,35968,4575,208,4367,0.045,0.955
11561,35971,4914,0,4914,0.0,1.0
11562,35972,1139,0,1139,0.0,1.0
11563,35973,2870,0,2870,0.0,1.0
11564,35974,1589,0,1589,0.0,1.0
11565,35975,1058,0,1058,0.0,1.0
11566,35976,16272,6838,9434,0.42,0.58
11567,35978,5390,0,5390,0.0,1.0
11568,35979,1398,0,1398,0.0,1.0
11569,35980,5161,0,5161,0.0,1.0
11570,35981,2141,0,2141,0.0,1.0
11571,35983,3738,435,3303,0.116,0.884
11572,35984,1889,0,1889,0.0,1.0
11573,35986,7744,0,7744,0.0,1.0
11574,35987,2666,0,2666,0.0,1.0
11575,35988,1940,0,1940,0.0,1.0
11576,35989,3573,0,3573,0.0,1.0
11577,35990,38,0,38,0.0,1.0
11578,36003,1975,0,1975,0.0,1.0
11579,36005,1522,0,1522,0.0,1.0
11580,36006,1313,0,1313,0.0,1.0
11581,36009,2566,0,2566,0.0,1.0
11582,36010,4677,0,4677,0.0,1.0
11583,36013,562,0,562,0.0,1.0
11584,36016,5150,0,5150,0.0,1.0
11585,36017,3318,0,3318,0.0,1.0
11586,36020,1123,713,410,0.635,0.365
11587,36022,13092,5316,7776,0.406,0.594
11588,36024,5428,0,5428,0.0,1.0
11589,36025,5729,4992,737,0.871,0.129
11590,36026,1089,0,1089,0.0,1.0
11591,36027,16261,8844,7417,0.544,0.456
11592,36028,1746,0,1746,0.0,1.0
11593,36029,723,0,723,0.0,1.0
11594,36030,491,0,491,0.0,1.0
11595,36031,156,0,156,0.0,1.0
11596,36032,2339,0,2339,0.0,1.0
11597,36033,4299,0,4299,0.0,1.0
11598,36034,807,0,807,0.0,1.0
11599,36035,1913,0,1913,0.0,1.0
11600,36036,2003,0,2003,0.0,1.0
11601,36037,14074,6026,8048,0.428,0.572
11602,36038,57,0,57,0.0,1.0
11603,36039,253,0,253,0.0,1.0
11604,36040,3976,0,3976,0.0,1.0
11605,36041,1318,0,1318,0.0,1.0
11606,36042,1500,0,1500,0.0,1.0
11607,36043,3666,223,3443,0.061,0.939
11608,36046,1490,0,1490,0.0,1.0
11609,36047,1396,0,1396,0.0,1.0
11610,36048,1459,0,1459,0.0,1.0
11611,36049,5706,0,5706,0.0,1.0
11612,36051,2304,0,2304,0.0,1.0
11613,36052,739,0,739,0.0,1.0
11614,36053,1967,0,1967,0.0,1.0
11615,36054,15066,13957,1109,0.926,0.074
11616,36064,6753,2160,4593,0.32,0.68
11617,36066,19089,17557,1532,0.92,0.08
11618,36067,26954,15098,11856,0.56,0.44
11619,36069,1935,0,1935,0.0,1.0
11620,36071,766,0,766,0.0,1.0
11621,36075,2226,0,2226,0.0,1.0
11622,36078,13179,4040,9139,0.307,0.693
11623,36079,9339,3976,5363,0.426,0.574
11624,36080,2271,0,2271,0.0,1.0
11625,36081,15267,10283,4984,0.674,0.326
11626,36082,1667,1638,29,0.983,0.017
11627,36083,9563,4912,4651,0.514,0.486
11628,36088,4767,4624,143,0.97,0.03
11629,36089,8760,5307,3453,0.606,0.394
11630,36091,3648,0,3648,0.0,1.0
11631,36092,20274,7163,13111,0.353,0.647
11632,36093,9456,470,8986,0.05,0.95
11633,36104,9468,9444,24,0.997,0.003
11634,36105,12043,10551,1492,0.876,0.124
11635,36106,15211,15211,0,1.0,0.0
11636,36107,9589,9589,0,1.0,0.0
11637,36108,21306,18031,3275,0.846,0.154
11638,36109,24777,24766,11,1.0,0.0
11639,36110,12997,11462,1535,0.882,0.118
11640,36111,12176,12176,0,1.0,0.0
11641,36112,553,553,0,1.0,0.0
11642,36113,1902,1884,18,0.991,0.009
11643,36115,623,623,0,1.0,0.0
11644,36116,43790,40997,2793,0.936,0.064
11645,36117,50268,47630,2638,0.948,0.052
11646,36201,20156,16657,3499,0.826,0.174
11647,36203,18799,17587,1212,0.936,0.064
11648,36205,635,373,262,0.587,0.413
11649,36206,11427,10368,1059,0.907,0.093
11650,36207,19801,13987,5814,0.706,0.294
11651,36250,4603,1081,3522,0.235,0.765
11652,36251,5103,0,5103,0.0,1.0
11653,36255,969,0,969,0.0,1.0
11654,36256,1570,0,1570,0.0,1.0
11655,36258,1599,0,1599,0.0,1.0
11656,36260,4247,2255,1992,0.531,0.469
11657,36262,1448,0,1448,0.0,1.0
11658,36263,658,0,658,0.0,1.0
11659,36264,8659,0,8659,0.0,1.0
11660,36265,21060,12742,8318,0.605,0.395
11661,36266,5582,0,5582,0.0,1.0
11662,36267,35,0,35,0.0,1.0
11663,36268,5432,282,5150,0.052,0.948
11664,36269,1395,0,1395,0.0,1.0
11665,36271,6023,31,5992,0.005,0.995
11666,36272,13389,3666,9723,0.274,0.726
11667,36273,2914,0,2914,0.0,1.0
11668,36274,11199,4275,6924,0.382,0.618
11669,36276,2592,0,2592,0.0,1.0
11670,36277,5420,4464,956,0.824,0.176
11671,36278,4366,0,4366,0.0,1.0
11672,36279,2645,0,2645,0.0,1.0
11673,36280,3932,0,3932,0.0,1.0
11674,36301,35759,26996,8763,0.755,0.245
11675,36303,30217,26390,3827,0.873,0.127
11676,36305,14470,13052,1418,0.902,0.098
11677,36310,6783,0,6783,0.0,1.0
11678,36311,2770,0,2770,0.0,1.0
11679,36312,6187,67,6120,0.011,0.989
11680,36313,285,0,285,0.0,1.0
11681,36314,595,0,595,0.0,1.0
11682,36316,1722,0,1722,0.0,1.0
11683,36317,590,0,590,0.0,1.0
11684,36318,1296,0,1296,0.0,1.0
11685,36319,2276,0,2276,0.0,1.0
11686,36320,3837,0,3837,0.0,1.0
11687,36321,1632,375,1257,0.23,0.77
11688,36322,9072,4460,4612,0.492,0.508
11689,36323,8255,0,8255,0.0,1.0
11690,36330,35530,29118,6412,0.82,0.18
11691,36340,5490,2654,2836,0.483,0.517
11692,36343,1579,0,1579,0.0,1.0
11693,36344,5732,0,5732,0.0,1.0
11694,36345,7822,2139,5683,0.273,0.727
11695,36346,1456,0,1456,0.0,1.0
11696,36350,6540,2736,3804,0.418,0.582
11697,36351,3146,0,3146,0.0,1.0
11698,36352,4885,0,4885,0.0,1.0
11699,36353,1968,0,1968,0.0,1.0
11700,36360,20157,12066,8091,0.599,0.401
11701,36362,4637,2849,1788,0.614,0.386
11702,36370,972,0,972,0.0,1.0
11703,36371,720,266,454,0.369,0.631
11704,36373,581,0,581,0.0,1.0
11705,36374,970,0,970,0.0,1.0
11706,36375,7390,0,7390,0.0,1.0
11707,36376,2445,0,2445,0.0,1.0
11708,36401,8314,2520,5794,0.303,0.697
11709,36420,10673,5604,5069,0.525,0.475
11710,36421,9241,1051,8190,0.114,0.886
11711,36425,1008,0,1008,0.0,1.0
11712,36426,16202,6866,9336,0.424,0.576
11713,36432,2420,0,2420,0.0,1.0
11714,36435,579,0,579,0.0,1.0
11715,36436,531,0,531,0.0,1.0
11716,36439,583,0,583,0.0,1.0
11717,36441,3576,551,3025,0.154,0.846
11718,36442,3555,0,3555,0.0,1.0
11719,36444,702,0,702,0.0,1.0
11720,36445,5050,0,5050,0.0,1.0
11721,36446,490,0,490,0.0,1.0
11722,36451,4977,0,4977,0.0,1.0
11723,36453,2198,0,2198,0.0,1.0
11724,36454,51,0,51,0.0,1.0
11725,36455,465,0,465,0.0,1.0
11726,36456,1820,0,1820,0.0,1.0
11727,36460,10738,4834,5904,0.45,0.55
11728,36467,10058,4806,5252,0.478,0.522
11729,36470,98,0,98,0.0,1.0
11730,36471,1257,0,1257,0.0,1.0
11731,36473,106,0,106,0.0,1.0
11732,36474,2926,0,2926,0.0,1.0
11733,36475,2208,0,2208,0.0,1.0
11734,36476,51,0,51,0.0,1.0
11735,36477,4946,0,4946,0.0,1.0
11736,36480,1773,0,1773,0.0,1.0
11737,36481,593,0,593,0.0,1.0
11738,36482,1090,0,1090,0.0,1.0
11739,36483,536,0,536,0.0,1.0
11740,36502,18355,6565,11790,0.358,0.642
11741,36505,1481,161,1320,0.109,0.891
11742,36507,19090,7486,11604,0.392,0.608
11743,36509,1983,1709,274,0.862,0.138
11744,36511,764,0,764,0.0,1.0
11745,36512,46,0,46,0.0,1.0
11746,36513,555,0,555,0.0,1.0
11747,36518,2842,0,2842,0.0,1.0
11748,36521,5431,0,5431,0.0,1.0
11749,36522,7183,0,7183,0.0,1.0
11750,36523,2818,643,2175,0.228,0.772
11751,36524,1232,0,1232,0.0,1.0
11752,36525,1935,775,1160,0.401,0.599
11753,36526,27890,25148,2742,0.902,0.098
11754,36527,12109,10352,1757,0.855,0.145
11755,36528,1237,0,1237,0.0,1.0
11756,36529,478,0,478,0.0,1.0
11757,36530,6873,0,6873,0.0,1.0
11758,36532,27829,18531,9298,0.666,0.334
11759,36535,26767,17774,8993,0.664,0.336
11760,36538,374,0,374,0.0,1.0
11761,36539,802,0,802,0.0,1.0
11762,36540,691,0,691,0.0,1.0
11763,36541,15647,4795,10852,0.306,0.694
11764,36542,12705,8695,4010,0.684,0.316
11765,36543,66,0,66,0.0,1.0
11766,36544,12476,6809,5667,0.546,0.454
11767,36545,9941,2920,7021,0.294,0.706
11768,36548,1136,0,1136,0.0,1.0
11769,36549,4271,2204,2067,0.516,0.484
11770,36550,217,0,217,0.0,1.0
11771,36551,8258,4729,3529,0.573,0.427
11772,36553,3575,0,3575,0.0,1.0
11773,36555,654,0,654,0.0,1.0
11774,36556,308,0,308,0.0,1.0
11775,36558,3854,0,3854,0.0,1.0
11776,36559,233,233,0,1.0,0.0
11777,36560,3690,0,3690,0.0,1.0
11778,36561,5808,4062,1746,0.699,0.301
11779,36562,1596,0,1596,0.0,1.0
11780,36564,107,0,107,0.0,1.0
11781,36567,12672,5373,7299,0.424,0.576
11782,36568,162,0,162,0.0,1.0
11783,36569,928,0,928,0.0,1.0
11784,36571,14423,11871,2552,0.823,0.177
11785,36572,6340,5949,391,0.938,0.062
11786,36574,1341,0,1341,0.0,1.0
11787,36575,18345,12089,6256,0.659,0.341
11788,36576,4143,618,3525,0.149,0.851
11789,36578,1749,0,1749,0.0,1.0
11790,36579,1590,0,1590,0.0,1.0
11791,36580,5420,0,5420,0.0,1.0
11792,36581,224,0,224,0.0,1.0
11793,36582,24624,16652,7972,0.676,0.324
11794,36583,639,0,639,0.0,1.0
11795,36584,772,0,772,0.0,1.0
11796,36585,972,0,972,0.0,1.0
11797,36587,12053,1838,10215,0.152,0.848
11798,36590,20,0,20,0.0,1.0
11799,36602,1057,1057,0,1.0,0.0
11800,36603,7922,7922,0,1.0,0.0
11801,36604,10456,10456,0,1.0,0.0
11802,36605,30111,29807,304,0.99,0.01
11803,36606,18733,18733,0,1.0,0.0
11804,36607,6852,6852,0,1.0,0.0
11805,36608,36864,33393,3471,0.906,0.094
11806,36609,25846,25846,0,1.0,0.0
11807,36610,13209,13209,0,1.0,0.0
11808,36611,6106,6074,32,0.995,0.005
11809,36612,4541,4541,0,1.0,0.0
11810,36613,12749,4399,8350,0.345,0.655
11811,36615,391,391,0,1.0,0.0
11812,36616,27,27,0,1.0,0.0
11813,36617,13967,13967,0,1.0,0.0
11814,36618,16737,16634,103,0.994,0.006
11815,36619,14269,13738,531,0.963,0.037
11816,36688,659,659,0,1.0,0.0
11817,36693,17847,17598,249,0.986,0.014
11818,36695,45118,41716,3402,0.925,0.075
11819,36701,24268,15300,8968,0.63,0.37
11820,36703,13643,8521,5122,0.625,0.375
11821,36720,784,0,784,0.0,1.0
11822,36722,472,0,472,0.0,1.0
11823,36723,230,0,230,0.0,1.0
11824,36726,4814,0,4814,0.0,1.0
11825,36727,61,0,61,0.0,1.0
11826,36728,461,0,461,0.0,1.0
11827,36732,8395,6388,2007,0.761,0.239
11828,36736,1207,0,1207,0.0,1.0
11829,36738,952,0,952,0.0,1.0
11830,36740,1328,0,1328,0.0,1.0
11831,36742,2554,64,2490,0.025,0.975
11832,36744,7419,0,7419,0.0,1.0
11833,36748,3260,0,3260,0.0,1.0
11834,36749,1089,0,1089,0.0,1.0
11835,36750,2901,0,2901,0.0,1.0
11836,36751,945,0,945,0.0,1.0
11837,36752,1644,0,1644,0.0,1.0
11838,36753,85,0,85,0.0,1.0
11839,36754,344,0,344,0.0,1.0
11840,36756,6165,0,6165,0.0,1.0
11841,36758,1412,0,1412,0.0,1.0
11842,36759,1501,0,1501,0.0,1.0
11843,36761,1161,0,1161,0.0,1.0
11844,36763,139,0,139,0.0,1.0
11845,36765,1294,0,1294,0.0,1.0
11846,36766,25,0,25,0.0,1.0
11847,36767,2012,0,2012,0.0,1.0
11848,36768,1096,0,1096,0.0,1.0
11849,36769,3014,0,3014,0.0,1.0
11850,36773,512,0,512,0.0,1.0
11851,36775,800,0,800,0.0,1.0
11852,36776,1489,0,1489,0.0,1.0
11853,36782,2405,0,2405,0.0,1.0
11854,36783,945,0,945,0.0,1.0
11855,36784,7754,3285,4469,0.424,0.576
11856,36785,1165,0,1165,0.0,1.0
11857,36786,3365,0,3365,0.0,1.0
11858,36790,139,0,139,0.0,1.0
11859,36792,1169,0,1169,0.0,1.0
11860,36793,568,0,568,0.0,1.0
11861,36801,22214,19619,2595,0.883,0.117
11862,36804,16861,4148,12713,0.246,0.754
11863,36830,33201,29217,3984,0.88,0.12
11864,36832,22071,18106,3965,0.82,0.18
11865,36849,3150,3150,0,1.0,0.0
11866,36850,2630,0,2630,0.0,1.0
11867,36852,2129,0,2129,0.0,1.0
11868,36853,8269,0,8269,0.0,1.0
11869,36854,14576,9626,4950,0.66,0.34
11870,36855,1551,0,1551,0.0,1.0
11871,36856,3719,46,3673,0.012,0.988
11872,36858,441,0,441,0.0,1.0
11873,36859,34,0,34,0.0,1.0
11874,36860,1580,0,1580,0.0,1.0
11875,36861,3264,0,3264,0.0,1.0
11876,36862,6623,0,6623,0.0,1.0
11877,36863,11672,7773,3899,0.666,0.334
11878,36865,23,0,23,0.0,1.0
11879,36866,3955,0,3955,0.0,1.0
11880,36867,22210,22007,203,0.991,0.009
11881,36869,18751,13273,5478,0.708,0.292
11882,36870,18783,17398,1385,0.926,0.074
11883,36871,1277,0,1277,0.0,1.0
11884,36874,7901,0,7901,0.0,1.0
11885,36875,4622,0,4622,0.0,1.0
11886,36877,11414,8540,2874,0.748,0.252
11887,36879,2114,501,1613,0.237,0.763
11888,36901,329,0,329,0.0,1.0
11889,36904,4098,0,4098,0.0,1.0
11890,36907,1930,0,1930,0.0,1.0
11891,36908,2417,0,2417,0.0,1.0
11892,36910,35,0,35,0.0,1.0
11893,36912,2017,0,2017,0.0,1.0
11894,36913,53,0,53,0.0,1.0
11895,36915,627,0,627,0.0,1.0
11896,36916,709,0,709,0.0,1.0
11897,36919,2143,0,2143,0.0,1.0
11898,36921,1035,0,1035,0.0,1.0
11899,36922,656,0,656,0.0,1.0
11900,36925,3115,0,3115,0.0,1.0
11901,37010,4679,1050,3629,0.224,0.776
11902,37012,2292,0,2292,0.0,1.0
11903,37013,78406,77917,489,0.994,0.006
11904,37014,1855,191,1664,0.103,0.897
11905,37015,17184,3424,13760,0.199,0.801
11906,37016,793,0,793,0.0,1.0
11907,37018,2259,0,2259,0.0,1.0
11908,37019,694,0,694,0.0,1.0
11909,37020,5036,0,5036,0.0,1.0
11910,37022,5469,0,5469,0.0,1.0
11911,37023,1811,0,1811,0.0,1.0
11912,37025,6226,0,6226,0.0,1.0
11913,37026,2201,0,2201,0.0,1.0
11914,37027,49035,47344,1691,0.966,0.034
11915,37028,676,0,676,0.0,1.0
11916,37029,5628,1496,4132,0.266,0.734
11917,37030,6982,3216,3766,0.461,0.539
11918,37031,3712,0,3712,0.0,1.0
11919,37032,4493,6,4487,0.001,0.999
11920,37033,7805,0,7805,0.0,1.0
11921,37034,6591,0,6591,0.0,1.0
11922,37035,3766,0,3766,0.0,1.0
11923,37036,5862,0,5862,0.0,1.0
11924,37037,6312,475,5837,0.075,0.925
11925,37040,44924,37978,6946,0.845,0.155
11926,37042,66916,61315,5601,0.916,0.084
11927,37043,39945,31845,8100,0.797,0.203
11928,37046,3665,0,3665,0.0,1.0
11929,37047,2345,0,2345,0.0,1.0
11930,37048,6030,589,5441,0.098,0.902
11931,37049,3244,0,3244,0.0,1.0
11932,37050,1699,0,1699,0.0,1.0
11933,37051,3677,0,3677,0.0,1.0
11934,37052,2656,0,2656,0.0,1.0
11935,37055,27024,14520,12504,0.537,0.463
11936,37057,834,0,834,0.0,1.0
11937,37058,7081,0,7081,0.0,1.0
11938,37059,1552,0,1552,0.0,1.0
11939,37060,2230,0,2230,0.0,1.0
11940,37061,5153,0,5153,0.0,1.0
11941,37062,10745,6373,4372,0.593,0.407
11942,37064,48118,38198,9920,0.794,0.206
11943,37066,42758,35599,7159,0.833,0.167
11944,37067,23652,21355,2297,0.903,0.097
11945,37069,18899,13236,5663,0.7,0.3
11946,37072,30215,22975,7240,0.76,0.24
11947,37073,13350,7509,5841,0.562,0.438
11948,37074,6965,0,6965,0.0,1.0
11949,37075,59256,54040,5216,0.912,0.088
11950,37076,35230,34046,1184,0.966,0.034
11951,37078,674,0,674,0.0,1.0
11952,37079,2578,0,2578,0.0,1.0
11953,37080,7384,87,7297,0.012,0.988
11954,37082,6107,0,6107,0.0,1.0
11955,37083,13909,4545,9364,0.327,0.673
11956,37085,4035,0,4035,0.0,1.0
11957,37086,31513,30479,1034,0.967,0.033
11958,37087,41132,26218,14914,0.637,0.363
11959,37090,12922,1880,11042,0.145,0.855
11960,37091,21005,10464,10541,0.498,0.502
11961,37095,1854,0,1854,0.0,1.0
11962,37096,5503,0,5503,0.0,1.0
11963,37097,2294,0,2294,0.0,1.0
11964,37098,5382,0,5382,0.0,1.0
11965,37101,6422,0,6422,0.0,1.0
11966,37110,32495,15386,17109,0.473,0.527
11967,37115,37316,37316,0,1.0,0.0
11968,37118,1264,0,1264,0.0,1.0
11969,37122,46463,32998,13465,0.71,0.29
11970,37127,15786,12269,3517,0.777,0.223
11971,37128,38966,34085,4881,0.875,0.125
11972,37129,49103,41499,7604,0.845,0.155
11973,37130,52070,47851,4219,0.919,0.081
11974,37132,2776,2776,0,1.0,0.0
11975,37134,3061,0,3061,0.0,1.0
11976,37135,9681,7282,2399,0.752,0.248
11977,37137,2725,0,2725,0.0,1.0
11978,37138,22191,22191,0,1.0,0.0
11979,37140,1365,0,1365,0.0,1.0
11980,37141,1224,0,1224,0.0,1.0
11981,37142,1902,0,1902,0.0,1.0
11982,37143,3818,0,3818,0.0,1.0
11983,37144,3344,0,3344,0.0,1.0
11984,37145,2157,0,2157,0.0,1.0
11985,37146,7182,3597,3585,0.501,0.499
11986,37148,22320,10819,11501,0.485,0.515
11987,37149,2210,0,2210,0.0,1.0
11988,37150,4894,0,4894,0.0,1.0
11989,37151,565,0,565,0.0,1.0
11990,37153,5520,679,4841,0.123,0.877
11991,37160,32744,20005,12739,0.611,0.389
11992,37165,70,0,70,0.0,1.0
11993,37166,13446,4050,9396,0.301,0.699
11994,37167,49322,46509,2813,0.943,0.057
11995,37171,917,0,917,0.0,1.0
11996,37172,28714,16564,12150,0.577,0.423
11997,37174,26418,22428,3990,0.849,0.151
11998,37175,1015,0,1015,0.0,1.0
11999,37178,2112,0,2112,0.0,1.0
12000,37179,11767,8211,3556,0.698,0.302
12001,37180,3033,0,3033,0.0,1.0
12002,37181,1534,0,1534,0.0,1.0
12003,37183,3229,0,3229,0.0,1.0
12004,37184,5844,0,5844,0.0,1.0
12005,37185,8638,3246,5392,0.376,0.624
12006,37186,9184,0,9184,0.0,1.0
12007,37187,6829,0,6829,0.0,1.0
12008,37188,13643,9927,3716,0.728,0.272
12009,37189,3320,727,2593,0.219,0.781
12010,37190,8787,2604,6183,0.296,0.704
12011,37191,4020,0,4020,0.0,1.0
12012,37201,2137,2137,0,1.0,0.0
12013,37203,11883,11883,0,1.0,0.0
12014,37204,12031,12031,0,1.0,0.0
12015,37205,24057,24057,0,1.0,0.0
12016,37206,25699,25699,0,1.0,0.0
12017,37207,34880,34492,388,0.989,0.011
12018,37208,16067,16067,0,1.0,0.0
12019,37209,35457,34405,1052,0.97,0.03
12020,37210,16067,16067,0,1.0,0.0
12021,37211,74755,74755,0,1.0,0.0
12022,37212,20148,20148,0,1.0,0.0
12023,37213,218,218,0,1.0,0.0
12024,37214,28973,28973,0,1.0,0.0
12025,37215,21190,19591,1599,0.925,0.075
12026,37216,17848,17848,0,1.0,0.0
12027,37217,29599,29599,0,1.0,0.0
12028,37218,14855,13165,1690,0.886,0.114
12029,37219,1162,1162,0,1.0,0.0
12030,37220,5786,4594,1192,0.794,0.206
12031,37221,36610,34296,2314,0.937,0.063
12032,37228,1160,1160,0,1.0,0.0
12033,37240,754,754,0,1.0,0.0
12034,37243,0,0,0,,
12035,37246,0,0,0,,
12036,37301,1429,0,1429,0.0,1.0
12037,37302,3730,1683,2047,0.451,0.549
12038,37303,25461,14166,11295,0.556,0.444
12039,37305,889,0,889,0.0,1.0
12040,37306,2760,0,2760,0.0,1.0
12041,37307,4870,0,4870,0.0,1.0
12042,37308,2772,0,2772,0.0,1.0
12043,37309,2138,444,1694,0.208,0.792
12044,37310,4135,1018,3117,0.246,0.754
12045,37311,27373,22999,4374,0.84,0.16
12046,37312,30962,25301,5661,0.817,0.183
12047,37313,1731,0,1731,0.0,1.0
12048,37315,1556,1556,0,1.0,0.0
12049,37317,2403,0,2403,0.0,1.0
12050,37318,1978,0,1978,0.0,1.0
12051,37321,19113,8807,10306,0.461,0.539
12052,37322,8239,0,8239,0.0,1.0
12053,37323,30439,16816,13623,0.552,0.448
12054,37324,5322,2417,2905,0.454,0.546
12055,37325,1845,0,1845,0.0,1.0
12056,37326,467,0,467,0.0,1.0
12057,37327,11174,3691,7483,0.33,0.67
12058,37328,1364,0,1364,0.0,1.0
12059,37329,5588,795,4793,0.142,0.858
12060,37330,6784,887,5897,0.131,0.869
12061,37331,7656,4074,3582,0.532,0.468
12062,37332,2609,0,2609,0.0,1.0
12063,37333,534,0,534,0.0,1.0
12064,37334,21700,9178,12522,0.423,0.577
12065,37335,2778,0,2778,0.0,1.0
12066,37336,4202,0,4202,0.0,1.0
12067,37337,1470,0,1470,0.0,1.0
12068,37338,3093,1367,1726,0.442,0.558
12069,37339,2018,0,2018,0.0,1.0
12070,37340,607,0,607,0.0,1.0
12071,37341,12085,8661,3424,0.717,0.283
12072,37342,3593,0,3593,0.0,1.0
12073,37343,40042,38670,1372,0.966,0.034
12074,37345,2311,0,2311,0.0,1.0
12075,37347,7559,3497,4062,0.463,0.537
12076,37348,1131,0,1131,0.0,1.0
12077,37350,1866,1866,0,1.0,0.0
12078,37351,390,390,0,1.0,0.0
12079,37352,3268,0,3268,0.0,1.0
12080,37353,4513,239,4274,0.053,0.947
12081,37354,16483,5391,11092,0.327,0.673
12082,37355,25596,11379,14217,0.445,0.555
12083,37356,2486,0,2486,0.0,1.0
12084,37357,5512,0,5512,0.0,1.0
12085,37359,783,0,783,0.0,1.0
12086,37360,1732,84,1648,0.048,0.952
12087,37361,1478,0,1478,0.0,1.0
12088,37362,3395,0,3395,0.0,1.0
12089,37363,32244,26098,6146,0.809,0.191
12090,37365,1314,0,1314,0.0,1.0
12091,37366,828,0,828,0.0,1.0
12092,37367,10247,0,10247,0.0,1.0
12093,37369,956,0,956,0.0,1.0
12094,37370,4652,658,3994,0.141,0.859
12095,37373,3074,0,3074,0.0,1.0
12096,37374,2047,454,1593,0.222,0.778
12097,37375,3711,0,3711,0.0,1.0
12098,37376,418,0,418,0.0,1.0
12099,37377,15310,11559,3751,0.755,0.245
12100,37379,26835,18102,8733,0.675,0.325
12101,37380,6289,2539,3750,0.404,0.596
12102,37381,8855,0,8855,0.0,1.0
12103,37385,8131,0,8131,0.0,1.0
12104,37387,3323,0,3323,0.0,1.0
12105,37388,24494,17166,7328,0.701,0.299
12106,37391,1598,0,1598,0.0,1.0
12107,37394,105,0,105,0.0,1.0
12108,37396,257,0,257,0.0,1.0
12109,37397,10127,0,10127,0.0,1.0
12110,37398,14347,8377,5970,0.584,0.416
12111,37402,3917,3917,0,1.0,0.0
12112,37403,5811,5811,0,1.0,0.0
12113,37404,13327,13327,0,1.0,0.0
12114,37405,14597,13227,1370,0.906,0.094
12115,37406,14627,14627,0,1.0,0.0
12116,37407,8932,8932,0,1.0,0.0
12117,37408,1486,1486,0,1.0,0.0
12118,37409,2851,2829,22,0.992,0.008
12119,37410,3886,3886,0,1.0,0.0
12120,37411,17587,17587,0,1.0,0.0
12121,37412,20951,20951,0,1.0,0.0
12122,37415,23873,22591,1282,0.946,0.054
12123,37416,14486,14486,0,1.0,0.0
12124,37419,6100,4255,1845,0.698,0.302
12125,37421,46228,46211,17,1.0,0.0
12126,37601,36182,31732,4450,0.877,0.123
12127,37604,34245,32817,1428,0.958,0.042
12128,37614,2107,2107,0,1.0,0.0
12129,37615,19560,17573,1987,0.898,0.102
12130,37616,4874,148,4726,0.03,0.97
12131,37617,14251,4146,10105,0.291,0.709
12132,37618,12747,4515,8232,0.354,0.646
12133,37620,39102,30715,8387,0.786,0.214
12134,37640,3743,0,3743,0.0,1.0
12135,37641,8567,1332,7235,0.155,0.845
12136,37642,14947,9376,5571,0.627,0.373
12137,37643,33689,23268,10421,0.691,0.309
12138,37645,5145,4821,324,0.937,0.063
12139,37650,12750,9156,3594,0.718,0.282
12140,37656,3677,0,3677,0.0,1.0
12141,37657,972,0,972,0.0,1.0
12142,37658,4386,1644,2742,0.375,0.625
12143,37659,27585,12457,15128,0.452,0.548
12144,37660,40038,36348,3690,0.908,0.092
12145,37663,14617,13500,1117,0.924,0.076
12146,37664,26880,23954,2926,0.891,0.109
12147,37665,5589,5589,0,1.0,0.0
12148,37680,766,0,766,0.0,1.0
12149,37681,6121,142,5979,0.023,0.977
12150,37682,667,667,0,1.0,0.0
12151,37683,13021,2698,10323,0.207,0.793
12152,37686,7072,1857,5215,0.263,0.737
12153,37687,5038,0,5038,0.0,1.0
12154,37688,1018,0,1018,0.0,1.0
12155,37690,4122,1060,3062,0.257,0.743
12156,37691,894,0,894,0.0,1.0
12157,37692,4770,956,3814,0.2,0.8
12158,37694,1955,358,1597,0.183,0.817
12159,37701,6817,6817,0,1.0,0.0
12160,37705,4559,380,4179,0.083,0.917
12161,37708,6563,0,6563,0.0,1.0
12162,37709,3732,0,3732,0.0,1.0
12163,37710,1141,0,1141,0.0,1.0
12164,37711,5044,0,5044,0.0,1.0
12165,37713,1488,0,1488,0.0,1.0
12166,37714,4547,1874,2673,0.412,0.588
12167,37715,1000,0,1000,0.0,1.0
12168,37716,25749,14967,10782,0.581,0.419
12169,37719,168,0,168,0.0,1.0
12170,37721,12733,3806,8927,0.299,0.701
12171,37722,6060,0,6060,0.0,1.0
12172,37723,944,0,944,0.0,1.0
12173,37724,2874,926,1948,0.322,0.678
12174,37725,16919,4983,11936,0.295,0.705
12175,37726,2037,0,2037,0.0,1.0
12176,37727,2043,0,2043,0.0,1.0
12177,37729,1456,0,1456,0.0,1.0
12178,37730,59,0,59,0.0,1.0
12179,37731,711,0,711,0.0,1.0
12180,37732,139,0,139,0.0,1.0
12181,37733,64,0,64,0.0,1.0
12182,37737,5785,1837,3948,0.318,0.682
12183,37738,5288,0,5288,0.0,1.0
12184,37742,5837,307,5530,0.053,0.947
12185,37743,25588,10900,14688,0.426,0.574
12186,37745,18401,11387,7014,0.619,0.381
12187,37748,17857,9195,8662,0.515,0.485
12188,37752,6516,3624,2892,0.556,0.444
12189,37753,814,0,814,0.0,1.0
12190,37754,4729,0,4729,0.0,1.0
12191,37755,3688,759,2929,0.206,0.794
12192,37756,2810,72,2738,0.026,0.974
12193,37757,9337,6263,3074,0.671,0.329
12194,37760,12931,8643,4288,0.668,0.332
12195,37762,3126,0,3126,0.0,1.0
12196,37763,15794,7640,8154,0.484,0.516
12197,37764,9258,26,9232,0.003,0.997
12198,37765,546,0,546,0.0,1.0
12199,37766,18850,10153,8697,0.539,0.461
12200,37769,5990,2729,3261,0.456,0.544
12201,37770,2646,0,2646,0.0,1.0
12202,37771,15380,10956,4424,0.712,0.288
12203,37772,11146,7207,3939,0.647,0.353
12204,37774,18321,10860,7461,0.593,0.407
12205,37777,11274,7298,3976,0.647,0.353
12206,37779,3978,0,3978,0.0,1.0
12207,37801,25124,18541,6583,0.738,0.262
12208,37803,31668,24010,7658,0.758,0.242
12209,37804,24682,19435,5247,0.787,0.213
12210,37806,2868,436,2432,0.152,0.848
12211,37807,9923,0,9923,0.0,1.0
12212,37809,2278,0,2278,0.0,1.0
12213,37810,1928,0,1928,0.0,1.0
12214,37811,3215,0,3215,0.0,1.0
12215,37813,17444,12199,5245,0.699,0.301
12216,37814,33071,30292,2779,0.916,0.084
12217,37818,4998,48,4950,0.01,0.99
12218,37819,713,0,713,0.0,1.0
12219,37820,7495,723,6772,0.096,0.904
12220,37821,22608,11579,11029,0.512,0.488
12221,37825,8399,2561,5838,0.305,0.695
12222,37826,4361,421,3940,0.097,0.903
12223,37828,1430,737,693,0.515,0.485
12224,37829,1804,0,1804,0.0,1.0
12225,37830,29700,27387,2313,0.922,0.078
12226,37840,10021,3158,6863,0.315,0.685
12227,37841,9605,3491,6114,0.363,0.637
12228,37843,3725,0,3725,0.0,1.0
12229,37845,494,0,494,0.0,1.0
12230,37846,5030,0,5030,0.0,1.0
12231,37847,2714,0,2714,0.0,1.0
12232,37848,246,0,246,0.0,1.0
12233,37849,25459,20143,5316,0.791,0.209
12234,37851,36,0,36,0.0,1.0
12235,37852,2558,0,2558,0.0,1.0
12236,37853,3815,2194,1621,0.575,0.425
12237,37854,13108,6680,6428,0.51,0.49
12238,37857,21309,6444,14865,0.302,0.698
12239,37860,4113,1216,2897,0.296,0.704
12240,37861,8340,0,8340,0.0,1.0
12241,37862,20934,14727,6207,0.703,0.297
12242,37863,6569,5263,1306,0.801,0.199
12243,37865,20912,13809,7103,0.66,0.34
12244,37866,1699,0,1699,0.0,1.0
12245,37869,5031,0,5031,0.0,1.0
12246,37870,4580,0,4580,0.0,1.0
12247,37871,9134,3699,5435,0.405,0.595
12248,37872,2041,0,2041,0.0,1.0
12249,37873,4073,145,3928,0.036,0.964
12250,37874,14979,5430,9549,0.363,0.637
12251,37876,29246,6087,23159,0.208,0.792
12252,37877,8464,5793,2671,0.684,0.316
12253,37878,514,0,514,0.0,1.0
12254,37879,10634,2052,8582,0.193,0.807
12255,37880,3477,0,3477,0.0,1.0
12256,37881,2291,0,2291,0.0,1.0
12257,37882,2724,0,2724,0.0,1.0
12258,37885,5067,0,5067,0.0,1.0
12259,37886,4418,109,4309,0.025,0.975
12260,37887,7511,0,7511,0.0,1.0
12261,37888,2741,0,2741,0.0,1.0
12262,37890,6668,3285,3383,0.493,0.507
12263,37891,3626,392,3234,0.108,0.892
12264,37892,2007,0,2007,0.0,1.0
12265,37902,1586,1586,0,1.0,0.0
12266,37909,15168,15168,0,1.0,0.0
12267,37912,20673,20673,0,1.0,0.0
12268,37914,19663,14967,4696,0.761,0.239
12269,37915,5647,5647,0,1.0,0.0
12270,37916,12507,12507,0,1.0,0.0
12271,37917,24072,24072,0,1.0,0.0
12272,37918,42835,40791,2044,0.952,0.048
12273,37919,28194,27887,307,0.989,0.011
12274,37920,39087,30320,8767,0.776,0.224
12275,37921,28233,28233,0,1.0,0.0
12276,37922,33180,32389,791,0.976,0.024
12277,37923,27457,27457,0,1.0,0.0
12278,37924,11259,8289,2970,0.736,0.264
12279,37931,26109,24819,1290,0.951,0.049
12280,37932,14527,10789,3738,0.743,0.257
12281,37934,24107,23765,342,0.986,0.014
12282,37938,17085,13750,3335,0.805,0.195
12283,38001,4719,2402,2317,0.509,0.491
12284,38002,38927,31174,7753,0.801,0.199
12285,38004,9866,7701,2165,0.781,0.219
12286,38006,5207,2356,2851,0.452,0.548
12287,38007,91,0,91,0.0,1.0
12288,38008,9721,5394,4327,0.555,0.445
12289,38011,9908,3533,6375,0.357,0.643
12290,38012,14575,9879,4696,0.678,0.322
12291,38015,2828,0,2828,0.0,1.0
12292,38016,43079,42521,558,0.987,0.013
12293,38017,48642,44601,4041,0.917,0.083
12294,38018,35059,34121,938,0.973,0.027
12295,38019,15601,8186,7415,0.525,0.475
12296,38021,59,0,59,0.0,1.0
12297,38023,6146,1133,5013,0.184,0.816
12298,38024,27406,18410,8996,0.672,0.328
12299,38028,6883,0,6883,0.0,1.0
12300,38029,80,80,0,1.0,0.0
12301,38030,977,0,977,0.0,1.0
12302,38034,2998,0,2998,0.0,1.0
12303,38036,478,436,42,0.912,0.088
12304,38037,1773,636,1137,0.359,0.641
12305,38039,1804,0,1804,0.0,1.0
12306,38040,5193,2099,3094,0.404,0.596
12307,38041,5085,700,4385,0.138,0.862
12308,38042,796,0,796,0.0,1.0
12309,38044,865,0,865,0.0,1.0
12310,38046,108,0,108,0.0,1.0
12311,38047,91,0,91,0.0,1.0
12312,38049,4984,7,4977,0.001,0.999
12313,38050,459,0,459,0.0,1.0
12314,38052,3907,0,3907,0.0,1.0
12315,38053,27932,15486,12446,0.554,0.446
12316,38054,284,284,0,1.0,0.0
12317,38057,3649,0,3649,0.0,1.0
12318,38058,10236,5836,4400,0.57,0.43
12319,38059,7663,3493,4170,0.456,0.544
12320,38060,9496,6802,2694,0.716,0.284
12321,38061,977,0,977,0.0,1.0
12322,38063,17403,8063,9340,0.463,0.537
12323,38066,2630,0,2630,0.0,1.0
12324,38067,1476,0,1476,0.0,1.0
12325,38068,10941,255,10686,0.023,0.977
12326,38069,2376,0,2376,0.0,1.0
12327,38070,175,0,175,0.0,1.0
12328,38075,6936,0,6936,0.0,1.0
12329,38076,847,0,847,0.0,1.0
12330,38077,43,0,43,0.0,1.0
12331,38079,5577,0,5577,0.0,1.0
12332,38080,2568,0,2568,0.0,1.0
12333,38103,12180,12180,0,1.0,0.0
12334,38104,23409,23409,0,1.0,0.0
12335,38105,6184,6184,0,1.0,0.0
12336,38106,27222,27219,3,1.0,0.0
12337,38107,17698,17698,0,1.0,0.0
12338,38108,18729,18729,0,1.0,0.0
12339,38109,46594,46073,521,0.989,0.011
12340,38111,41742,41742,0,1.0,0.0
12341,38112,17472,17472,0,1.0,0.0
12342,38114,26905,26905,0,1.0,0.0
12343,38115,39129,39129,0,1.0,0.0
12344,38116,40404,40404,0,1.0,0.0
12345,38117,26125,26125,0,1.0,0.0
12346,38118,41465,41209,256,0.994,0.006
12347,38119,22330,22330,0,1.0,0.0
12348,38120,14237,14224,13,0.999,0.001
12349,38122,25270,25270,0,1.0,0.0
12350,38125,36150,36055,95,0.997,0.003
12351,38126,7334,7334,0,1.0,0.0
12352,38127,45248,44111,1137,0.975,0.025
12353,38128,44863,44788,75,0.998,0.002
12354,38131,0,0,0,,
12355,38132,7,7,0,1.0,0.0
12356,38133,20787,20787,0,1.0,0.0
12357,38134,41948,41948,0,1.0,0.0
12358,38135,30657,30588,69,0.998,0.002
12359,38138,24045,24045,0,1.0,0.0
12360,38139,16086,16086,0,1.0,0.0
12361,38141,22462,22462,0,1.0,0.0
12362,38152,834,834,0,1.0,0.0
12363,38201,10093,5066,5027,0.502,0.498
12364,38220,1849,0,1849,0.0,1.0
12365,38221,3308,0,3308,0.0,1.0
12366,38222,2629,0,2629,0.0,1.0
12367,38224,956,0,956,0.0,1.0
12368,38225,6283,0,6283,0.0,1.0
12369,38226,345,0,345,0.0,1.0
12370,38229,2931,0,2931,0.0,1.0
12371,38230,3736,0,3736,0.0,1.0
12372,38231,1664,0,1664,0.0,1.0
12373,38232,1998,0,1998,0.0,1.0
12374,38233,2852,0,2852,0.0,1.0
12375,38235,441,0,441,0.0,1.0
12376,38236,662,0,662,0.0,1.0
12377,38237,16627,11397,5230,0.685,0.315
12378,38240,2259,0,2259,0.0,1.0
12379,38241,898,0,898,0.0,1.0
12380,38242,20151,10642,9509,0.528,0.472
12381,38251,2751,0,2751,0.0,1.0
12382,38253,1156,0,1156,0.0,1.0
12383,38254,85,0,85,0.0,1.0
12384,38255,2299,0,2299,0.0,1.0
12385,38256,3089,0,3089,0.0,1.0
12386,38257,4397,1916,2481,0.436,0.564
12387,38258,1500,0,1500,0.0,1.0
12388,38259,860,0,860,0.0,1.0
12389,38260,3804,0,3804,0.0,1.0
12390,38261,16919,10303,6616,0.609,0.391
12391,38301,36613,29194,7419,0.797,0.203
12392,38305,49808,42026,7782,0.844,0.156
12393,38310,6145,15,6130,0.002,0.998
12394,38311,786,0,786,0.0,1.0
12395,38313,3204,0,3204,0.0,1.0
12396,38315,3876,0,3876,0.0,1.0
12397,38316,2917,0,2917,0.0,1.0
12398,38317,2537,0,2537,0.0,1.0
12399,38318,476,0,476,0.0,1.0
12400,38320,10686,3552,7134,0.332,0.668
12401,38321,2431,0,2431,0.0,1.0
12402,38326,2560,0,2560,0.0,1.0
12403,38327,477,254,223,0.532,0.468
12404,38328,730,0,730,0.0,1.0
12405,38329,3220,0,3220,0.0,1.0
12406,38330,4404,2264,2140,0.514,0.486
12407,38332,1120,0,1120,0.0,1.0
12408,38333,523,0,523,0.0,1.0
12409,38334,1911,0,1911,0.0,1.0
12410,38337,1366,0,1366,0.0,1.0
12411,38339,637,0,637,0.0,1.0
12412,38340,12935,5932,7003,0.459,0.541
12413,38341,2252,0,2252,0.0,1.0
12414,38342,1438,0,1438,0.0,1.0
12415,38343,15619,8801,6818,0.563,0.437
12416,38344,8684,0,8684,0.0,1.0
12417,38345,2089,0,2089,0.0,1.0
12418,38347,270,0,270,0.0,1.0
12419,38348,1037,0,1037,0.0,1.0
12420,38351,17603,6560,11043,0.373,0.627
12421,38352,494,0,494,0.0,1.0
12422,38355,5882,3636,2246,0.618,0.382
12423,38356,2193,14,2179,0.006,0.994
12424,38357,2757,0,2757,0.0,1.0
12425,38358,12121,7427,4694,0.613,0.387
12426,38359,278,0,278,0.0,1.0
12427,38361,994,0,994,0.0,1.0
12428,38362,1145,646,499,0.564,0.436
12429,38363,6097,0,6097,0.0,1.0
12430,38365,16,0,16,0.0,1.0
12431,38366,2267,95,2172,0.042,0.958
12432,38367,2843,0,2843,0.0,1.0
12433,38368,1985,0,1985,0.0,1.0
12434,38369,1887,984,903,0.521,0.479
12435,38370,670,0,670,0.0,1.0
12436,38371,1235,0,1235,0.0,1.0
12437,38372,17595,8078,9517,0.459,0.541
12438,38374,2052,0,2052,0.0,1.0
12439,38375,9251,3840,5411,0.415,0.585
12440,38376,233,0,233,0.0,1.0
12441,38379,1171,0,1171,0.0,1.0
12442,38380,574,0,574,0.0,1.0
12443,38381,1640,0,1640,0.0,1.0
12444,38382,9515,3820,5695,0.401,0.599
12445,38387,375,0,375,0.0,1.0
12446,38388,1840,0,1840,0.0,1.0
12447,38390,907,0,907,0.0,1.0
12448,38391,1174,0,1174,0.0,1.0
12449,38392,776,0,776,0.0,1.0
12450,38401,54469,35534,18935,0.652,0.348
12451,38425,3724,0,3724,0.0,1.0
12452,38449,2811,0,2811,0.0,1.0
12453,38450,2778,0,2778,0.0,1.0
12454,38451,4814,0,4814,0.0,1.0
12455,38452,1091,0,1091,0.0,1.0
12456,38453,373,0,373,0.0,1.0
12457,38454,1208,0,1208,0.0,1.0
12458,38455,227,0,227,0.0,1.0
12459,38456,4559,0,4559,0.0,1.0
12460,38457,808,0,808,0.0,1.0
12461,38459,453,0,453,0.0,1.0
12462,38460,1410,0,1410,0.0,1.0
12463,38461,1379,0,1379,0.0,1.0
12464,38462,10297,3625,6672,0.352,0.648
12465,38463,2817,0,2817,0.0,1.0
12466,38464,22293,9889,12404,0.444,0.556
12467,38468,5201,211,4990,0.041,0.959
12468,38469,4092,0,4092,0.0,1.0
12469,38471,530,0,530,0.0,1.0
12470,38472,2656,0,2656,0.0,1.0
12471,38473,1061,0,1061,0.0,1.0
12472,38474,7802,3507,4295,0.45,0.55
12473,38475,635,0,635,0.0,1.0
12474,38476,1228,0,1228,0.0,1.0
12475,38477,2766,0,2766,0.0,1.0
12476,38478,17733,7741,9992,0.437,0.563
12477,38481,896,0,896,0.0,1.0
12478,38482,1535,0,1535,0.0,1.0
12479,38483,5663,0,5663,0.0,1.0
12480,38485,6502,0,6502,0.0,1.0
12481,38486,967,0,967,0.0,1.0
12482,38487,1057,0,1057,0.0,1.0
12483,38488,2524,0,2524,0.0,1.0
12484,38501,36687,28211,8476,0.769,0.231
12485,38504,901,0,901,0.0,1.0
12486,38505,1806,1806,0,1.0,0.0
12487,38506,26521,12566,13955,0.474,0.526
12488,38541,1613,0,1613,0.0,1.0
12489,38542,22,0,22,0.0,1.0
12490,38543,560,0,560,0.0,1.0
12491,38544,6543,1605,4938,0.245,0.755
12492,38545,1474,19,1455,0.013,0.987
12493,38547,1975,66,1909,0.033,0.967
12494,38548,731,0,731,0.0,1.0
12495,38549,3679,0,3679,0.0,1.0
12496,38551,4106,0,4106,0.0,1.0
12497,38552,275,0,275,0.0,1.0
12498,38553,2312,0,2312,0.0,1.0
12499,38554,827,0,827,0.0,1.0
12500,38555,18809,12808,6001,0.681,0.319
12501,38556,12540,0,12540,0.0,1.0
12502,38558,6970,5473,1497,0.785,0.215
12503,38559,1340,278,1062,0.207,0.793
12504,38560,1425,0,1425,0.0,1.0
12505,38562,6554,0,6554,0.0,1.0
12506,38563,2330,0,2330,0.0,1.0
12507,38564,453,0,453,0.0,1.0
12508,38565,1098,0,1098,0.0,1.0
12509,38567,784,0,784,0.0,1.0
12510,38568,2034,0,2034,0.0,1.0
12511,38569,363,0,363,0.0,1.0
12512,38570,9898,3485,6413,0.352,0.648
12513,38571,13848,484,13364,0.035,0.965
12514,38572,10649,3156,7493,0.296,0.704
12515,38573,2198,0,2198,0.0,1.0
12516,38574,8413,3010,5403,0.358,0.642
12517,38575,1172,0,1172,0.0,1.0
12518,38577,1153,0,1153,0.0,1.0
12519,38578,177,0,177,0.0,1.0
12520,38579,1063,0,1063,0.0,1.0
12521,38580,1743,0,1743,0.0,1.0
12522,38581,4112,0,4112,0.0,1.0
12523,38582,1426,0,1426,0.0,1.0
12524,38583,23825,5171,18654,0.217,0.783
12525,38585,3717,0,3717,0.0,1.0
12526,38587,1301,0,1301,0.0,1.0
12527,38588,1011,0,1011,0.0,1.0
12528,38589,200,0,200,0.0,1.0
12529,38601,2371,0,2371,0.0,1.0
12530,38603,2894,0,2894,0.0,1.0
12531,38606,16127,6730,9397,0.417,0.583
12532,38610,3542,0,3542,0.0,1.0
12533,38611,17202,0,17202,0.0,1.0
12534,38614,20418,17582,2836,0.861,0.139
12535,38617,734,0,734,0.0,1.0
12536,38618,12031,0,12031,0.0,1.0
12537,38619,5004,0,5004,0.0,1.0
12538,38620,3375,579,2796,0.172,0.828
12539,38621,1910,0,1910,0.0,1.0
12540,38622,705,0,705,0.0,1.0
12541,38623,259,0,259,0.0,1.0
12542,38625,1058,0,1058,0.0,1.0
12543,38626,1353,0,1353,0.0,1.0
12544,38627,1120,0,1120,0.0,1.0
12545,38629,1774,0,1774,0.0,1.0
12546,38630,132,0,132,0.0,1.0
12547,38631,1306,0,1306,0.0,1.0
12548,38632,24377,11902,12475,0.488,0.512
12549,38633,2590,0,2590,0.0,1.0
12550,38635,15941,6160,9781,0.386,0.614
12551,38637,26066,25496,570,0.978,0.022
12552,38639,1257,0,1257,0.0,1.0
12553,38641,2338,0,2338,0.0,1.0
12554,38642,2321,0,2321,0.0,1.0
12555,38643,2619,1655,964,0.632,0.368
12556,38644,208,0,208,0.0,1.0
12557,38645,1329,201,1128,0.151,0.849
12558,38646,3073,1881,1192,0.612,0.388
12559,38647,1143,0,1143,0.0,1.0
12560,38650,3881,2,3879,0.001,0.999
12561,38651,7103,3290,3813,0.463,0.537
12562,38652,16600,6630,9970,0.399,0.601
12563,38654,45956,36753,9203,0.8,0.2
12564,38655,36699,21570,15129,0.588,0.412
12565,38658,2074,0,2074,0.0,1.0
12566,38659,2841,0,2841,0.0,1.0
12567,38661,2039,0,2039,0.0,1.0
12568,38663,11950,3592,8358,0.301,0.699
12569,38664,3279,0,3279,0.0,1.0
12570,38665,2683,0,2683,0.0,1.0
12571,38666,6915,0,6915,0.0,1.0
12572,38668,14462,6531,7931,0.452,0.548
12573,38670,1226,0,1226,0.0,1.0
12574,38671,35712,35360,352,0.99,0.01
12575,38672,11249,10725,524,0.953,0.047
12576,38673,746,0,746,0.0,1.0
12577,38674,898,0,898,0.0,1.0
12578,38676,6375,3662,2713,0.574,0.426
12579,38677,4198,4198,0,1.0,0.0
12580,38680,6194,4784,1410,0.772,0.228
12581,38683,5637,0,5637,0.0,1.0
12582,38685,1347,0,1347,0.0,1.0
12583,38701,24187,21114,3073,0.873,0.127
12584,38702,1,0,1,0.0,1.0
12585,38703,14568,12998,1570,0.892,0.108
12586,38704,41,0,41,0.0,1.0
12587,38720,597,0,597,0.0,1.0
12588,38721,1230,0,1230,0.0,1.0
12589,38722,531,0,531,0.0,1.0
12590,38723,33,0,33,0.0,1.0
12591,38725,998,0,998,0.0,1.0
12592,38726,532,0,532,0.0,1.0
12593,38730,1718,604,1114,0.352,0.648
12594,38731,129,0,129,0.0,1.0
12595,38732,17981,15118,2863,0.841,0.159
12596,38736,440,0,440,0.0,1.0
12597,38737,2932,0,2932,0.0,1.0
12598,38738,3998,0,3998,0.0,1.0
12599,38740,466,0,466,0.0,1.0
12600,38744,682,0,682,0.0,1.0
12601,38745,144,0,144,0.0,1.0
12602,38746,616,0,616,0.0,1.0
12603,38748,3901,2612,1289,0.67,0.33
12604,38749,26,0,26,0.0,1.0
12605,38751,11638,10408,1230,0.894,0.106
12606,38753,1456,0,1456,0.0,1.0
12607,38754,1532,0,1532,0.0,1.0
12608,38756,6462,4971,1491,0.769,0.231
12609,38759,1194,0,1194,0.0,1.0
12610,38760,929,481,448,0.518,0.482
12611,38761,2870,2567,303,0.894,0.106
12612,38762,2294,0,2294,0.0,1.0
12613,38764,430,0,430,0.0,1.0
12614,38765,201,0,201,0.0,1.0
12615,38767,77,0,77,0.0,1.0
12616,38768,182,0,182,0.0,1.0
12617,38769,2216,0,2216,0.0,1.0
12618,38771,3260,2998,262,0.92,0.08
12619,38772,182,0,182,0.0,1.0
12620,38773,3375,0,3375,0.0,1.0
12621,38774,2522,0,2522,0.0,1.0
12622,38778,1686,0,1686,0.0,1.0
12623,38781,252,0,252,0.0,1.0
12624,38801,29871,24685,5186,0.826,0.174
12625,38804,17285,10606,6679,0.614,0.386
12626,38821,12528,6566,5962,0.524,0.476
12627,38824,7832,0,7832,0.0,1.0
12628,38826,4703,2179,2524,0.463,0.537
12629,38827,2733,0,2733,0.0,1.0
12630,38828,3970,0,3970,0.0,1.0
12631,38829,18707,6050,12657,0.323,0.677
12632,38833,2370,0,2370,0.0,1.0
12633,38834,29133,12469,16664,0.428,0.572
12634,38838,1629,0,1629,0.0,1.0
12635,38841,2775,0,2775,0.0,1.0
12636,38843,11467,3217,8250,0.281,0.719
12637,38844,131,0,131,0.0,1.0
12638,38846,2446,0,2446,0.0,1.0
12639,38847,3501,0,3501,0.0,1.0
12640,38848,848,0,848,0.0,1.0
12641,38849,5702,0,5702,0.0,1.0
12642,38850,3141,0,3141,0.0,1.0
12643,38851,8408,2557,5851,0.304,0.696
12644,38852,9449,0,9449,0.0,1.0
12645,38855,4602,0,4602,0.0,1.0
12646,38856,1788,0,1788,0.0,1.0
12647,38857,3252,0,3252,0.0,1.0
12648,38858,7176,0,7176,0.0,1.0
12649,38859,749,0,749,0.0,1.0
12650,38860,5663,0,5663,0.0,1.0
12651,38862,2731,823,1908,0.301,0.699
12652,38863,19788,4807,14981,0.243,0.757
12653,38864,1701,0,1701,0.0,1.0
12654,38865,4698,0,4698,0.0,1.0
12655,38866,11897,5449,6448,0.458,0.542
12656,38868,5481,781,4700,0.142,0.858
12657,38869,478,0,478,0.0,1.0
12658,38870,3122,0,3122,0.0,1.0
12659,38871,1640,0,1640,0.0,1.0
12660,38873,2719,0,2719,0.0,1.0
12661,38876,1322,0,1322,0.0,1.0
12662,38878,2864,0,2864,0.0,1.0
12663,38879,785,775,10,0.987,0.013
12664,38901,18403,10481,7922,0.57,0.43
12665,38913,396,0,396,0.0,1.0
12666,38914,552,0,552,0.0,1.0
12667,38915,4046,0,4046,0.0,1.0
12668,38916,5049,0,5049,0.0,1.0
12669,38917,3258,0,3258,0.0,1.0
12670,38920,804,0,804,0.0,1.0
12671,38921,5061,2930,2131,0.579,0.421
12672,38922,3451,0,3451,0.0,1.0
12673,38923,1293,0,1293,0.0,1.0
12674,38924,771,0,771,0.0,1.0
12675,38925,2363,0,2363,0.0,1.0
12676,38927,1186,0,1186,0.0,1.0
12677,38928,497,0,497,0.0,1.0
12678,38929,1317,0,1317,0.0,1.0
12679,38930,25297,22380,2917,0.885,0.115
12680,38940,2141,0,2141,0.0,1.0
12681,38941,5282,4223,1059,0.8,0.2
12682,38943,526,0,526,0.0,1.0
12683,38944,504,0,504,0.0,1.0
12684,38945,35,0,35,0.0,1.0
12685,38946,362,0,362,0.0,1.0
12686,38947,445,0,445,0.0,1.0
12687,38948,2288,0,2288,0.0,1.0
12688,38949,297,0,297,0.0,1.0
12689,38950,334,0,334,0.0,1.0
12690,38951,1316,0,1316,0.0,1.0
12691,38952,611,0,611,0.0,1.0
12692,38953,798,0,798,0.0,1.0
12693,38954,1514,0,1514,0.0,1.0
12694,38957,734,0,734,0.0,1.0
12695,38958,38,0,38,0.0,1.0
12696,38961,803,0,803,0.0,1.0
12697,38962,149,0,149,0.0,1.0
12698,38963,4015,0,4015,0.0,1.0
12699,38964,104,0,104,0.0,1.0
12700,38965,9135,2622,6513,0.287,0.713
12701,38966,1174,0,1174,0.0,1.0
12702,38967,7755,4388,3367,0.566,0.434
12703,39038,6258,4702,1556,0.751,0.249
12704,39039,2193,0,2193,0.0,1.0
12705,39040,3295,0,3295,0.0,1.0
12706,39041,3404,0,3404,0.0,1.0
12707,39042,34198,22275,11923,0.651,0.349
12708,39044,3872,0,3872,0.0,1.0
12709,39045,1353,0,1353,0.0,1.0
12710,39046,26398,14903,11495,0.565,0.435
12711,39047,34539,24460,10079,0.708,0.292
12712,39051,16569,4478,12091,0.27,0.73
12713,39054,341,0,341,0.0,1.0
12714,39056,25621,20708,4913,0.808,0.192
12715,39057,2291,0,2291,0.0,1.0
12716,39059,12073,5269,6804,0.436,0.564
12717,39061,88,0,88,0.0,1.0
12718,39062,467,0,467,0.0,1.0
12719,39063,3620,2525,1095,0.698,0.302
12720,39066,4338,0,4338,0.0,1.0
12721,39067,1434,0,1434,0.0,1.0
12722,39069,5409,0,5409,0.0,1.0
12723,39071,5346,0,5346,0.0,1.0
12724,39073,19685,5937,13748,0.302,0.698
12725,39074,14896,4887,10009,0.328,0.672
12726,39078,755,0,755,0.0,1.0
12727,39079,2037,0,2037,0.0,1.0
12728,39082,1312,0,1312,0.0,1.0
12729,39083,10626,4868,5758,0.458,0.542
12730,39086,1635,0,1635,0.0,1.0
12731,39088,135,0,135,0.0,1.0
12732,39090,13398,6983,6415,0.521,0.479
12733,39092,2934,0,2934,0.0,1.0
12734,39094,3956,0,3956,0.0,1.0
12735,39095,7324,0,7324,0.0,1.0
12736,39096,2338,0,2338,0.0,1.0
12737,39097,873,0,873,0.0,1.0
12738,39108,1974,0,1974,0.0,1.0
12739,39110,36143,29818,6325,0.825,0.175
12740,39111,10460,4170,6290,0.399,0.601
12741,39113,595,0,595,0.0,1.0
12742,39114,9998,0,9998,0.0,1.0
12743,39115,155,0,155,0.0,1.0
12744,39116,2538,0,2538,0.0,1.0
12745,39117,10697,2979,7718,0.278,0.722
12746,39119,5506,0,5506,0.0,1.0
12747,39120,32334,20274,12060,0.627,0.373
12748,39140,2250,0,2250,0.0,1.0
12749,39144,867,0,867,0.0,1.0
12750,39145,5170,0,5170,0.0,1.0
12751,39146,2841,0,2841,0.0,1.0
12752,39149,1649,0,1649,0.0,1.0
12753,39150,5914,0,5914,0.0,1.0
12754,39152,1284,0,1284,0.0,1.0
12755,39153,3724,0,3724,0.0,1.0
12756,39154,10526,4032,6494,0.383,0.617
12757,39156,513,0,513,0.0,1.0
12758,39157,24645,23361,1284,0.948,0.052
12759,39159,3334,0,3334,0.0,1.0
12760,39160,2889,0,2889,0.0,1.0
12761,39162,205,0,205,0.0,1.0
12762,39166,613,0,613,0.0,1.0
12763,39167,47,0,47,0.0,1.0
12764,39168,6643,0,6643,0.0,1.0
12765,39169,2957,0,2957,0.0,1.0
12766,39170,9407,0,9407,0.0,1.0
12767,39174,715,575,140,0.804,0.196
12768,39175,4843,0,4843,0.0,1.0
12769,39176,2106,0,2106,0.0,1.0
12770,39177,136,0,136,0.0,1.0
12771,39179,1228,0,1228,0.0,1.0
12772,39180,32603,19452,13151,0.597,0.403
12773,39183,15661,9376,6285,0.599,0.401
12774,39189,5263,0,5263,0.0,1.0
12775,39191,8074,0,8074,0.0,1.0
12776,39192,1733,0,1733,0.0,1.0
12777,39193,968,967,1,0.999,0.001
12778,39194,20925,15546,5379,0.743,0.257
12779,39201,536,536,0,1.0,0.0
12780,39202,8411,8411,0,1.0,0.0
12781,39203,7091,7091,0,1.0,0.0
12782,39204,19468,19468,0,1.0,0.0
12783,39206,25341,25341,0,1.0,0.0
12784,39208,31371,28176,3195,0.898,0.102
12785,39209,29617,27524,2093,0.929,0.071
12786,39211,24515,24337,178,0.993,0.007
12787,39212,33263,32114,1149,0.965,0.035
12788,39213,22328,21771,557,0.975,0.025
12789,39216,3454,3454,0,1.0,0.0
12790,39217,1103,1103,0,1.0,0.0
12791,39218,6943,6260,683,0.902,0.098
12792,39232,7068,5524,1544,0.782,0.218
12793,39269,0,0,0,,
12794,39272,12551,11831,720,0.943,0.057
12795,39301,27449,13669,13780,0.498,0.502
12796,39305,20431,12536,7895,0.614,0.386
12797,39307,18603,13819,4784,0.743,0.257
12798,39309,601,0,601,0.0,1.0
12799,39320,1828,0,1828,0.0,1.0
12800,39322,1882,0,1882,0.0,1.0
12801,39323,1290,0,1290,0.0,1.0
12802,39325,5983,0,5983,0.0,1.0
12803,39326,720,0,720,0.0,1.0
12804,39327,4190,0,4190,0.0,1.0
12805,39328,4806,0,4806,0.0,1.0
12806,39330,2746,0,2746,0.0,1.0
12807,39332,1923,0,1923,0.0,1.0
12808,39335,3160,0,3160,0.0,1.0
12809,39336,1235,0,1235,0.0,1.0
12810,39337,1808,0,1808,0.0,1.0
12811,39338,3319,0,3319,0.0,1.0
12812,39339,15619,4624,10995,0.296,0.704
12813,39341,7156,2998,4158,0.419,0.581
12814,39342,1287,1210,77,0.94,0.06
12815,39345,6127,2810,3317,0.459,0.541
12816,39346,2241,0,2241,0.0,1.0
12817,39347,1497,0,1497,0.0,1.0
12818,39348,838,0,838,0.0,1.0
12819,39350,24865,7759,17106,0.312,0.688
12820,39352,812,0,812,0.0,1.0
12821,39354,2094,0,2094,0.0,1.0
12822,39355,7131,0,7131,0.0,1.0
12823,39356,659,0,659,0.0,1.0
12824,39358,1679,0,1679,0.0,1.0
12825,39359,273,0,273,0.0,1.0
12826,39360,3830,0,3830,0.0,1.0
12827,39361,1468,0,1468,0.0,1.0
12828,39362,2866,0,2866,0.0,1.0
12829,39363,1773,0,1773,0.0,1.0
12830,39364,2985,297,2688,0.099,0.901
12831,39365,7547,0,7547,0.0,1.0
12832,39366,1380,0,1380,0.0,1.0
12833,39367,15096,4224,10872,0.28,0.72
12834,39401,43366,34723,8643,0.801,0.199
12835,39402,37492,32099,5393,0.856,0.144
12836,39406,1759,1759,0,1.0,0.0
12837,39421,2936,0,2936,0.0,1.0
12838,39422,5146,0,5146,0.0,1.0
12839,39423,2690,0,2690,0.0,1.0
12840,39425,1754,0,1754,0.0,1.0
12841,39426,16301,3333,12968,0.204,0.796
12842,39427,1314,0,1314,0.0,1.0
12843,39428,9761,0,9761,0.0,1.0
12844,39429,17657,6990,10667,0.396,0.604
12845,39437,12917,3695,9222,0.286,0.714
12846,39439,4573,0,4573,0.0,1.0
12847,39440,21305,20641,664,0.969,0.031
12848,39443,21939,1795,20144,0.082,0.918
12849,39451,7181,0,7181,0.0,1.0
12850,39452,26964,2636,24328,0.098,0.902
12851,39455,9721,0,9721,0.0,1.0
12852,39456,1292,0,1292,0.0,1.0
12853,39459,3677,0,3677,0.0,1.0
12854,39461,582,0,582,0.0,1.0
12855,39462,1122,0,1122,0.0,1.0
12856,39464,2482,0,2482,0.0,1.0
12857,39465,21386,9967,11419,0.466,0.534
12858,39466,27738,13459,14279,0.485,0.515
12859,39470,13011,0,13011,0.0,1.0
12860,39474,6050,0,6050,0.0,1.0
12861,39475,12225,1752,10473,0.143,0.857
12862,39476,7582,0,7582,0.0,1.0
12863,39477,686,0,686,0.0,1.0
12864,39478,2201,0,2201,0.0,1.0
12865,39479,5796,0,5796,0.0,1.0
12866,39480,2770,0,2770,0.0,1.0
12867,39481,1867,0,1867,0.0,1.0
12868,39482,9746,58,9688,0.006,0.994
12869,39483,6447,304,6143,0.047,0.953
12870,39501,21987,21960,27,0.999,0.001
12871,39503,45309,35822,9487,0.791,0.209
12872,39507,16234,16234,0,1.0,0.0
12873,39520,14681,11911,2770,0.811,0.189
12874,39525,8383,7855,528,0.937,0.063
12875,39530,8086,8085,1,1.0,0.0
12876,39531,17736,17736,0,1.0,0.0
12877,39532,32716,22421,10295,0.685,0.315
12878,39534,2379,2379,0,1.0,0.0
12879,39540,8522,8486,36,0.996,0.004
12880,39553,17174,15884,1290,0.925,0.075
12881,39556,7705,0,7705,0.0,1.0
12882,39560,16844,15443,1401,0.917,0.083
12883,39561,1852,0,1852,0.0,1.0
12884,39562,17912,3006,14906,0.168,0.832
12885,39563,13790,13219,571,0.959,0.041
12886,39564,36952,34896,2056,0.944,0.056
12887,39565,19453,3021,16432,0.155,0.845
12888,39567,10740,10719,21,0.998,0.002
12889,39571,13179,5087,8092,0.386,0.614
12890,39572,1414,0,1414,0.0,1.0
12891,39573,8828,0,8828,0.0,1.0
12892,39574,13613,0,13613,0.0,1.0
12893,39576,5809,5467,342,0.941,0.059
12894,39577,10374,3768,6606,0.363,0.637
12895,39581,11595,11557,38,0.997,0.003
12896,39601,23536,10635,12901,0.452,0.548
12897,39629,6519,0,6519,0.0,1.0
12898,39630,1115,0,1115,0.0,1.0
12899,39631,3732,0,3732,0.0,1.0
12900,39633,1094,0,1094,0.0,1.0
12901,39635,170,0,170,0.0,1.0
12902,39638,3333,0,3333,0.0,1.0
12903,39641,4569,0,4569,0.0,1.0
12904,39643,1102,0,1102,0.0,1.0
12905,39645,5016,0,5016,0.0,1.0
12906,39647,1023,0,1023,0.0,1.0
12907,39648,21710,14298,7412,0.659,0.341
12908,39652,8315,0,8315,0.0,1.0
12909,39653,2799,0,2799,0.0,1.0
12910,39654,5635,0,5635,0.0,1.0
12911,39656,803,0,803,0.0,1.0
12912,39657,2351,0,2351,0.0,1.0
12913,39661,2997,0,2997,0.0,1.0
12914,39662,1318,0,1318,0.0,1.0
12915,39663,3080,0,3080,0.0,1.0
12916,39664,2256,0,2256,0.0,1.0
12917,39665,1196,0,1196,0.0,1.0
12918,39666,9588,2090,7498,0.218,0.782
12919,39667,12837,0,12837,0.0,1.0
12920,39668,681,0,681,0.0,1.0
12921,39669,6045,0,6045,0.0,1.0
12922,39701,13997,11640,2357,0.832,0.168
12923,39702,22883,13411,9472,0.586,0.414
12924,39705,13667,9263,4404,0.678,0.322
12925,39730,11805,4666,7139,0.395,0.605
12926,39735,3916,0,3916,0.0,1.0
12927,39736,312,0,312,0.0,1.0
12928,39737,285,0,285,0.0,1.0
12929,39739,2957,0,2957,0.0,1.0
12930,39740,5038,0,5038,0.0,1.0
12931,39741,1560,0,1560,0.0,1.0
12932,39743,2067,0,2067,0.0,1.0
12933,39744,6008,0,6008,0.0,1.0
12934,39745,810,0,810,0.0,1.0
12935,39746,3183,0,3183,0.0,1.0
12936,39747,1999,0,1999,0.0,1.0
12937,39750,2781,0,2781,0.0,1.0
12938,39751,1309,0,1309,0.0,1.0
12939,39752,2473,0,2473,0.0,1.0
12940,39755,1051,0,1051,0.0,1.0
12941,39756,1943,0,1943,0.0,1.0
12942,39759,42108,28100,14008,0.667,0.333
12943,39760,23,0,23,0.0,1.0
12944,39762,2207,2207,0,1.0,0.0
12945,39766,2630,0,2630,0.0,1.0
12946,39767,861,0,861,0.0,1.0
12947,39769,1923,0,1923,0.0,1.0
12948,39771,127,0,127,0.0,1.0
12949,39772,1793,0,1793,0.0,1.0
12950,39773,16670,9173,7497,0.55,0.45
12951,39776,1674,0,1674,0.0,1.0
12952,39813,2110,0,2110,0.0,1.0
12953,39815,1686,0,1686,0.0,1.0
12954,39817,10894,5582,5312,0.512,0.488
12955,39819,11282,6536,4746,0.579,0.421
12956,39823,8550,3748,4802,0.438,0.562
12957,39824,544,0,544,0.0,1.0
12958,39825,1461,0,1461,0.0,1.0
12959,39826,418,0,418,0.0,1.0
12960,39827,3842,123,3719,0.032,0.968
12961,39828,15150,9291,5859,0.613,0.387
12962,39834,2138,0,2138,0.0,1.0
12963,39836,461,0,461,0.0,1.0
12964,39837,6166,0,6166,0.0,1.0
12965,39840,5726,3811,1915,0.666,0.334
12966,39841,878,0,878,0.0,1.0
12967,39842,8357,4466,3891,0.534,0.466
12968,39845,7871,2654,5217,0.337,0.663
12969,39846,2440,0,2440,0.0,1.0
12970,39851,2388,0,2388,0.0,1.0
12971,39854,2592,676,1916,0.261,0.739
12972,39859,1281,91,1190,0.071,0.929
12973,39861,1003,0,1003,0.0,1.0
12974,39862,1326,0,1326,0.0,1.0
12975,39866,2122,0,2122,0.0,1.0
12976,39867,321,0,321,0.0,1.0
12977,39870,2238,0,2238,0.0,1.0
12978,39877,500,0,500,0.0,1.0
12979,39885,76,0,76,0.0,1.0
12980,39886,1616,0,1616,0.0,1.0
12981,39897,3430,0,3430,0.0,1.0
12982,40003,1902,0,1902,0.0,1.0
12983,40004,28245,17597,10648,0.623,0.377
12984,40006,5084,0,5084,0.0,1.0
12985,40007,166,0,166,0.0,1.0
12986,40008,3476,0,3476,0.0,1.0
12987,40009,1051,0,1051,0.0,1.0
12988,40010,587,47,540,0.08,0.92
12989,40011,2549,0,2549,0.0,1.0
12990,40012,589,0,589,0.0,1.0
12991,40013,5369,992,4377,0.185,0.815
12992,40014,19986,16375,3611,0.819,0.181
12993,40019,3789,0,3789,0.0,1.0
12994,40020,109,0,109,0.0,1.0
12995,40022,834,0,834,0.0,1.0
12996,40023,4118,451,3667,0.11,0.89
12997,40025,59,59,0,1.0,0.0
12998,40026,5458,3631,1827,0.665,0.335
12999,40031,22863,17851,5012,0.781,0.219
13000,40033,12355,5646,6709,0.457,0.543
13001,40036,223,0,223,0.0,1.0
13002,40037,2864,0,2864,0.0,1.0
13003,40040,531,0,531,0.0,1.0
13004,40041,286,286,0,1.0,0.0
13005,40045,3451,467,2984,0.135,0.865
13006,40046,1741,0,1741,0.0,1.0
13007,40047,19345,15151,4194,0.783,0.217
13008,40048,113,113,0,1.0,0.0
13009,40049,115,0,115,0.0,1.0
13010,40050,1389,0,1389,0.0,1.0
13011,40051,4799,0,4799,0.0,1.0
13012,40052,515,0,515,0.0,1.0
13013,40055,1752,0,1752,0.0,1.0
13014,40056,3263,3263,0,1.0,0.0
13015,40057,3354,0,3354,0.0,1.0
13016,40058,64,0,64,0.0,1.0
13017,40059,16708,15713,995,0.94,0.06
13018,40060,1184,0,1184,0.0,1.0
13019,40062,301,0,301,0.0,1.0
13020,40063,789,0,789,0.0,1.0
13021,40065,28025,20621,7404,0.736,0.264
13022,40067,5114,0,5114,0.0,1.0
13023,40068,2131,0,2131,0.0,1.0
13024,40069,8276,0,8276,0.0,1.0
13025,40070,582,0,582,0.0,1.0
13026,40071,14292,0,14292,0.0,1.0
13027,40075,1323,0,1323,0.0,1.0
13028,40076,2516,0,2516,0.0,1.0
13029,40077,564,0,564,0.0,1.0
13030,40078,2200,0,2200,0.0,1.0
13031,40104,1336,0,1336,0.0,1.0
13032,40107,2067,0,2067,0.0,1.0
13033,40108,11583,0,11583,0.0,1.0
13034,40109,1990,823,1167,0.414,0.586
13035,40110,60,0,60,0.0,1.0
13036,40111,1682,0,1682,0.0,1.0
13037,40115,727,0,727,0.0,1.0
13038,40117,2299,0,2299,0.0,1.0
13039,40118,9724,8678,1046,0.892,0.108
13040,40119,1797,0,1797,0.0,1.0
13041,40121,10124,10123,1,1.0,0.0
13042,40140,787,0,787,0.0,1.0
13043,40142,2304,0,2304,0.0,1.0
13044,40143,5939,0,5939,0.0,1.0
13045,40144,1866,0,1866,0.0,1.0
13046,40145,908,0,908,0.0,1.0
13047,40146,3745,0,3745,0.0,1.0
13048,40150,4103,0,4103,0.0,1.0
13049,40152,604,0,604,0.0,1.0
13050,40155,947,947,0,1.0,0.0
13051,40157,876,0,876,0.0,1.0
13052,40160,23574,22561,1013,0.957,0.043
13053,40161,178,0,178,0.0,1.0
13054,40162,6056,227,5829,0.037,0.963
13055,40165,32726,22122,10604,0.676,0.324
13056,40170,344,0,344,0.0,1.0
13057,40171,243,0,243,0.0,1.0
13058,40175,13070,5481,7589,0.419,0.581
13059,40176,931,0,931,0.0,1.0
13060,40177,1463,0,1463,0.0,1.0
13061,40178,468,0,468,0.0,1.0
13062,40202,6772,6772,0,1.0,0.0
13063,40203,19694,19694,0,1.0,0.0
13064,40204,14236,14236,0,1.0,0.0
13065,40205,23678,23678,0,1.0,0.0
13066,40206,18865,18865,0,1.0,0.0
13067,40207,29745,29745,0,1.0,0.0
13068,40208,13227,13227,0,1.0,0.0
13069,40209,360,360,0,1.0,0.0
13070,40210,14822,14822,0,1.0,0.0
13071,40211,22612,22612,0,1.0,0.0
13072,40212,17685,17685,0,1.0,0.0
13073,40213,16796,16796,0,1.0,0.0
13074,40214,45291,45291,0,1.0,0.0
13075,40215,22287,22287,0,1.0,0.0
13076,40216,40746,40714,32,0.999,0.001
13077,40217,12507,12507,0,1.0,0.0
13078,40218,31658,31658,0,1.0,0.0
13079,40219,38032,38010,22,0.999,0.001
13080,40220,33109,33109,0,1.0,0.0
13081,40222,21359,21359,0,1.0,0.0
13082,40223,22011,21958,53,0.998,0.002
13083,40228,15743,15743,0,1.0,0.0
13084,40229,36852,36426,426,0.988,0.012
13085,40231,0,0,0,,
13086,40241,28988,28988,0,1.0,0.0
13087,40242,10930,10930,0,1.0,0.0
13088,40243,10210,10026,184,0.982,0.018
13089,40245,30109,28155,1954,0.935,0.065
13090,40258,26465,26445,20,0.999,0.001
13091,40272,37394,35260,2134,0.943,0.057
13092,40280,303,303,0,1.0,0.0
13093,40291,35427,34774,653,0.982,0.018
13094,40299,38371,35481,2890,0.925,0.075
13095,40310,526,0,526,0.0,1.0
13096,40311,7153,0,7153,0.0,1.0
13097,40312,5898,1200,4698,0.203,0.797
13098,40313,3143,1286,1857,0.409,0.591
13099,40316,309,0,309,0.0,1.0
13100,40322,3328,0,3328,0.0,1.0
13101,40324,41342,31859,9483,0.771,0.229
13102,40328,1065,0,1065,0.0,1.0
13103,40330,19334,8715,10619,0.451,0.549
13104,40334,76,0,76,0.0,1.0
13105,40336,13061,2898,10163,0.222,0.778
13106,40337,5501,0,5501,0.0,1.0
13107,40339,46,0,46,0.0,1.0
13108,40342,21125,12489,8636,0.591,0.409
13109,40346,686,0,686,0.0,1.0
13110,40347,2767,26,2741,0.009,0.991
13111,40348,600,0,600,0.0,1.0
13112,40350,228,0,228,0.0,1.0
13113,40351,20329,5996,14333,0.295,0.705
13114,40353,20779,10835,9944,0.521,0.479
13115,40356,40503,30495,10008,0.753,0.247
13116,40358,904,0,904,0.0,1.0
13117,40359,7080,0,7080,0.0,1.0
13118,40360,6564,0,6564,0.0,1.0
13119,40361,18220,11042,7178,0.606,0.394
13120,40363,22,0,22,0.0,1.0
13121,40370,2763,0,2763,0.0,1.0
13122,40371,2838,0,2838,0.0,1.0
13123,40372,2128,0,2128,0.0,1.0
13124,40374,1702,0,1702,0.0,1.0
13125,40376,52,0,52,0.0,1.0
13126,40379,3288,0,3288,0.0,1.0
13127,40380,6612,2949,3663,0.446,0.554
13128,40383,22408,15907,6501,0.71,0.29
13129,40385,3131,0,3131,0.0,1.0
13130,40387,2046,0,2046,0.0,1.0
13131,40390,7366,5508,1858,0.748,0.252
13132,40391,35262,25831,9431,0.733,0.267
13133,40402,2905,0,2905,0.0,1.0
13134,40403,23774,14311,9463,0.602,0.398
13135,40404,643,643,0,1.0,0.0
13136,40409,3843,0,3843,0.0,1.0
13137,40419,4621,0,4621,0.0,1.0
13138,40422,24280,17360,6920,0.715,0.285
13139,40434,34,0,34,0.0,1.0
13140,40437,4932,0,4932,0.0,1.0
13141,40440,2092,1230,862,0.588,0.412
13142,40442,1136,0,1136,0.0,1.0
13143,40444,14096,3739,10357,0.265,0.735
13144,40445,997,0,997,0.0,1.0
13145,40447,8251,0,8251,0.0,1.0
13146,40448,53,0,53,0.0,1.0
13147,40456,9300,2626,6674,0.282,0.718
13148,40460,1129,0,1129,0.0,1.0
13149,40461,3121,553,2568,0.177,0.823
13150,40464,1114,0,1114,0.0,1.0
13151,40468,1807,0,1807,0.0,1.0
13152,40472,1679,605,1074,0.36,0.64
13153,40475,55803,35623,20180,0.638,0.362
13154,40481,218,0,218,0.0,1.0
13155,40484,11612,4480,7132,0.386,0.614
13156,40486,2223,0,2223,0.0,1.0
13157,40489,4109,0,4109,0.0,1.0
13158,40502,25709,25709,0,1.0,0.0
13159,40503,28003,28003,0,1.0,0.0
13160,40504,25655,25655,0,1.0,0.0
13161,40505,26040,26040,0,1.0,0.0
13162,40506,2802,2802,0,1.0,0.0
13163,40507,1757,1757,0,1.0,0.0
13164,40508,23569,23569,0,1.0,0.0
13165,40509,32364,30357,2007,0.938,0.062
13166,40510,1928,1095,833,0.568,0.432
13167,40511,31798,29048,2750,0.914,0.086
13168,40513,10994,10359,635,0.942,0.058
13169,40514,14647,14647,0,1.0,0.0
13170,40515,33595,31590,2005,0.94,0.06
13171,40516,2877,873,2004,0.303,0.697
13172,40517,35227,35227,0,1.0,0.0
13173,40601,49566,35232,14334,0.711,0.289
13174,40604,462,462,0,1.0,0.0
13175,40701,29497,16173,13324,0.548,0.452
13176,40729,5485,1086,4399,0.198,0.802
13177,40734,3764,564,3200,0.15,0.85
13178,40737,1379,0,1379,0.0,1.0
13179,40740,3321,991,2330,0.298,0.702
13180,40741,21875,9530,12345,0.436,0.564
13181,40743,229,70,159,0.306,0.694
13182,40744,18334,8760,9574,0.478,0.522
13183,40759,2531,8,2523,0.003,0.997
13184,40763,469,0,469,0.0,1.0
13185,40769,18507,5969,12538,0.323,0.677
13186,40771,1068,185,883,0.173,0.827
13187,40801,531,219,312,0.412,0.588
13188,40806,2499,1125,1374,0.45,0.55
13189,40807,337,332,5,0.985,0.015
13190,40808,99,0,99,0.0,1.0
13191,40810,1548,0,1548,0.0,1.0
13192,40813,669,0,669,0.0,1.0
13193,40815,1534,0,1534,0.0,1.0
13194,40816,78,0,78,0.0,1.0
13195,40818,110,0,110,0.0,1.0
13196,40819,729,0,729,0.0,1.0
13197,40820,581,0,581,0.0,1.0
13198,40823,4231,2616,1615,0.618,0.382
13199,40824,559,392,167,0.701,0.299
13200,40826,759,0,759,0.0,1.0
13201,40827,674,0,674,0.0,1.0
13202,40828,3965,2216,1749,0.559,0.441
13203,40829,172,114,58,0.663,0.337
13204,40830,301,0,301,0.0,1.0
13205,40831,5150,3296,1854,0.64,0.36
13206,40840,312,0,312,0.0,1.0
13207,40843,259,0,259,0.0,1.0
13208,40844,123,0,123,0.0,1.0
13209,40845,635,0,635,0.0,1.0
13210,40847,261,200,61,0.766,0.234
13211,40849,352,289,63,0.821,0.179
13212,40854,1213,1020,193,0.841,0.159
13213,40855,860,763,97,0.887,0.113
13214,40856,756,0,756,0.0,1.0
13215,40858,397,0,397,0.0,1.0
13216,40862,647,0,647,0.0,1.0
13217,40863,502,0,502,0.0,1.0
13218,40865,410,93,317,0.227,0.773
13219,40868,1100,0,1100,0.0,1.0
13220,40870,279,0,279,0.0,1.0
13221,40873,2390,747,1643,0.313,0.687
13222,40874,504,0,504,0.0,1.0
13223,40902,1239,0,1239,0.0,1.0
13224,40903,681,225,456,0.33,0.67
13225,40906,11132,5160,5972,0.464,0.536
13226,40913,171,0,171,0.0,1.0
13227,40914,467,0,467,0.0,1.0
13228,40915,896,210,686,0.234,0.766
13229,40921,295,0,295,0.0,1.0
13230,40923,735,0,735,0.0,1.0
13231,40927,482,0,482,0.0,1.0
13232,40935,2699,531,2168,0.197,0.803
13233,40939,273,0,273,0.0,1.0
13234,40940,478,0,478,0.0,1.0
13235,40941,251,143,108,0.57,0.43
13236,40943,748,0,748,0.0,1.0
13237,40946,220,0,220,0.0,1.0
13238,40949,788,174,614,0.221,0.779
13239,40953,998,0,998,0.0,1.0
13240,40958,451,0,451,0.0,1.0
13241,40962,19143,4514,14629,0.236,0.764
13242,40964,151,0,151,0.0,1.0
13243,40965,13570,10765,2805,0.793,0.207
13244,40972,1327,0,1327,0.0,1.0
13245,40977,10362,0,10362,0.0,1.0
13246,40979,148,0,148,0.0,1.0
13247,40982,388,0,388,0.0,1.0
13248,40983,352,0,352,0.0,1.0
13249,40988,555,0,555,0.0,1.0
13250,40995,121,0,121,0.0,1.0
13251,40997,371,0,371,0.0,1.0
13252,41001,16412,10514,5898,0.641,0.359
13253,41002,2510,0,2510,0.0,1.0
13254,41003,2786,0,2786,0.0,1.0
13255,41004,4122,0,4122,0.0,1.0
13256,41005,22569,17907,4662,0.793,0.207
13257,41006,4434,0,4434,0.0,1.0
13258,41007,4193,0,4193,0.0,1.0
13259,41008,7457,5165,2292,0.693,0.307
13260,41010,3217,0,3217,0.0,1.0
13261,41011,25872,25872,0,1.0,0.0
13262,41014,6942,6942,0,1.0,0.0
13263,41015,20864,18394,2470,0.882,0.118
13264,41016,6075,6075,0,1.0,0.0
13265,41017,38940,38940,0,1.0,0.0
13266,41018,27345,27345,0,1.0,0.0
13267,41030,6299,3292,3007,0.523,0.477
13268,41031,15886,6421,9465,0.404,0.596
13269,41033,1976,0,1976,0.0,1.0
13270,41034,1032,0,1032,0.0,1.0
13271,41035,10785,2680,8105,0.248,0.752
13272,41039,2502,0,2502,0.0,1.0
13273,41040,7265,0,7265,0.0,1.0
13274,41041,7153,2795,4358,0.391,0.609
13275,41042,49968,49968,0,1.0,0.0
13276,41043,1745,0,1745,0.0,1.0
13277,41044,1116,0,1116,0.0,1.0
13278,41045,1273,0,1273,0.0,1.0
13279,41046,1414,0,1414,0.0,1.0
13280,41048,13959,12661,1298,0.907,0.093
13281,41049,2261,0,2261,0.0,1.0
13282,41051,26796,24277,2519,0.906,0.094
13283,41052,107,0,107,0.0,1.0
13284,41055,1813,0,1813,0.0,1.0
13285,41056,14228,7801,6427,0.548,0.452
13286,41059,2712,785,1927,0.289,0.711
13287,41062,35,0,35,0.0,1.0
13288,41063,3378,0,3378,0.0,1.0
13289,41064,2073,0,2073,0.0,1.0
13290,41071,20869,20869,0,1.0,0.0
13291,41073,5955,5955,0,1.0,0.0
13292,41074,5338,5338,0,1.0,0.0
13293,41075,16459,16459,0,1.0,0.0
13294,41076,16468,14705,1763,0.893,0.107
13295,41080,1849,0,1849,0.0,1.0
13296,41083,1326,0,1326,0.0,1.0
13297,41085,724,724,0,1.0,0.0
13298,41086,2771,0,2771,0.0,1.0
13299,41091,16873,13361,3512,0.792,0.208
13300,41092,3514,24,3490,0.007,0.993
13301,41093,2869,0,2869,0.0,1.0
13302,41094,13631,9776,3855,0.717,0.283
13303,41095,3540,0,3540,0.0,1.0
13304,41097,7349,2740,4609,0.373,0.627
13305,41098,2037,0,2037,0.0,1.0
13306,41099,1169,1169,0,1.0,0.0
13307,41101,18758,18696,62,0.997,0.003
13308,41102,21712,17055,4657,0.786,0.214
13309,41121,1852,0,1852,0.0,1.0
13310,41124,1039,0,1039,0.0,1.0
13311,41129,9922,2747,7175,0.277,0.723
13312,41132,425,0,425,0.0,1.0
13313,41135,172,0,172,0.0,1.0
13314,41139,8271,8059,212,0.974,0.026
13315,41141,2461,0,2461,0.0,1.0
13316,41142,91,0,91,0.0,1.0
13317,41143,14535,5716,8819,0.393,0.607
13318,41144,10279,3314,6965,0.322,0.678
13319,41146,412,0,412,0.0,1.0
13320,41149,733,0,733,0.0,1.0
13321,41159,583,0,583,0.0,1.0
13322,41164,13125,0,13125,0.0,1.0
13323,41166,919,0,919,0.0,1.0
13324,41168,3043,0,3043,0.0,1.0
13325,41169,5354,5105,249,0.953,0.047
13326,41171,5042,0,5042,0.0,1.0
13327,41174,1122,335,787,0.299,0.701
13328,41175,5591,2479,3112,0.443,0.557
13329,41179,7852,0,7852,0.0,1.0
13330,41180,1087,0,1087,0.0,1.0
13331,41183,1618,1618,0,1.0,0.0
13332,41189,2264,0,2264,0.0,1.0
13333,41201,238,0,238,0.0,1.0
13334,41203,696,0,696,0.0,1.0
13335,41204,560,0,560,0.0,1.0
13336,41214,750,0,750,0.0,1.0
13337,41216,1297,101,1196,0.078,0.922
13338,41219,2053,0,2053,0.0,1.0
13339,41222,2627,448,2179,0.171,0.829
13340,41224,6414,0,6414,0.0,1.0
13341,41226,168,0,168,0.0,1.0
13342,41230,11730,3631,8099,0.31,0.69
13343,41231,1002,0,1002,0.0,1.0
13344,41232,782,0,782,0.0,1.0
13345,41234,601,0,601,0.0,1.0
13346,41238,860,0,860,0.0,1.0
13347,41240,6916,4144,2772,0.599,0.401
13348,41250,1195,0,1195,0.0,1.0
13349,41254,571,0,571,0.0,1.0
13350,41255,1036,0,1036,0.0,1.0
13351,41256,2433,642,1791,0.264,0.736
13352,41257,390,0,390,0.0,1.0
13353,41260,885,567,318,0.641,0.359
13354,41262,1474,0,1474,0.0,1.0
13355,41263,525,0,525,0.0,1.0
13356,41264,389,0,389,0.0,1.0
13357,41265,1857,0,1857,0.0,1.0
13358,41267,1245,0,1245,0.0,1.0
13359,41268,395,395,0,1.0,0.0
13360,41271,237,0,237,0.0,1.0
13361,41274,585,68,517,0.116,0.884
13362,41301,6159,0,6159,0.0,1.0
13363,41311,7538,0,7538,0.0,1.0
13364,41314,5239,0,5239,0.0,1.0
13365,41317,190,0,190,0.0,1.0
13366,41332,1184,0,1184,0.0,1.0
13367,41339,10957,2567,8390,0.234,0.766
13368,41348,1219,0,1219,0.0,1.0
13369,41352,677,0,677,0.0,1.0
13370,41360,500,0,500,0.0,1.0
13371,41365,501,0,501,0.0,1.0
13372,41366,20,0,20,0.0,1.0
13373,41367,179,0,179,0.0,1.0
13374,41385,470,0,470,0.0,1.0
13375,41390,52,0,52,0.0,1.0
13376,41397,64,0,64,0.0,1.0
13377,41408,445,0,445,0.0,1.0
13378,41421,233,0,233,0.0,1.0
13379,41425,1138,0,1138,0.0,1.0
13380,41464,722,0,722,0.0,1.0
13381,41465,11979,0,11979,0.0,1.0
13382,41472,10985,0,10985,0.0,1.0
13383,41501,23298,6999,16299,0.3,0.7
13384,41503,570,250,320,0.439,0.561
13385,41512,976,0,976,0.0,1.0
13386,41513,590,0,590,0.0,1.0
13387,41514,3491,400,3091,0.115,0.885
13388,41517,109,0,109,0.0,1.0
13389,41519,1108,0,1108,0.0,1.0
13390,41522,5352,0,5352,0.0,1.0
13391,41524,384,0,384,0.0,1.0
13392,41526,125,125,0,1.0,0.0
13393,41527,675,0,675,0.0,1.0
13394,41528,999,0,999,0.0,1.0
13395,41531,985,21,964,0.021,0.979
13396,41534,273,0,273,0.0,1.0
13397,41535,526,0,526,0.0,1.0
13398,41537,5373,0,5373,0.0,1.0
13399,41538,97,0,97,0.0,1.0
13400,41539,1722,0,1722,0.0,1.0
13401,41540,302,0,302,0.0,1.0
13402,41543,543,0,543,0.0,1.0
13403,41544,931,0,931,0.0,1.0
13404,41547,369,0,369,0.0,1.0
13405,41548,862,0,862,0.0,1.0
13406,41553,2288,0,2288,0.0,1.0
13407,41554,1102,0,1102,0.0,1.0
13408,41555,915,0,915,0.0,1.0
13409,41557,1716,0,1716,0.0,1.0
13410,41558,809,0,809,0.0,1.0
13411,41559,339,0,339,0.0,1.0
13412,41560,384,0,384,0.0,1.0
13413,41562,2807,139,2668,0.05,0.95
13414,41563,445,0,445,0.0,1.0
13415,41564,1159,0,1159,0.0,1.0
13416,41566,714,0,714,0.0,1.0
13417,41567,369,0,369,0.0,1.0
13418,41568,1073,0,1073,0.0,1.0
13419,41571,639,0,639,0.0,1.0
13420,41572,3754,0,3754,0.0,1.0
13421,41601,755,467,288,0.619,0.381
13422,41602,819,440,379,0.537,0.463
13423,41603,1498,0,1498,0.0,1.0
13424,41604,620,0,620,0.0,1.0
13425,41605,637,0,637,0.0,1.0
13426,41606,656,0,656,0.0,1.0
13427,41607,318,0,318,0.0,1.0
13428,41612,78,0,78,0.0,1.0
13429,41615,675,0,675,0.0,1.0
13430,41616,794,0,794,0.0,1.0
13431,41619,599,0,599,0.0,1.0
13432,41621,329,260,69,0.79,0.21
13433,41622,228,0,228,0.0,1.0
13434,41630,1230,0,1230,0.0,1.0
13435,41631,1106,0,1106,0.0,1.0
13436,41632,614,0,614,0.0,1.0
13437,41635,3056,673,2383,0.22,0.78
13438,41636,984,0,984,0.0,1.0
13439,41640,1343,0,1343,0.0,1.0
13440,41642,725,0,725,0.0,1.0
13441,41643,194,0,194,0.0,1.0
13442,41645,1268,0,1268,0.0,1.0
13443,41647,1815,0,1815,0.0,1.0
13444,41649,2631,105,2526,0.04,0.96
13445,41650,534,0,534,0.0,1.0
13446,41653,11451,4355,7096,0.38,0.62
13447,41655,896,0,896,0.0,1.0
13448,41659,520,0,520,0.0,1.0
13449,41660,802,0,802,0.0,1.0
13450,41663,384,0,384,0.0,1.0
13451,41666,908,0,908,0.0,1.0
13452,41667,720,0,720,0.0,1.0
13453,41669,865,0,865,0.0,1.0
13454,41701,17252,6717,10535,0.389,0.611
13455,41712,380,0,380,0.0,1.0
13456,41713,51,0,51,0.0,1.0
13457,41714,418,0,418,0.0,1.0
13458,41719,1043,190,853,0.182,0.818
13459,41721,788,0,788,0.0,1.0
13460,41722,1688,0,1688,0.0,1.0
13461,41723,1537,128,1409,0.083,0.917
13462,41725,174,0,174,0.0,1.0
13463,41727,640,0,640,0.0,1.0
13464,41729,230,230,0,1.0,0.0
13465,41731,1023,0,1023,0.0,1.0
13466,41735,295,0,295,0.0,1.0
13467,41739,179,0,179,0.0,1.0
13468,41740,877,0,877,0.0,1.0
13469,41745,200,0,200,0.0,1.0
13470,41746,835,0,835,0.0,1.0
13471,41749,3556,0,3556,0.0,1.0
13472,41751,289,161,128,0.557,0.443
13473,41754,460,0,460,0.0,1.0
13474,41759,397,0,397,0.0,1.0
13475,41760,35,0,35,0.0,1.0
13476,41762,107,0,107,0.0,1.0
13477,41763,574,0,574,0.0,1.0
13478,41764,741,0,741,0.0,1.0
13479,41766,131,0,131,0.0,1.0
13480,41772,277,0,277,0.0,1.0
13481,41773,1273,0,1273,0.0,1.0
13482,41774,2659,18,2641,0.007,0.993
13483,41775,114,0,114,0.0,1.0
13484,41776,1509,0,1509,0.0,1.0
13485,41777,947,0,947,0.0,1.0
13486,41804,720,0,720,0.0,1.0
13487,41810,502,0,502,0.0,1.0
13488,41812,230,0,230,0.0,1.0
13489,41815,802,0,802,0.0,1.0
13490,41817,251,0,251,0.0,1.0
13491,41819,392,0,392,0.0,1.0
13492,41821,537,0,537,0.0,1.0
13493,41822,2553,0,2553,0.0,1.0
13494,41824,1072,0,1072,0.0,1.0
13495,41825,548,0,548,0.0,1.0
13496,41826,978,0,978,0.0,1.0
13497,41828,808,0,808,0.0,1.0
13498,41831,849,0,849,0.0,1.0
13499,41832,424,0,424,0.0,1.0
13500,41833,321,0,321,0.0,1.0
13501,41834,659,0,659,0.0,1.0
13502,41835,790,0,790,0.0,1.0
13503,41836,798,0,798,0.0,1.0
13504,41837,1284,0,1284,0.0,1.0
13505,41838,548,0,548,0.0,1.0
13506,41839,1193,0,1193,0.0,1.0
13507,41840,1111,0,1111,0.0,1.0
13508,41843,949,0,949,0.0,1.0
13509,41844,1355,0,1355,0.0,1.0
13510,41845,293,0,293,0.0,1.0
13511,41847,617,0,617,0.0,1.0
13512,41848,80,0,80,0.0,1.0
13513,41849,193,0,193,0.0,1.0
13514,41855,696,0,696,0.0,1.0
13515,41858,8064,0,8064,0.0,1.0
13516,41859,349,0,349,0.0,1.0
13517,41861,108,0,108,0.0,1.0
13518,41862,952,0,952,0.0,1.0
13519,42001,27960,23209,4751,0.83,0.17
13520,42003,29683,23972,5711,0.808,0.192
13521,42020,2330,0,2330,0.0,1.0
13522,42021,1505,0,1505,0.0,1.0
13523,42022,104,0,104,0.0,1.0
13524,42023,2422,0,2422,0.0,1.0
13525,42024,1490,0,1490,0.0,1.0
13526,42025,19305,4447,14858,0.23,0.77
13527,42027,2291,0,2291,0.0,1.0
13528,42028,635,0,635,0.0,1.0
13529,42029,6321,0,6321,0.0,1.0
13530,42031,3418,0,3418,0.0,1.0
13531,42032,192,0,192,0.0,1.0
13532,42035,1068,0,1068,0.0,1.0
13533,42036,1167,0,1167,0.0,1.0
13534,42037,29,0,29,0.0,1.0
13535,42038,5298,0,5298,0.0,1.0
13536,42039,1751,0,1751,0.0,1.0
13537,42040,1082,0,1082,0.0,1.0
13538,42041,4627,2423,2204,0.524,0.476
13539,42044,3404,0,3404,0.0,1.0
13540,42045,2089,0,2089,0.0,1.0
13541,42047,192,0,192,0.0,1.0
13542,42048,2147,0,2147,0.0,1.0
13543,42049,1480,0,1480,0.0,1.0
13544,42050,3256,0,3256,0.0,1.0
13545,42051,2840,0,2840,0.0,1.0
13546,42053,4931,0,4931,0.0,1.0
13547,42054,984,0,984,0.0,1.0
13548,42055,2609,0,2609,0.0,1.0
13549,42056,1982,0,1982,0.0,1.0
13550,42058,2336,440,1896,0.188,0.812
13551,42060,130,0,130,0.0,1.0
13552,42061,55,0,55,0.0,1.0
13553,42064,8421,2718,5703,0.323,0.677
13554,42066,23182,11356,11826,0.49,0.51
13555,42069,1100,0,1100,0.0,1.0
13556,42071,29655,19072,10583,0.643,0.357
13557,42076,1213,0,1213,0.0,1.0
13558,42078,1852,0,1852,0.0,1.0
13559,42079,1426,0,1426,0.0,1.0
13560,42081,2203,0,2203,0.0,1.0
13561,42082,1845,0,1845,0.0,1.0
13562,42083,446,0,446,0.0,1.0
13563,42084,83,0,83,0.0,1.0
13564,42085,918,0,918,0.0,1.0
13565,42086,4036,141,3895,0.035,0.965
13566,42087,2419,0,2419,0.0,1.0
13567,42088,2656,0,2656,0.0,1.0
13568,42101,55648,38339,17309,0.689,0.311
13569,42102,88,88,0,1.0,0.0
13570,42103,18936,12170,6766,0.643,0.357
13571,42104,29610,27540,2070,0.93,0.07
13572,42120,2588,0,2588,0.0,1.0
13573,42122,4368,169,4199,0.039,0.961
13574,42123,840,0,840,0.0,1.0
13575,42124,55,0,55,0.0,1.0
13576,42127,6199,1919,4280,0.31,0.69
13577,42129,7026,0,7026,0.0,1.0
13578,42130,175,0,175,0.0,1.0
13579,42133,1370,0,1370,0.0,1.0
13580,42134,16785,9492,7293,0.566,0.434
13581,42140,1264,0,1264,0.0,1.0
13582,42141,30349,13569,16780,0.447,0.553
13583,42151,275,0,275,0.0,1.0
13584,42153,326,0,326,0.0,1.0
13585,42154,691,0,691,0.0,1.0
13586,42156,254,0,254,0.0,1.0
13587,42157,437,0,437,0.0,1.0
13588,42159,1195,0,1195,0.0,1.0
13589,42160,1992,0,1992,0.0,1.0
13590,42163,56,0,56,0.0,1.0
13591,42164,16277,4251,12026,0.261,0.739
13592,42166,2314,0,2314,0.0,1.0
13593,42167,8145,0,8145,0.0,1.0
13594,42170,1403,0,1403,0.0,1.0
13595,42171,6841,0,6841,0.0,1.0
13596,42202,2389,0,2389,0.0,1.0
13597,42204,657,0,657,0.0,1.0
13598,42206,5407,0,5407,0.0,1.0
13599,42207,1207,0,1207,0.0,1.0
13600,42210,4236,0,4236,0.0,1.0
13601,42211,13422,2960,10462,0.221,0.779
13602,42214,682,0,682,0.0,1.0
13603,42215,1300,0,1300,0.0,1.0
13604,42217,4117,0,4117,0.0,1.0
13605,42220,6844,0,6844,0.0,1.0
13606,42223,19837,19806,31,0.998,0.002
13607,42232,812,0,812,0.0,1.0
13608,42234,2469,0,2469,0.0,1.0
13609,42236,929,0,929,0.0,1.0
13610,42240,42479,32491,9988,0.765,0.235
13611,42254,209,0,209,0.0,1.0
13612,42256,5028,0,5028,0.0,1.0
13613,42259,1281,0,1281,0.0,1.0
13614,42261,10602,0,10602,0.0,1.0
13615,42262,8396,6661,1735,0.793,0.207
13616,42265,820,0,820,0.0,1.0
13617,42266,2590,0,2590,0.0,1.0
13618,42273,443,0,443,0.0,1.0
13619,42274,2373,0,2373,0.0,1.0
13620,42275,883,0,883,0.0,1.0
13621,42276,14471,6714,7757,0.464,0.536
13622,42280,484,0,484,0.0,1.0
13623,42285,375,0,375,0.0,1.0
13624,42286,1291,0,1291,0.0,1.0
13625,42301,42440,35562,6878,0.838,0.162
13626,42303,38909,34981,3928,0.899,0.101
13627,42320,8205,3678,4527,0.448,0.552
13628,42321,327,0,327,0.0,1.0
13629,42322,47,0,47,0.0,1.0
13630,42323,793,0,793,0.0,1.0
13631,42324,1276,0,1276,0.0,1.0
13632,42325,2028,0,2028,0.0,1.0
13633,42326,460,0,460,0.0,1.0
13634,42327,4037,0,4037,0.0,1.0
13635,42328,1389,0,1389,0.0,1.0
13636,42330,9386,4699,4687,0.501,0.499
13637,42332,271,0,271,0.0,1.0
13638,42333,1111,0,1111,0.0,1.0
13639,42337,2026,0,2026,0.0,1.0
13640,42338,88,0,88,0.0,1.0
13641,42339,800,0,800,0.0,1.0
13642,42343,1782,0,1782,0.0,1.0
13643,42344,856,0,856,0.0,1.0
13644,42345,11747,4639,7108,0.395,0.605
13645,42347,6152,2460,3692,0.4,0.6
13646,42348,4810,916,3894,0.19,0.81
13647,42349,1503,0,1503,0.0,1.0
13648,42350,1433,0,1433,0.0,1.0
13649,42351,3851,0,3851,0.0,1.0
13650,42352,2060,0,2060,0.0,1.0
13651,42354,252,183,69,0.726,0.274
13652,42355,1852,0,1852,0.0,1.0
13653,42356,83,0,83,0.0,1.0
13654,42361,492,0,492,0.0,1.0
13655,42366,5863,0,5863,0.0,1.0
13656,42367,667,605,62,0.907,0.093
13657,42368,1325,0,1325,0.0,1.0
13658,42369,331,0,331,0.0,1.0
13659,42370,28,0,28,0.0,1.0
13660,42371,476,0,476,0.0,1.0
13661,42372,1854,0,1854,0.0,1.0
13662,42374,277,0,277,0.0,1.0
13663,42376,5799,0,5799,0.0,1.0
13664,42378,3339,0,3339,0.0,1.0
13665,42404,2569,0,2569,0.0,1.0
13666,42406,3555,0,3555,0.0,1.0
13667,42408,6737,0,6737,0.0,1.0
13668,42409,2586,0,2586,0.0,1.0
13669,42410,1460,1257,203,0.861,0.139
13670,42411,1656,0,1656,0.0,1.0
13671,42413,3118,460,2658,0.148,0.852
13672,42420,38192,28583,9609,0.748,0.252
13673,42431,26916,20982,5934,0.78,0.22
13674,42436,1030,0,1030,0.0,1.0
13675,42437,8324,5210,3114,0.626,0.374
13676,42440,748,705,43,0.943,0.057
13677,42441,1594,0,1594,0.0,1.0
13678,42442,3504,1405,2099,0.401,0.599
13679,42445,11331,5890,5441,0.52,0.48
13680,42450,4063,0,4063,0.0,1.0
13681,42451,783,0,783,0.0,1.0
13682,42452,2141,0,2141,0.0,1.0
13683,42453,532,0,532,0.0,1.0
13684,42455,3376,0,3376,0.0,1.0
13685,42456,1690,0,1690,0.0,1.0
13686,42458,1151,0,1151,0.0,1.0
13687,42459,4423,0,4423,0.0,1.0
13688,42461,1481,0,1481,0.0,1.0
13689,42462,1319,0,1319,0.0,1.0
13690,42463,156,0,156,0.0,1.0
13691,42464,1799,0,1799,0.0,1.0
13692,42501,17592,11821,5771,0.672,0.328
13693,42503,22894,13634,9260,0.596,0.404
13694,42516,463,0,463,0.0,1.0
13695,42518,2914,827,2087,0.284,0.716
13696,42519,3191,361,2830,0.113,0.887
13697,42528,1524,0,1524,0.0,1.0
13698,42533,802,772,30,0.963,0.037
13699,42539,10026,0,10026,0.0,1.0
13700,42541,531,0,531,0.0,1.0
13701,42544,5843,14,5829,0.002,0.998
13702,42553,5284,1293,3991,0.245,0.755
13703,42565,735,0,735,0.0,1.0
13704,42566,660,0,660,0.0,1.0
13705,42567,6007,320,5687,0.053,0.947
13706,42602,10216,0,10216,0.0,1.0
13707,42603,130,0,130,0.0,1.0
13708,42629,4953,0,4953,0.0,1.0
13709,42631,134,0,134,0.0,1.0
13710,42633,20065,6716,13349,0.335,0.665
13711,42634,1565,0,1565,0.0,1.0
13712,42635,5103,0,5103,0.0,1.0
13713,42638,207,0,207,0.0,1.0
13714,42642,12573,0,12573,0.0,1.0
13715,42647,4086,0,4086,0.0,1.0
13716,42649,2326,0,2326,0.0,1.0
13717,42653,4619,0,4619,0.0,1.0
13718,42701,48194,32828,15366,0.681,0.319
13719,42712,1855,0,1855,0.0,1.0
13720,42713,1641,0,1641,0.0,1.0
13721,42715,347,0,347,0.0,1.0
13722,42716,1582,0,1582,0.0,1.0
13723,42717,6558,0,6558,0.0,1.0
13724,42718,24312,11719,12593,0.482,0.518
13725,42721,3982,0,3982,0.0,1.0
13726,42722,714,0,714,0.0,1.0
13727,42724,4714,1077,3637,0.228,0.772
13728,42726,4667,820,3847,0.176,0.824
13729,42728,15925,4579,11346,0.288,0.712
13730,42729,1617,0,1617,0.0,1.0
13731,42731,341,0,341,0.0,1.0
13732,42732,2120,0,2120,0.0,1.0
13733,42733,1454,0,1454,0.0,1.0
13734,42740,1973,223,1750,0.113,0.887
13735,42741,480,0,480,0.0,1.0
13736,42743,8869,0,8869,0.0,1.0
13737,42746,1892,0,1892,0.0,1.0
13738,42748,8706,3413,5293,0.392,0.608
13739,42749,5245,2332,2913,0.445,0.555
13740,42753,743,0,743,0.0,1.0
13741,42754,15349,5982,9367,0.39,0.61
13742,42757,2974,0,2974,0.0,1.0
13743,42758,139,0,139,0.0,1.0
13744,42762,422,0,422,0.0,1.0
13745,42764,559,0,559,0.0,1.0
13746,42765,5840,0,5840,0.0,1.0
13747,42776,2736,0,2736,0.0,1.0
13748,42782,953,0,953,0.0,1.0
13749,42784,2685,0,2685,0.0,1.0
13750,42788,310,0,310,0.0,1.0
13751,43001,2400,0,2400,0.0,1.0
13752,43002,2262,2262,0,1.0,0.0
13753,43003,2917,0,2917,0.0,1.0
13754,43004,22727,22068,659,0.971,0.029
13755,43005,174,0,174,0.0,1.0
13756,43006,822,0,822,0.0,1.0
13757,43008,2479,2479,0,1.0,0.0
13758,43009,2135,0,2135,0.0,1.0
13759,43010,272,0,272,0.0,1.0
13760,43011,7491,0,7491,0.0,1.0
13761,43013,1201,0,1201,0.0,1.0
13762,43014,3632,0,3632,0.0,1.0
13763,43015,48107,37839,10268,0.787,0.213
13764,43016,31306,31165,141,0.995,0.005
13765,43017,37626,37586,40,0.999,0.001
13766,43019,8700,0,8700,0.0,1.0
13767,43021,10301,5730,4571,0.556,0.444
13768,43022,4161,2352,1809,0.565,0.435
13769,43023,13231,6729,6502,0.509,0.491
13770,43025,5306,2916,2390,0.55,0.45
13771,43026,54017,52228,1789,0.967,0.033
13772,43028,7537,4835,2702,0.642,0.358
13773,43029,664,0,664,0.0,1.0
13774,43030,114,0,114,0.0,1.0
13775,43031,12318,4523,7795,0.367,0.633
13776,43032,77,0,77,0.0,1.0
13777,43033,380,0,380,0.0,1.0
13778,43035,24721,24675,46,0.998,0.002
13779,43036,258,0,258,0.0,1.0
13780,43037,535,0,535,0.0,1.0
13781,43040,31790,22348,9442,0.703,0.297
13782,43044,5528,0,5528,0.0,1.0
13783,43045,1953,0,1953,0.0,1.0
13784,43046,3396,1827,1569,0.538,0.462
13785,43050,29050,19801,9249,0.682,0.318
13786,43054,20566,19305,1261,0.939,0.061
13787,43055,59605,50351,9254,0.845,0.155
13788,43056,17439,10607,6832,0.608,0.392
13789,43060,2480,0,2480,0.0,1.0
13790,43061,3967,0,3967,0.0,1.0
13791,43062,27644,16928,10716,0.612,0.388
13792,43064,12580,4369,8211,0.347,0.653
13793,43065,38821,37300,1521,0.961,0.039
13794,43066,1328,0,1328,0.0,1.0
13795,43067,1591,0,1591,0.0,1.0
13796,43068,51836,51779,57,0.999,0.001
13797,43070,133,0,133,0.0,1.0
13798,43071,2351,386,1965,0.164,0.836
13799,43072,5948,0,5948,0.0,1.0
13800,43074,11655,3953,7702,0.339,0.661
13801,43076,9051,773,8278,0.085,0.915
13802,43077,258,0,258,0.0,1.0
13803,43078,20885,11699,9186,0.56,0.44
13804,43080,5498,0,5498,0.0,1.0
13805,43081,55991,54879,1112,0.98,0.02
13806,43082,29946,28519,1427,0.952,0.048
13807,43084,841,0,841,0.0,1.0
13808,43085,23258,23258,0,1.0,0.0
13809,43101,380,0,380,0.0,1.0
13810,43102,4512,0,4512,0.0,1.0
13811,43103,10697,6168,4529,0.577,0.423
13812,43105,8147,3212,4935,0.394,0.606
13813,43106,1685,0,1685,0.0,1.0
13814,43107,3153,0,3153,0.0,1.0
13815,43109,118,118,0,1.0,0.0
13816,43110,33847,28807,5040,0.851,0.149
13817,43111,225,0,225,0.0,1.0
13818,43112,4617,3,4614,0.001,0.999
13819,43113,23717,15019,8698,0.633,0.367
13820,43115,1321,0,1321,0.0,1.0
13821,43116,1448,0,1448,0.0,1.0
13822,43117,73,0,73,0.0,1.0
13823,43119,27698,25155,2543,0.908,0.092
13824,43123,58424,54022,4402,0.925,0.075
13825,43125,12161,10574,1587,0.87,0.13
13826,43126,326,326,0,1.0,0.0
13827,43127,283,0,283,0.0,1.0
13828,43128,2309,0,2309,0.0,1.0
13829,43130,59570,42554,17016,0.714,0.286
13830,43135,4445,0,4445,0.0,1.0
13831,43136,460,460,0,1.0,0.0
13832,43137,2388,1116,1272,0.467,0.533
13833,43138,18437,8080,10357,0.438,0.562
13834,43140,24066,14260,9806,0.593,0.407
13835,43142,111,0,111,0.0,1.0
13836,43143,5694,0,5694,0.0,1.0
13837,43144,477,0,477,0.0,1.0
13838,43145,1918,0,1918,0.0,1.0
13839,43146,12369,6513,5856,0.527,0.473
13840,43147,38440,37238,1202,0.969,0.031
13841,43148,2220,0,2220,0.0,1.0
13842,43149,2552,0,2552,0.0,1.0
13843,43150,2482,0,2482,0.0,1.0
13844,43151,322,0,322,0.0,1.0
13845,43152,921,0,921,0.0,1.0
13846,43153,971,0,971,0.0,1.0
13847,43154,3150,0,3150,0.0,1.0
13848,43155,2543,0,2543,0.0,1.0
13849,43156,242,0,242,0.0,1.0
13850,43157,610,610,0,1.0,0.0
13851,43158,268,0,268,0.0,1.0
13852,43160,22305,15168,7137,0.68,0.32
13853,43162,6926,4572,2354,0.66,0.34
13854,43164,2203,0,2203,0.0,1.0
13855,43201,35495,35495,0,1.0,0.0
13856,43202,20251,20251,0,1.0,0.0
13857,43203,8108,8108,0,1.0,0.0
13858,43204,42104,42104,0,1.0,0.0
13859,43205,12272,12272,0,1.0,0.0
13860,43206,21864,21864,0,1.0,0.0
13861,43207,45144,45132,12,1.0,0.0
13862,43209,27228,27228,0,1.0,0.0
13863,43210,9432,9432,0,1.0,0.0
13864,43211,21600,21600,0,1.0,0.0
13865,43212,18551,18551,0,1.0,0.0
13866,43213,30444,30444,0,1.0,0.0
13867,43214,24650,24650,0,1.0,0.0
13868,43215,12790,12790,0,1.0,0.0
13869,43217,2602,2593,9,0.997,0.003
13870,43219,27123,27123,0,1.0,0.0
13871,43220,24989,24989,0,1.0,0.0
13872,43221,31265,31265,0,1.0,0.0
13873,43222,4617,4617,0,1.0,0.0
13874,43223,27366,27366,0,1.0,0.0
13875,43224,38699,38699,0,1.0,0.0
13876,43227,21340,21340,0,1.0,0.0
13877,43228,50737,50693,44,0.999,0.001
13878,43229,46347,46347,0,1.0,0.0
13879,43230,51161,51161,0,1.0,0.0
13880,43231,19685,19685,0,1.0,0.0
13881,43232,42201,42201,0,1.0,0.0
13882,43235,38493,38493,0,1.0,0.0
13883,43240,3469,3469,0,1.0,0.0
13884,43302,54790,46264,8526,0.844,0.156
13885,43310,3104,0,3104,0.0,1.0
13886,43311,19240,13235,6005,0.688,0.312
13887,43314,3173,0,3173,0.0,1.0
13888,43315,7046,0,7046,0.0,1.0
13889,43316,6041,3575,2466,0.592,0.408
13890,43317,168,0,168,0.0,1.0
13891,43318,3864,0,3864,0.0,1.0
13892,43319,1040,0,1040,0.0,1.0
13893,43320,1588,417,1171,0.263,0.737
13894,43321,267,0,267,0.0,1.0
13895,43322,374,0,374,0.0,1.0
13896,43323,680,0,680,0.0,1.0
13897,43324,2817,824,1993,0.293,0.707
13898,43326,13611,8360,5251,0.614,0.386
13899,43330,118,0,118,0.0,1.0
13900,43331,4485,3714,771,0.828,0.172
13901,43332,2323,0,2323,0.0,1.0
13902,43333,894,106,788,0.119,0.881
13903,43334,6651,0,6651,0.0,1.0
13904,43336,39,0,39,0.0,1.0
13905,43337,1108,0,1108,0.0,1.0
13906,43338,10489,3467,7022,0.331,0.669
13907,43340,1721,0,1721,0.0,1.0
13908,43341,907,0,907,0.0,1.0
13909,43342,3228,120,3108,0.037,0.963
13910,43343,1505,0,1505,0.0,1.0
13911,43344,5677,0,5677,0.0,1.0
13912,43345,920,0,920,0.0,1.0
13913,43347,1530,0,1530,0.0,1.0
13914,43348,1984,1879,105,0.947,0.053
13915,43351,10436,6055,4381,0.58,0.42
13916,43356,1103,0,1103,0.0,1.0
13917,43357,4763,0,4763,0.0,1.0
13918,43358,2521,0,2521,0.0,1.0
13919,43359,819,0,819,0.0,1.0
13920,43360,1593,0,1593,0.0,1.0
13921,43402,31327,25416,5911,0.811,0.189
13922,43403,5004,5004,0,1.0,0.0
13923,43406,1777,0,1777,0.0,1.0
13924,43407,639,0,639,0.0,1.0
13925,43408,269,219,50,0.814,0.186
13926,43410,10403,5986,4417,0.575,0.425
13927,43412,4362,1077,3285,0.247,0.753
13928,43413,1407,0,1407,0.0,1.0
13929,43416,2891,0,2891,0.0,1.0
13930,43420,30579,23385,7194,0.765,0.235
13931,43430,4783,3377,1406,0.706,0.294
13932,43431,4752,0,4752,0.0,1.0
13933,43432,1366,0,1366,0.0,1.0
13934,43433,95,0,95,0.0,1.0
13935,43434,101,101,0,1.0,0.0
13936,43435,1532,0,1532,0.0,1.0
13937,43437,427,0,427,0.0,1.0
13938,43438,312,0,312,0.0,1.0
13939,43439,113,0,113,0.0,1.0
13940,43440,4875,2498,2377,0.512,0.488
13941,43442,999,0,999,0.0,1.0
13942,43443,1834,0,1834,0.0,1.0
13943,43445,1161,0,1161,0.0,1.0
13944,43446,25,0,25,0.0,1.0
13945,43447,3450,2200,1250,0.638,0.362
13946,43449,8278,2794,5484,0.338,0.662
13947,43450,3619,0,3619,0.0,1.0
13948,43451,1119,318,801,0.284,0.716
13949,43452,13811,10851,2960,0.786,0.214
13950,43456,608,0,608,0.0,1.0
13951,43457,1456,0,1456,0.0,1.0
13952,43458,414,0,414,0.0,1.0
13953,43460,6289,6289,0,1.0,0.0
13954,43462,1163,0,1163,0.0,1.0
13955,43463,18,18,0,1.0,0.0
13956,43464,1460,0,1460,0.0,1.0
13957,43465,5059,4497,562,0.889,0.111
13958,43466,2192,0,2192,0.0,1.0
13959,43467,106,0,106,0.0,1.0
13960,43468,451,0,451,0.0,1.0
13961,43469,3149,0,3149,0.0,1.0
13962,43501,788,0,788,0.0,1.0
13963,43502,6933,4353,2580,0.628,0.372
13964,43504,1094,0,1094,0.0,1.0
13965,43505,96,0,96,0.0,1.0
13966,43506,14830,9762,5068,0.658,0.342
13967,43511,940,0,940,0.0,1.0
13968,43512,28674,18306,10368,0.638,0.362
13969,43515,7979,3158,4821,0.396,0.604
13970,43516,2951,0,2951,0.0,1.0
13971,43517,3744,0,3744,0.0,1.0
13972,43518,2726,0,2726,0.0,1.0
13973,43519,184,0,184,0.0,1.0
13974,43521,2811,0,2811,0.0,1.0
13975,43522,3344,0,3344,0.0,1.0
13976,43523,62,0,62,0.0,1.0
13977,43524,1236,0,1236,0.0,1.0
13978,43525,1152,0,1152,0.0,1.0
13979,43526,6072,3613,2459,0.595,0.405
13980,43527,2287,0,2287,0.0,1.0
13981,43528,16430,15600,830,0.949,0.051
13982,43529,256,0,256,0.0,1.0
13983,43531,216,0,216,0.0,1.0
13984,43532,4015,0,4015,0.0,1.0
13985,43533,1553,0,1553,0.0,1.0
13986,43534,1784,0,1784,0.0,1.0
13987,43535,757,0,757,0.0,1.0
13988,43536,394,0,394,0.0,1.0
13989,43537,27276,27096,180,0.993,0.007
13990,43540,1501,0,1501,0.0,1.0
13991,43541,144,0,144,0.0,1.0
13992,43542,3591,1216,2375,0.339,0.661
13993,43543,7771,3929,3842,0.506,0.494
13994,43545,14034,8724,5310,0.622,0.378
13995,43547,284,0,284,0.0,1.0
13996,43548,700,0,700,0.0,1.0
13997,43549,1460,0,1460,0.0,1.0
13998,43551,37002,32396,4606,0.876,0.124
13999,43553,252,252,0,1.0,0.0
14000,43554,2408,0,2408,0.0,1.0
14001,43555,200,0,200,0.0,1.0
14002,43556,1860,0,1860,0.0,1.0
14003,43557,3393,0,3393,0.0,1.0
14004,43558,13579,4655,8924,0.343,0.657
14005,43560,32226,31526,700,0.978,0.022
14006,43565,348,0,348,0.0,1.0
14007,43566,7613,6701,912,0.88,0.12
14008,43567,13283,7348,5935,0.553,0.447
14009,43569,2818,0,2818,0.0,1.0
14010,43570,3106,0,3106,0.0,1.0
14011,43571,6783,4200,2583,0.619,0.381
14012,43604,10154,10154,0,1.0,0.0
14013,43605,28346,28346,0,1.0,0.0
14014,43606,26429,26429,0,1.0,0.0
14015,43607,23958,23958,0,1.0,0.0
14016,43608,16515,16515,0,1.0,0.0
14017,43609,23687,23687,0,1.0,0.0
14018,43610,5105,5105,0,1.0,0.0
14019,43611,19207,19207,0,1.0,0.0
14020,43612,29674,29674,0,1.0,0.0
14021,43613,31635,31635,0,1.0,0.0
14022,43614,29290,29290,0,1.0,0.0
14023,43615,39441,39441,0,1.0,0.0
14024,43616,20873,17097,3776,0.819,0.181
14025,43617,7500,7293,207,0.972,0.028
14026,43619,7499,7294,205,0.973,0.027
14027,43620,5858,5858,0,1.0,0.0
14028,43623,20149,20149,0,1.0,0.0
14029,43701,55643,40132,15511,0.721,0.279
14030,43711,91,0,91,0.0,1.0
14031,43713,7487,4351,3136,0.581,0.419
14032,43716,1973,0,1973,0.0,1.0
14033,43717,164,151,13,0.921,0.079
14034,43718,3209,0,3209,0.0,1.0
14035,43719,2601,0,2601,0.0,1.0
14036,43720,1300,0,1300,0.0,1.0
14037,43721,149,0,149,0.0,1.0
14038,43722,420,0,420,0.0,1.0
14039,43723,4984,2819,2165,0.566,0.434
14040,43724,9201,5337,3864,0.58,0.42
14041,43725,20357,12513,7844,0.615,0.385
14042,43727,1473,0,1473,0.0,1.0
14043,43728,1250,0,1250,0.0,1.0
14044,43730,2503,0,2503,0.0,1.0
14045,43731,5461,2911,2550,0.533,0.467
14046,43732,1703,0,1703,0.0,1.0
14047,43733,95,0,95,0.0,1.0
14048,43734,1171,0,1171,0.0,1.0
14049,43735,499,0,499,0.0,1.0
14050,43736,55,0,55,0.0,1.0
14051,43738,164,0,164,0.0,1.0
14052,43739,2025,0,2025,0.0,1.0
14053,43740,256,0,256,0.0,1.0
14054,43746,1425,0,1425,0.0,1.0
14055,43747,1083,0,1083,0.0,1.0
14056,43748,2755,0,2755,0.0,1.0
14057,43749,2339,0,2339,0.0,1.0
14058,43750,164,0,164,0.0,1.0
14059,43754,1542,0,1542,0.0,1.0
14060,43755,1620,0,1620,0.0,1.0
14061,43756,5320,1961,3359,0.369,0.631
14062,43758,3315,691,2624,0.208,0.792
14063,43759,66,0,66,0.0,1.0
14064,43760,1831,0,1831,0.0,1.0
14065,43761,111,0,111,0.0,1.0
14066,43762,5413,2665,2748,0.492,0.508
14067,43764,8566,4940,3626,0.577,0.423
14068,43766,1648,0,1648,0.0,1.0
14069,43767,1443,184,1259,0.128,0.872
14070,43768,275,0,275,0.0,1.0
14071,43771,2007,43,1964,0.021,0.979
14072,43772,1879,0,1879,0.0,1.0
14073,43773,3248,0,3248,0.0,1.0
14074,43777,4714,2123,2591,0.45,0.55
14075,43778,1526,0,1526,0.0,1.0
14076,43779,971,0,971,0.0,1.0
14077,43780,2106,0,2106,0.0,1.0
14078,43782,849,0,849,0.0,1.0
14079,43783,4704,0,4704,0.0,1.0
14080,43786,32,0,32,0.0,1.0
14081,43787,2997,0,2997,0.0,1.0
14082,43788,865,0,865,0.0,1.0
14083,43793,5110,0,5110,0.0,1.0
14084,43802,1075,0,1075,0.0,1.0
14085,43804,3851,0,3851,0.0,1.0
14086,43805,71,0,71,0.0,1.0
14087,43811,829,0,829,0.0,1.0
14088,43812,19061,11517,7544,0.604,0.396
14089,43821,4327,0,4327,0.0,1.0
14090,43822,4626,0,4626,0.0,1.0
14091,43824,3787,0,3787,0.0,1.0
14092,43830,6158,1789,4369,0.291,0.709
14093,43832,7479,4170,3309,0.558,0.442
14094,43836,128,0,128,0.0,1.0
14095,43837,1973,0,1973,0.0,1.0
14096,43840,1248,0,1248,0.0,1.0
14097,43842,355,0,355,0.0,1.0
14098,43843,1123,0,1123,0.0,1.0
14099,43844,3869,0,3869,0.0,1.0
14100,43845,4711,2534,2177,0.538,0.462
14101,43901,2219,0,2219,0.0,1.0
14102,43902,202,0,202,0.0,1.0
14103,43903,2208,0,2208,0.0,1.0
14104,43905,237,0,237,0.0,1.0
14105,43906,8678,5133,3545,0.591,0.409
14106,43907,6008,2521,3487,0.42,0.58
14107,43908,1574,0,1574,0.0,1.0
14108,43910,3631,429,3202,0.118,0.882
14109,43912,6801,4560,2241,0.67,0.33
14110,43913,1490,1400,90,0.94,0.06
14111,43914,94,0,94,0.0,1.0
14112,43915,1495,5,1490,0.003,0.997
14113,43917,3136,0,3136,0.0,1.0
14114,43920,23438,19744,3694,0.842,0.158
14115,43925,82,0,82,0.0,1.0
14116,43926,285,285,0,1.0,0.0
14117,43927,74,0,74,0.0,1.0
14118,43928,116,0,116,0.0,1.0
14119,43930,882,0,882,0.0,1.0
14120,43931,272,272,0,1.0,0.0
14121,43932,931,0,931,0.0,1.0
14122,43933,2070,0,2070,0.0,1.0
14123,43934,295,293,2,0.993,0.007
14124,43935,8943,7140,1803,0.798,0.202
14125,43938,5794,4164,1630,0.719,0.281
14126,43939,513,0,513,0.0,1.0
14127,43940,377,0,377,0.0,1.0
14128,43942,2500,0,2500,0.0,1.0
14129,43943,3472,594,2878,0.171,0.829
14130,43944,2529,0,2529,0.0,1.0
14131,43945,3191,0,3191,0.0,1.0
14132,43946,2114,67,2047,0.032,0.968
14133,43947,5322,4149,1173,0.78,0.22
14134,43948,670,0,670,0.0,1.0
14135,43950,16762,5826,10936,0.348,0.652
14136,43951,84,0,84,0.0,1.0
14137,43952,19050,17186,1864,0.902,0.098
14138,43953,11553,10830,723,0.937,0.063
14139,43961,294,293,1,0.997,0.003
14140,43962,112,0,112,0.0,1.0
14141,43963,1362,1362,0,1.0,0.0
14142,43964,9575,5331,4244,0.557,0.443
14143,43967,21,0,21,0.0,1.0
14144,43968,7182,3734,3448,0.52,0.48
14145,43970,31,0,31,0.0,1.0
14146,43971,1150,1125,25,0.978,0.022
14147,43972,144,0,144,0.0,1.0
14148,43973,1996,0,1996,0.0,1.0
14149,43974,107,0,107,0.0,1.0
14150,43976,1632,0,1632,0.0,1.0
14151,43977,2407,0,2407,0.0,1.0
14152,43983,440,0,440,0.0,1.0
14153,43985,128,0,128,0.0,1.0
14154,43986,1975,0,1975,0.0,1.0
14155,43988,2476,0,2476,0.0,1.0
14156,44001,20769,18256,2513,0.879,0.121
14157,44003,4676,0,4676,0.0,1.0
14158,44004,33421,28553,4868,0.854,0.146
14159,44010,1667,0,1667,0.0,1.0
14160,44011,21193,21193,0,1.0,0.0
14161,44012,22581,22572,9,1.0,0.0
14162,44017,19161,19161,0,1.0,0.0
14163,44021,6444,1471,4973,0.228,0.772
14164,44022,16516,14513,2003,0.879,0.121
14165,44023,17351,8906,8445,0.513,0.487
14166,44024,23557,8161,15396,0.346,0.654
14167,44026,11116,6171,4945,0.555,0.445
14168,44028,8467,2183,6284,0.258,0.742
14169,44030,16652,13450,3202,0.808,0.192
14170,44032,1557,0,1557,0.0,1.0
14171,44035,64263,62331,1932,0.97,0.03
14172,44039,29563,29424,139,0.995,0.005
14173,44040,3020,1033,1987,0.342,0.658
14174,44041,14979,8613,6366,0.575,0.425
14175,44044,15951,8002,7949,0.502,0.498
14176,44045,422,422,0,1.0,0.0
14177,44046,2222,0,2222,0.0,1.0
14178,44047,9213,3205,6008,0.348,0.652
14179,44048,2565,662,1903,0.258,0.742
14180,44049,238,0,238,0.0,1.0
14181,44050,6118,3246,2872,0.531,0.469
14182,44052,29850,29850,0,1.0,0.0
14183,44053,18256,18256,0,1.0,0.0
14184,44054,12591,12591,0,1.0,0.0
14185,44055,19846,19846,0,1.0,0.0
14186,44056,11157,11157,0,1.0,0.0
14187,44057,19961,14657,5304,0.734,0.266
14188,44060,60211,59418,793,0.987,0.013
14189,44062,14972,3387,11585,0.226,0.774
14190,44064,1657,0,1657,0.0,1.0
14191,44065,4433,0,4433,0.0,1.0
14192,44067,20441,20062,379,0.981,0.019
14193,44070,32902,32902,0,1.0,0.0
14194,44072,4383,1082,3301,0.247,0.753
14195,44074,11679,7980,3699,0.683,0.317
14196,44076,5141,0,5141,0.0,1.0
14197,44077,56491,51242,5249,0.907,0.093
14198,44080,226,0,226,0.0,1.0
14199,44081,7088,6072,1016,0.857,0.143
14200,44082,1619,0,1619,0.0,1.0
14201,44084,3611,0,3611,0.0,1.0
14202,44085,3277,0,3277,0.0,1.0
14203,44086,2391,0,2391,0.0,1.0
14204,44087,20221,19959,262,0.987,0.013
14205,44089,15899,11885,4014,0.748,0.252
14206,44090,11504,4845,6659,0.421,0.579
14207,44092,16835,16835,0,1.0,0.0
14208,44093,1467,0,1467,0.0,1.0
14209,44094,35234,32700,2534,0.928,0.072
14210,44095,33579,33579,0,1.0,0.0
14211,44099,2314,0,2314,0.0,1.0
14212,44101,565,565,0,1.0,0.0
14213,44102,45014,45014,0,1.0,0.0
14214,44103,18123,18123,0,1.0,0.0
14215,44104,22640,22640,0,1.0,0.0
14216,44105,40089,40089,0,1.0,0.0
14217,44106,26896,26896,0,1.0,0.0
14218,44107,52244,52244,0,1.0,0.0
14219,44108,25679,25679,0,1.0,0.0
14220,44109,40646,40646,0,1.0,0.0
14221,44110,20136,20136,0,1.0,0.0
14222,44111,39778,39778,0,1.0,0.0
14223,44112,23073,23073,0,1.0,0.0
14224,44113,19213,19213,0,1.0,0.0
14225,44114,5225,5225,0,1.0,0.0
14226,44115,8307,8307,0,1.0,0.0
14227,44116,20268,20268,0,1.0,0.0
14228,44117,10224,10224,0,1.0,0.0
14229,44118,40438,40438,0,1.0,0.0
14230,44119,12482,12482,0,1.0,0.0
14231,44120,38196,38196,0,1.0,0.0
14232,44121,33220,33220,0,1.0,0.0
14233,44122,34057,34057,0,1.0,0.0
14234,44123,17637,17637,0,1.0,0.0
14235,44124,38282,38033,249,0.993,0.007
14236,44125,28730,28615,115,0.996,0.004
14237,44126,16771,16771,0,1.0,0.0
14238,44127,5586,5586,0,1.0,0.0
14239,44128,29274,29274,0,1.0,0.0
14240,44129,29090,29090,0,1.0,0.0
14241,44130,50639,50639,0,1.0,0.0
14242,44131,20469,20040,429,0.979,0.021
14243,44132,14071,14071,0,1.0,0.0
14244,44133,30394,29502,892,0.971,0.029
14245,44134,38800,38800,0,1.0,0.0
14246,44135,26861,26861,0,1.0,0.0
14247,44136,25608,25608,0,1.0,0.0
14248,44137,23240,23240,0,1.0,0.0
14249,44138,22332,22332,0,1.0,0.0
14250,44139,24356,24050,306,0.987,0.013
14251,44140,15651,15651,0,1.0,0.0
14252,44141,13945,12135,1810,0.87,0.13
14253,44142,19201,19201,0,1.0,0.0
14254,44143,24499,24349,150,0.994,0.006
14255,44144,21089,21089,0,1.0,0.0
14256,44145,32729,32729,0,1.0,0.0
14257,44146,29761,29224,537,0.982,0.018
14258,44147,19480,19480,0,1.0,0.0
14259,44149,19177,19033,144,0.992,0.008
14260,44201,6917,0,6917,0.0,1.0
14261,44202,19561,16725,2836,0.855,0.145
14262,44203,41248,40010,1238,0.97,0.03
14263,44212,43548,43007,541,0.988,0.012
14264,44214,2076,0,2076,0.0,1.0
14265,44215,2162,2052,110,0.949,0.051
14266,44216,9418,5917,3501,0.628,0.372
14267,44217,4142,1984,2158,0.479,0.521
14268,44221,29587,29587,0,1.0,0.0
14269,44223,18185,17442,743,0.959,0.041
14270,44224,38742,38517,225,0.994,0.006
14271,44230,8252,5739,2513,0.695,0.305
14272,44231,8308,2713,5595,0.327,0.673
14273,44233,7646,2477,5169,0.324,0.676
14274,44234,4192,1263,2929,0.301,0.699
14275,44235,1825,0,1825,0.0,1.0
14276,44236,25296,22996,2300,0.909,0.091
14277,44240,37927,36588,1339,0.965,0.035
14278,44241,16428,14584,1844,0.888,0.112
14279,44243,5658,5658,0,1.0,0.0
14280,44250,1253,1253,0,1.0,0.0
14281,44251,850,773,77,0.909,0.091
14282,44253,3218,0,3218,0.0,1.0
14283,44254,4833,2670,2163,0.552,0.448
14284,44255,7987,257,7730,0.032,0.968
14285,44256,62039,43192,18847,0.696,0.304
14286,44260,13450,8769,4681,0.652,0.348
14287,44262,5016,5016,0,1.0,0.0
14288,44264,2315,717,1598,0.31,0.69
14289,44265,51,0,51,0.0,1.0
14290,44266,33581,24764,8817,0.737,0.263
14291,44270,8890,6828,2062,0.768,0.232
14292,44272,5208,1493,3715,0.287,0.713
14293,44273,6718,2580,4138,0.384,0.616
14294,44274,225,0,225,0.0,1.0
14295,44275,3521,0,3521,0.0,1.0
14296,44276,1906,326,1580,0.171,0.829
14297,44278,17868,17868,0,1.0,0.0
14298,44280,4557,279,4278,0.061,0.939
14299,44281,29954,23653,6301,0.79,0.21
14300,44285,85,0,85,0.0,1.0
14301,44286,6109,2145,3964,0.351,0.649
14302,44287,7559,0,7559,0.0,1.0
14303,44288,4118,2174,1944,0.528,0.472
14304,44301,15340,15340,0,1.0,0.0
14305,44302,5524,5524,0,1.0,0.0
14306,44303,7700,7700,0,1.0,0.0
14307,44304,5916,5916,0,1.0,0.0
14308,44305,22294,22294,0,1.0,0.0
14309,44306,22492,22492,0,1.0,0.0
14310,44307,7643,7643,0,1.0,0.0
14311,44308,1392,1392,0,1.0,0.0
14312,44310,22786,22786,0,1.0,0.0
14313,44311,8782,8782,0,1.0,0.0
14314,44312,31919,31919,0,1.0,0.0
14315,44313,24935,24685,250,0.99,0.01
14316,44314,18825,18825,0,1.0,0.0
14317,44319,22686,22686,0,1.0,0.0
14318,44320,19937,19660,277,0.986,0.014
14319,44321,15200,13456,1744,0.885,0.115
14320,44333,18763,15665,3098,0.835,0.165
14321,44401,2892,0,2892,0.0,1.0
14322,44402,3352,0,3352,0.0,1.0
14323,44403,3820,782,3038,0.205,0.795
14324,44404,1624,0,1624,0.0,1.0
14325,44405,8229,8229,0,1.0,0.0
14326,44406,22054,16048,6006,0.728,0.272
14327,44408,10331,6732,3599,0.652,0.348
14328,44410,17409,9782,7627,0.562,0.438
14329,44411,2181,0,2181,0.0,1.0
14330,44412,2644,0,2644,0.0,1.0
14331,44413,7261,4944,2317,0.681,0.319
14332,44417,1659,0,1659,0.0,1.0
14333,44418,1357,0,1357,0.0,1.0
14334,44420,15429,14993,436,0.972,0.028
14335,44423,2425,0,2425,0.0,1.0
14336,44425,14898,11628,3270,0.781,0.219
14337,44427,1612,0,1612,0.0,1.0
14338,44428,3290,0,3290,0.0,1.0
14339,44429,2576,0,2576,0.0,1.0
14340,44430,5270,4264,1006,0.809,0.191
14341,44431,4727,1986,2741,0.42,0.58
14342,44432,13693,5740,7953,0.419,0.581
14343,44436,3836,1540,2296,0.401,0.599
14344,44437,4252,4252,0,1.0,0.0
14345,44438,4751,3796,955,0.799,0.201
14346,44439,115,0,115,0.0,1.0
14347,44440,4967,4718,249,0.95,0.05
14348,44441,1600,0,1600,0.0,1.0
14349,44442,4006,2643,1363,0.66,0.34
14350,44443,1704,0,1704,0.0,1.0
14351,44444,10454,6632,3822,0.634,0.366
14352,44445,3449,1369,2080,0.397,0.603
14353,44446,20955,20551,404,0.981,0.019
14354,44449,1323,0,1323,0.0,1.0
14355,44450,2042,0,2042,0.0,1.0
14356,44451,3032,0,3032,0.0,1.0
14357,44452,3167,815,2352,0.257,0.743
14358,44454,1153,0,1153,0.0,1.0
14359,44455,1890,0,1890,0.0,1.0
14360,44460,26732,15878,10854,0.594,0.406
14361,44470,3790,89,3701,0.023,0.977
14362,44471,11097,11072,25,0.998,0.002
14363,44473,3823,43,3780,0.011,0.989
14364,44481,10408,1329,9079,0.128,0.872
14365,44483,26006,25236,770,0.97,0.03
14366,44484,22991,22653,338,0.985,0.015
14367,44485,16498,16269,229,0.986,0.014
14368,44490,798,753,45,0.944,0.056
14369,44491,3515,0,3515,0.0,1.0
14370,44493,25,0,25,0.0,1.0
14371,44502,10204,10204,0,1.0,0.0
14372,44503,1021,1021,0,1.0,0.0
14373,44504,5262,5262,0,1.0,0.0
14374,44505,19357,19194,163,0.992,0.008
14375,44506,2707,2707,0,1.0,0.0
14376,44507,5863,5863,0,1.0,0.0
14377,44509,11975,11975,0,1.0,0.0
14378,44510,2499,2499,0,1.0,0.0
14379,44511,19672,19672,0,1.0,0.0
14380,44512,34424,34424,0,1.0,0.0
14381,44514,22472,20983,1489,0.934,0.066
14382,44515,27766,26905,861,0.969,0.031
14383,44601,35294,26796,8498,0.759,0.241
14384,44606,7819,0,7819,0.0,1.0
14385,44607,234,0,234,0.0,1.0
14386,44608,2666,0,2666,0.0,1.0
14387,44609,3987,858,3129,0.215,0.785
14388,44610,263,0,263,0.0,1.0
14389,44611,2025,0,2025,0.0,1.0
14390,44612,5293,3651,1642,0.69,0.31
14391,44613,2011,1826,185,0.908,0.092
14392,44614,12595,11491,1104,0.912,0.088
14393,44615,11125,3498,7627,0.314,0.686
14394,44618,6858,2411,4447,0.352,0.648
14395,44620,1567,0,1567,0.0,1.0
14396,44621,4624,2795,1829,0.604,0.396
14397,44622,18588,14312,4276,0.77,0.23
14398,44624,5397,0,5397,0.0,1.0
14399,44625,1418,181,1237,0.128,0.872
14400,44626,2977,161,2816,0.054,0.946
14401,44627,6845,0,6845,0.0,1.0
14402,44628,1067,0,1067,0.0,1.0
14403,44629,2403,265,2138,0.11,0.89
14404,44632,9765,5042,4723,0.516,0.484
14405,44633,2615,0,2615,0.0,1.0
14406,44634,2164,0,2164,0.0,1.0
14407,44637,2694,0,2694,0.0,1.0
14408,44638,1497,0,1497,0.0,1.0
14409,44640,151,97,54,0.642,0.358
14410,44641,20349,15268,5081,0.75,0.25
14411,44643,3239,0,3239,0.0,1.0
14412,44644,4791,2800,1991,0.584,0.416
14413,44645,2465,0,2465,0.0,1.0
14414,44646,47525,47120,405,0.991,0.009
14415,44647,18015,15229,2786,0.845,0.155
14416,44651,861,0,861,0.0,1.0
14417,44652,80,80,0,1.0,0.0
14418,44653,599,596,3,0.995,0.005
14419,44654,19679,2968,16711,0.151,0.849
14420,44656,2968,0,2968,0.0,1.0
14421,44657,10334,4398,5936,0.426,0.574
14422,44659,163,0,163,0.0,1.0
14423,44661,171,0,171,0.0,1.0
14424,44662,9656,4422,5234,0.458,0.542
14425,44663,25362,19265,6097,0.76,0.24
14426,44666,2928,140,2788,0.048,0.952
14427,44667,13481,8780,4701,0.651,0.349
14428,44669,1382,0,1382,0.0,1.0
14429,44670,235,0,235,0.0,1.0
14430,44671,380,0,380,0.0,1.0
14431,44672,4874,4782,92,0.981,0.019
14432,44675,2082,0,2082,0.0,1.0
14433,44676,4877,0,4877,0.0,1.0
14434,44677,2543,1216,1327,0.478,0.522
14435,44678,152,0,152,0.0,1.0
14436,44680,4138,2768,1370,0.669,0.331
14437,44681,7799,0,7799,0.0,1.0
14438,44682,803,777,26,0.968,0.032
14439,44683,8550,5588,2962,0.654,0.346
14440,44685,27556,26289,1267,0.954,0.046
14441,44687,249,0,249,0.0,1.0
14442,44688,3053,0,3053,0.0,1.0
14443,44689,638,0,638,0.0,1.0
14444,44690,166,0,166,0.0,1.0
14445,44691,43753,29214,14539,0.668,0.332
14446,44693,86,0,86,0.0,1.0
14447,44695,1608,0,1608,0.0,1.0
14448,44697,187,66,121,0.353,0.647
14449,44699,937,0,937,0.0,1.0
14450,44702,1053,1053,0,1.0,0.0
14451,44703,8895,8895,0,1.0,0.0
14452,44704,3811,3811,0,1.0,0.0
14453,44705,18772,18772,0,1.0,0.0
14454,44706,18246,17272,974,0.947,0.053
14455,44707,9208,7956,1252,0.864,0.136
14456,44708,25109,25109,0,1.0,0.0
14457,44709,18905,18905,0,1.0,0.0
14458,44710,9179,9179,0,1.0,0.0
14459,44714,9056,9056,0,1.0,0.0
14460,44718,11951,11951,0,1.0,0.0
14461,44720,39010,37084,1926,0.951,0.049
14462,44721,13560,12687,873,0.936,0.064
14463,44730,6050,2877,3173,0.476,0.524
14464,44802,1032,0,1032,0.0,1.0
14465,44804,1202,0,1202,0.0,1.0
14466,44805,32345,20226,12119,0.625,0.375
14467,44807,2381,0,2381,0.0,1.0
14468,44809,293,0,293,0.0,1.0
14469,44811,12867,8413,4454,0.654,0.346
14470,44813,8051,0,8051,0.0,1.0
14471,44814,2929,0,2929,0.0,1.0
14472,44815,637,0,637,0.0,1.0
14473,44816,42,0,42,0.0,1.0
14474,44817,1562,0,1562,0.0,1.0
14475,44818,2644,0,2644,0.0,1.0
14476,44820,18102,12401,5701,0.685,0.315
14477,44822,3240,0,3240,0.0,1.0
14478,44824,4060,1462,2598,0.36,0.64
14479,44825,58,0,58,0.0,1.0
14480,44826,1687,0,1687,0.0,1.0
14481,44827,7097,4739,2358,0.668,0.332
14482,44828,166,0,166,0.0,1.0
14483,44830,18962,14694,4268,0.775,0.225
14484,44833,17121,11227,5894,0.656,0.344
14485,44836,2654,0,2654,0.0,1.0
14486,44837,4514,0,4514,0.0,1.0
14487,44838,266,0,266,0.0,1.0
14488,44839,12519,9372,3147,0.749,0.251
14489,44840,2900,0,2900,0.0,1.0
14490,44841,710,0,710,0.0,1.0
14491,44842,5436,0,5436,0.0,1.0
14492,44843,2387,0,2387,0.0,1.0
14493,44844,764,0,764,0.0,1.0
14494,44846,3301,1480,1821,0.448,0.552
14495,44847,3739,1308,2431,0.35,0.65
14496,44849,2260,0,2260,0.0,1.0
14497,44850,148,0,148,0.0,1.0
14498,44851,5308,0,5308,0.0,1.0
14499,44853,1397,0,1397,0.0,1.0
14500,44854,1749,0,1749,0.0,1.0
14501,44855,1271,0,1271,0.0,1.0
14502,44856,128,0,128,0.0,1.0
14503,44857,23805,18018,5787,0.757,0.243
14504,44859,1737,0,1737,0.0,1.0
14505,44861,64,0,64,0.0,1.0
14506,44864,3204,0,3204,0.0,1.0
14507,44865,3434,0,3434,0.0,1.0
14508,44866,2259,0,2259,0.0,1.0
14509,44867,2351,0,2351,0.0,1.0
14510,44870,41030,38133,2897,0.929,0.071
14511,44874,394,0,394,0.0,1.0
14512,44875,13818,9305,4513,0.673,0.327
14513,44878,3147,0,3147,0.0,1.0
14514,44880,2864,0,2864,0.0,1.0
14515,44881,70,0,70,0.0,1.0
14516,44882,2909,0,2909,0.0,1.0
14517,44883,29413,19546,9867,0.665,0.335
14518,44887,1020,0,1020,0.0,1.0
14519,44889,6703,0,6703,0.0,1.0
14520,44890,11162,6309,4853,0.565,0.435
14521,44901,2501,2501,0,1.0,0.0
14522,44902,5432,5432,0,1.0,0.0
14523,44903,25602,14393,11209,0.562,0.438
14524,44904,13906,9212,4694,0.662,0.338
14525,44905,14513,13705,808,0.944,0.056
14526,44906,16718,15832,886,0.947,0.053
14527,44907,14313,14175,138,0.99,0.01
14528,45001,606,606,0,1.0,0.0
14529,45002,13388,9367,4021,0.7,0.3
14530,45003,697,0,697,0.0,1.0
14531,45005,29963,27866,2097,0.93,0.07
14532,45011,69677,67097,2580,0.963,0.037
14533,45013,52613,40473,12140,0.769,0.231
14534,45014,43917,43917,0,1.0,0.0
14535,45015,12038,12038,0,1.0,0.0
14536,45030,17921,12437,5484,0.694,0.306
14537,45032,348,0,348,0.0,1.0
14538,45033,276,276,0,1.0,0.0
14539,45034,1184,1184,0,1.0,0.0
14540,45036,37504,27298,10206,0.728,0.272
14541,45039,22814,22369,445,0.98,0.02
14542,45040,50627,49919,708,0.986,0.014
14543,45041,199,199,0,1.0,0.0
14544,45042,26451,19743,6708,0.746,0.254
14545,45044,52822,51684,1138,0.978,0.022
14546,45050,8548,8428,120,0.986,0.014
14547,45051,177,177,0,1.0,0.0
14548,45052,4004,3080,924,0.769,0.231
14549,45053,3420,0,3420,0.0,1.0
14550,45054,2471,138,2333,0.056,0.944
14551,45056,27038,21376,5662,0.791,0.209
14552,45062,688,688,0,1.0,0.0
14553,45064,2857,0,2857,0.0,1.0
14554,45065,4442,4403,39,0.991,0.009
14555,45066,23839,21824,2015,0.915,0.085
14556,45067,13898,12445,1453,0.895,0.105
14557,45068,10479,4747,5732,0.453,0.547
14558,45069,49060,49060,0,1.0,0.0
14559,45070,192,0,192,0.0,1.0
14560,45101,2385,1886,499,0.791,0.209
14561,45102,22680,21594,1086,0.952,0.048
14562,45103,31485,23262,8223,0.739,0.261
14563,45106,12349,3258,9091,0.264,0.736
14564,45107,9236,4184,5052,0.453,0.547
14565,45111,376,376,0,1.0,0.0
14566,45112,64,0,64,0.0,1.0
14567,45113,3857,0,3857,0.0,1.0
14568,45115,78,0,78,0.0,1.0
14569,45118,3614,0,3614,0.0,1.0
14570,45120,3672,0,3672,0.0,1.0
14571,45121,9036,3829,5207,0.424,0.576
14572,45122,11054,3119,7935,0.282,0.718
14573,45123,8671,5100,3571,0.588,0.412
14574,45130,3913,0,3913,0.0,1.0
14575,45131,238,0,238,0.0,1.0
14576,45132,262,0,262,0.0,1.0
14577,45133,23900,6668,17232,0.279,0.721
14578,45135,4761,0,4761,0.0,1.0
14579,45140,53267,50938,2329,0.956,0.044
14580,45142,4444,0,4444,0.0,1.0
14581,45144,4272,0,4272,0.0,1.0
14582,45145,40,0,40,0.0,1.0
14583,45146,1580,0,1580,0.0,1.0
14584,45147,147,147,0,1.0,0.0
14585,45148,1588,0,1588,0.0,1.0
14586,45150,31394,29998,1396,0.956,0.044
14587,45152,11329,5478,5851,0.484,0.516
14588,45153,1665,0,1665,0.0,1.0
14589,45154,9172,3030,6142,0.33,0.67
14590,45155,366,0,366,0.0,1.0
14591,45156,98,0,98,0.0,1.0
14592,45157,9758,3685,6073,0.378,0.622
14593,45158,370,0,370,0.0,1.0
14594,45159,3392,0,3392,0.0,1.0
14595,45160,699,699,0,1.0,0.0
14596,45162,2519,0,2519,0.0,1.0
14597,45164,271,0,271,0.0,1.0
14598,45166,98,0,98,0.0,1.0
14599,45167,3764,1767,1997,0.469,0.531
14600,45168,1607,0,1607,0.0,1.0
14601,45169,4772,2512,2260,0.526,0.474
14602,45171,6054,0,6054,0.0,1.0
14603,45172,131,0,131,0.0,1.0
14604,45174,2258,2258,0,1.0,0.0
14605,45176,9100,2266,6834,0.249,0.751
14606,45177,22260,12374,9886,0.556,0.444
14607,45202,15483,15483,0,1.0,0.0
14608,45203,2236,2236,0,1.0,0.0
14609,45204,6972,6972,0,1.0,0.0
14610,45205,19389,19389,0,1.0,0.0
14611,45206,10745,10745,0,1.0,0.0
14612,45207,7974,7974,0,1.0,0.0
14613,45208,17614,17614,0,1.0,0.0
14614,45209,9605,9605,0,1.0,0.0
14615,45211,36111,36111,0,1.0,0.0
14616,45212,22253,22253,0,1.0,0.0
14617,45213,12013,12013,0,1.0,0.0
14618,45214,8738,8738,0,1.0,0.0
14619,45215,29623,29623,0,1.0,0.0
14620,45216,9570,9570,0,1.0,0.0
14621,45217,6566,6566,0,1.0,0.0
14622,45218,3846,3846,0,1.0,0.0
14623,45219,16526,16526,0,1.0,0.0
14624,45220,15313,15313,0,1.0,0.0
14625,45223,12360,12360,0,1.0,0.0
14626,45224,19837,19837,0,1.0,0.0
14627,45225,9040,9040,0,1.0,0.0
14628,45226,5476,5476,0,1.0,0.0
14629,45227,17486,17486,0,1.0,0.0
14630,45229,13020,13020,0,1.0,0.0
14631,45230,27536,27536,0,1.0,0.0
14632,45231,40893,40893,0,1.0,0.0
14633,45232,6358,6358,0,1.0,0.0
14634,45233,15808,15808,0,1.0,0.0
14635,45236,24552,24552,0,1.0,0.0
14636,45237,20021,20021,0,1.0,0.0
14637,45238,45760,45760,0,1.0,0.0
14638,45239,28315,28315,0,1.0,0.0
14639,45240,27286,27286,0,1.0,0.0
14640,45241,23044,23044,0,1.0,0.0
14641,45242,22055,21345,710,0.968,0.032
14642,45243,14891,12411,2480,0.833,0.167
14643,45244,28565,28514,51,0.998,0.002
14644,45245,18542,17560,982,0.947,0.053
14645,45246,15133,15133,0,1.0,0.0
14646,45247,22082,20727,1355,0.939,0.061
14647,45248,24915,24915,0,1.0,0.0
14648,45249,12902,12902,0,1.0,0.0
14649,45251,22391,22245,146,0.993,0.007
14650,45252,4600,2395,2205,0.521,0.479
14651,45255,21775,21061,714,0.967,0.033
14652,45301,130,130,0,1.0,0.0
14653,45302,4280,0,4280,0.0,1.0
14654,45303,2223,0,2223,0.0,1.0
14655,45304,7300,0,7300,0.0,1.0
14656,45305,10712,9069,1643,0.847,0.153
14657,45306,2294,0,2294,0.0,1.0
14658,45307,338,0,338,0.0,1.0
14659,45308,4682,0,4682,0.0,1.0
14660,45309,12123,6558,5565,0.541,0.459
14661,45310,244,0,244,0.0,1.0
14662,45311,6367,0,6367,0.0,1.0
14663,45312,1435,0,1435,0.0,1.0
14664,45314,5916,4041,1875,0.683,0.317
14665,45315,4377,3459,918,0.79,0.21
14666,45316,115,0,115,0.0,1.0
14667,45317,1180,0,1180,0.0,1.0
14668,45318,5365,2727,2638,0.508,0.492
14669,45319,293,285,8,0.973,0.027
14670,45320,15691,11208,4483,0.714,0.286
14671,45321,931,0,931,0.0,1.0
14672,45322,21447,20116,1331,0.938,0.062
14673,45323,5019,4742,277,0.945,0.055
14674,45324,40529,39237,1292,0.968,0.032
14675,45325,2647,0,2647,0.0,1.0
14676,45326,1179,0,1179,0.0,1.0
14677,45327,8917,5495,3422,0.616,0.384
14678,45328,525,0,525,0.0,1.0
14679,45330,834,0,834,0.0,1.0
14680,45331,22930,13337,9593,0.582,0.418
14681,45332,612,0,612,0.0,1.0
14682,45333,1345,0,1345,0.0,1.0
14683,45334,2037,0,2037,0.0,1.0
14684,45335,6939,3769,3170,0.543,0.457
14685,45336,153,0,153,0.0,1.0
14686,45337,1690,0,1690,0.0,1.0
14687,45338,5298,0,5298,0.0,1.0
14688,45339,1234,0,1234,0.0,1.0
14689,45340,830,0,830,0.0,1.0
14690,45341,3883,3491,392,0.899,0.101
14691,45342,36784,34880,1904,0.948,0.052
14692,45344,16955,10470,6485,0.618,0.382
14693,45345,6144,4078,2066,0.664,0.336
14694,45346,2293,0,2293,0.0,1.0
14695,45347,4324,1801,2523,0.417,0.583
14696,45348,994,0,994,0.0,1.0
14697,45349,427,0,427,0.0,1.0
14698,45350,106,0,106,0.0,1.0
14699,45351,274,0,274,0.0,1.0
14700,45352,208,0,208,0.0,1.0
14701,45353,196,0,196,0.0,1.0
14702,45354,642,573,69,0.893,0.107
14703,45356,25172,21104,4068,0.838,0.162
14704,45358,356,0,356,0.0,1.0
14705,45359,1970,0,1970,0.0,1.0
14706,45360,335,333,2,0.994,0.006
14707,45361,288,0,288,0.0,1.0
14708,45362,1076,0,1076,0.0,1.0
14709,45363,1770,610,1160,0.345,0.655
14710,45365,30561,21623,8938,0.708,0.292
14711,45368,4727,0,4727,0.0,1.0
14712,45369,3545,0,3545,0.0,1.0
14713,45370,2452,0,2452,0.0,1.0
14714,45371,18333,12351,5982,0.674,0.326
14715,45372,375,305,70,0.813,0.187
14716,45373,35131,30071,5060,0.856,0.144
14717,45377,15215,13843,1372,0.91,0.09
14718,45378,407,0,407,0.0,1.0
14719,45380,5477,2685,2792,0.49,0.51
14720,45381,5509,0,5509,0.0,1.0
14721,45382,1269,0,1269,0.0,1.0
14722,45383,7037,4599,2438,0.654,0.346
14723,45384,2001,0,2001,0.0,1.0
14724,45385,37247,27870,9377,0.748,0.252
14725,45387,5169,3589,1580,0.694,0.306
14726,45388,812,0,812,0.0,1.0
14727,45389,521,0,521,0.0,1.0
14728,45390,3461,1824,1637,0.527,0.473
14729,45402,11420,11420,0,1.0,0.0
14730,45403,15006,15006,0,1.0,0.0
14731,45404,10833,10833,0,1.0,0.0
14732,45405,18948,18948,0,1.0,0.0
14733,45406,21914,21914,0,1.0,0.0
14734,45409,12868,12868,0,1.0,0.0
14735,45410,15339,15339,0,1.0,0.0
14736,45414,21055,20230,825,0.961,0.039
14737,45415,12631,12631,0,1.0,0.0
14738,45416,5740,5740,0,1.0,0.0
14739,45417,31281,29350,1931,0.938,0.062
14740,45418,1351,1287,64,0.953,0.047
14741,45419,15159,15159,0,1.0,0.0
14742,45420,25438,25438,0,1.0,0.0
14743,45424,49930,48190,1740,0.965,0.035
14744,45426,15239,14639,600,0.961,0.039
14745,45428,240,240,0,1.0,0.0
14746,45429,25885,25885,0,1.0,0.0
14747,45430,7402,7402,0,1.0,0.0
14748,45431,26315,26315,0,1.0,0.0
14749,45432,15288,15288,0,1.0,0.0
14750,45433,2011,1975,36,0.982,0.018
14751,45434,12163,12140,23,0.998,0.002
14752,45439,10000,10000,0,1.0,0.0
14753,45440,20734,20551,183,0.991,0.009
14754,45449,18175,18161,14,0.999,0.001
14755,45458,29880,29754,126,0.996,0.004
14756,45459,27749,27744,5,1.0,0.0
14757,45502,16110,3611,12499,0.224,0.776
14758,45503,32999,32757,242,0.993,0.007
14759,45504,18465,16577,1888,0.898,0.102
14760,45505,20197,19424,773,0.962,0.038
14761,45506,14055,12610,1445,0.897,0.103
14762,45601,57842,32263,25579,0.558,0.442
14763,45612,5303,0,5303,0.0,1.0
14764,45613,3597,0,3597,0.0,1.0
14765,45614,5080,762,4318,0.15,0.85
14766,45616,1559,0,1559,0.0,1.0
14767,45617,71,0,71,0.0,1.0
14768,45618,30,0,30,0.0,1.0
14769,45619,8200,3653,4547,0.445,0.555
14770,45620,917,0,917,0.0,1.0
14771,45621,313,0,313,0.0,1.0
14772,45622,321,0,321,0.0,1.0
14773,45623,3494,206,3288,0.059,0.941
14774,45624,31,0,31,0.0,1.0
14775,45628,5211,0,5211,0.0,1.0
14776,45629,3438,0,3438,0.0,1.0
14777,45630,118,0,118,0.0,1.0
14778,45631,15048,5007,10041,0.333,0.667
14779,45634,2112,0,2112,0.0,1.0
14780,45636,148,0,148,0.0,1.0
14781,45638,21635,13723,7912,0.634,0.366
14782,45640,15960,7130,8830,0.447,0.553
14783,45642,33,0,33,0.0,1.0
14784,45644,4249,0,4249,0.0,1.0
14785,45645,3036,0,3036,0.0,1.0
14786,45646,370,0,370,0.0,1.0
14787,45647,2484,0,2484,0.0,1.0
14788,45648,13372,2931,10441,0.219,0.781
14789,45650,435,0,435,0.0,1.0
14790,45651,6047,0,6047,0.0,1.0
14791,45652,3519,0,3519,0.0,1.0
14792,45653,4179,0,4179,0.0,1.0
14793,45654,917,0,917,0.0,1.0
14794,45656,6639,0,6639,0.0,1.0
14795,45657,2744,0,2744,0.0,1.0
14796,45658,2787,0,2787,0.0,1.0
14797,45659,2973,0,2973,0.0,1.0
14798,45660,8297,0,8297,0.0,1.0
14799,45661,7657,2109,5548,0.275,0.725
14800,45662,30219,24504,5715,0.811,0.189
14801,45663,6762,2477,4285,0.366,0.634
14802,45669,10399,6759,3640,0.65,0.35
14803,45671,457,0,457,0.0,1.0
14804,45672,1749,0,1749,0.0,1.0
14805,45673,385,0,385,0.0,1.0
14806,45674,584,0,584,0.0,1.0
14807,45678,1101,0,1101,0.0,1.0
14808,45679,2812,0,2812,0.0,1.0
14809,45680,13074,9434,3640,0.722,0.278
14810,45681,1689,0,1689,0.0,1.0
14811,45682,2420,0,2420,0.0,1.0
14812,45684,1804,0,1804,0.0,1.0
14813,45685,1251,0,1251,0.0,1.0
14814,45686,3397,0,3397,0.0,1.0
14815,45688,475,0,475,0.0,1.0
14816,45690,14412,5287,9125,0.367,0.633
14817,45692,8773,4638,4135,0.529,0.471
14818,45693,8981,3133,5848,0.349,0.651
14819,45694,12147,6437,5710,0.53,0.47
14820,45695,674,0,674,0.0,1.0
14821,45696,1438,0,1438,0.0,1.0
14822,45697,4894,0,4894,0.0,1.0
14823,45698,341,0,341,0.0,1.0
14824,45701,34122,25137,8985,0.737,0.263
14825,45710,5541,0,5541,0.0,1.0
14826,45711,1115,0,1115,0.0,1.0
14827,45714,9951,6636,3315,0.667,0.333
14828,45715,2630,0,2630,0.0,1.0
14829,45716,469,456,13,0.972,0.028
14830,45719,1046,0,1046,0.0,1.0
14831,45721,29,0,29,0.0,1.0
14832,45723,3740,0,3740,0.0,1.0
14833,45724,1744,0,1744,0.0,1.0
14834,45727,516,0,516,0.0,1.0
14835,45729,1289,0,1289,0.0,1.0
14836,45732,4776,1928,2848,0.404,0.596
14837,45734,549,0,549,0.0,1.0
14838,45735,1730,0,1730,0.0,1.0
14839,45740,494,476,18,0.964,0.036
14840,45741,918,0,918,0.0,1.0
14841,45742,3014,950,2064,0.315,0.685
14842,45743,1449,0,1449,0.0,1.0
14843,45744,2728,2,2726,0.001,0.999
14844,45745,1140,0,1140,0.0,1.0
14845,45746,433,0,433,0.0,1.0
14846,45750,27785,18395,9390,0.662,0.338
14847,45760,3892,2256,1636,0.58,0.42
14848,45761,1745,0,1745,0.0,1.0
14849,45764,9431,5886,3545,0.624,0.376
14850,45766,1382,0,1382,0.0,1.0
14851,45767,2800,0,2800,0.0,1.0
14852,45768,1703,852,851,0.5,0.5
14853,45769,6642,1413,5229,0.213,0.787
14854,45770,620,0,620,0.0,1.0
14855,45771,3432,51,3381,0.015,0.985
14856,45772,2149,0,2149,0.0,1.0
14857,45773,83,0,83,0.0,1.0
14858,45775,1259,0,1259,0.0,1.0
14859,45776,765,0,765,0.0,1.0
14860,45778,824,0,824,0.0,1.0
14861,45779,755,726,29,0.962,0.038
14862,45780,3254,3149,105,0.968,0.032
14863,45782,343,256,87,0.746,0.254
14864,45784,3386,0,3386,0.0,1.0
14865,45786,3253,0,3253,0.0,1.0
14866,45787,29,0,29,0.0,1.0
14867,45788,1129,0,1129,0.0,1.0
14868,45789,177,0,177,0.0,1.0
14869,45801,25303,21918,3385,0.866,0.134
14870,45804,15758,15000,758,0.952,0.048
14871,45805,22514,21491,1023,0.955,0.045
14872,45806,11158,6913,4245,0.62,0.38
14873,45807,12221,7006,5215,0.573,0.427
14874,45808,349,0,349,0.0,1.0
14875,45809,157,0,157,0.0,1.0
14876,45810,8460,5945,2515,0.703,0.297
14877,45812,1943,0,1943,0.0,1.0
14878,45813,3530,0,3530,0.0,1.0
14879,45814,2620,0,2620,0.0,1.0
14880,45816,291,0,291,0.0,1.0
14881,45817,6736,4215,2521,0.626,0.374
14882,45819,233,0,233,0.0,1.0
14883,45820,543,524,19,0.965,0.035
14884,45821,1435,0,1435,0.0,1.0
14885,45822,18943,11259,7684,0.594,0.406
14886,45826,306,0,306,0.0,1.0
14887,45827,2369,0,2369,0.0,1.0
14888,45828,6125,4473,1652,0.73,0.27
14889,45830,6228,0,6228,0.0,1.0
14890,45831,3181,0,3181,0.0,1.0
14891,45832,2905,0,2905,0.0,1.0
14892,45833,10667,7440,3227,0.697,0.303
14893,45835,490,0,490,0.0,1.0
14894,45836,1479,0,1479,0.0,1.0
14895,45838,50,0,50,0.0,1.0
14896,45840,54979,48065,6914,0.874,0.126
14897,45841,929,0,929,0.0,1.0
14898,45843,3701,0,3701,0.0,1.0
14899,45844,3256,0,3256,0.0,1.0
14900,45845,3178,1493,1685,0.47,0.53
14901,45846,4437,0,4437,0.0,1.0
14902,45849,1219,0,1219,0.0,1.0
14903,45850,3653,0,3653,0.0,1.0
14904,45851,669,0,669,0.0,1.0
14905,45853,1439,0,1439,0.0,1.0
14906,45854,498,0,498,0.0,1.0
14907,45855,193,0,193,0.0,1.0
14908,45856,5194,0,5194,0.0,1.0
14909,45858,3083,0,3083,0.0,1.0
14910,45859,495,0,495,0.0,1.0
14911,45860,2274,0,2274,0.0,1.0
14912,45861,296,0,296,0.0,1.0
14913,45862,1507,0,1507,0.0,1.0
14914,45863,1254,0,1254,0.0,1.0
14915,45864,163,0,163,0.0,1.0
14916,45865,4745,2927,1818,0.617,0.383
14917,45866,186,0,186,0.0,1.0
14918,45867,1189,0,1189,0.0,1.0
14919,45868,567,0,567,0.0,1.0
14920,45869,4534,3011,1523,0.664,0.336
14921,45870,156,0,156,0.0,1.0
14922,45871,1955,0,1955,0.0,1.0
14923,45872,4240,3474,766,0.819,0.181
14924,45873,2238,0,2238,0.0,1.0
14925,45874,2100,0,2100,0.0,1.0
14926,45875,10989,5270,5719,0.48,0.52
14927,45876,863,0,863,0.0,1.0
14928,45877,2139,0,2139,0.0,1.0
14929,45879,6284,3550,2734,0.565,0.435
14930,45880,2395,0,2395,0.0,1.0
14931,45881,1461,0,1461,0.0,1.0
14932,45882,3004,0,3004,0.0,1.0
14933,45883,3883,0,3883,0.0,1.0
14934,45884,145,0,145,0.0,1.0
14935,45885,12661,9373,3288,0.74,0.26
14936,45886,551,0,551,0.0,1.0
14937,45887,4755,0,4755,0.0,1.0
14938,45888,220,0,220,0.0,1.0
14939,45889,1351,376,975,0.278,0.722
14940,45890,671,0,671,0.0,1.0
14941,45891,15275,10747,4528,0.704,0.296
14942,45894,605,0,605,0.0,1.0
14943,45895,17945,10684,7261,0.595,0.405
14944,45896,2089,0,2089,0.0,1.0
14945,45897,101,0,101,0.0,1.0
14946,45898,1314,0,1314,0.0,1.0
14947,45899,194,0,194,0.0,1.0
14948,46001,10459,6271,4188,0.6,0.4
14949,46011,16770,11887,4883,0.709,0.291
14950,46012,19414,17198,2216,0.886,0.114
14951,46013,17876,17253,623,0.965,0.035
14952,46016,19225,19225,0,1.0,0.0
14953,46017,6025,4645,1380,0.771,0.229
14954,46030,3308,1734,1574,0.524,0.476
14955,46031,2161,755,1406,0.349,0.651
14956,46032,42234,42234,0,1.0,0.0
14957,46033,34889,34887,2,1.0,0.0
14958,46034,6730,4907,1823,0.729,0.271
14959,46035,1113,0,1113,0.0,1.0
14960,46036,11663,9421,2242,0.808,0.192
14961,46037,35891,35617,274,0.992,0.008
14962,46038,37723,37721,2,1.0,0.0
14963,46039,745,0,745,0.0,1.0
14964,46040,9944,7372,2572,0.741,0.259
14965,46041,23891,16684,7207,0.698,0.302
14966,46044,2965,0,2965,0.0,1.0
14967,46045,93,0,93,0.0,1.0
14968,46047,43,0,43,0.0,1.0
14969,46048,2406,2343,63,0.974,0.026
14970,46049,850,0,850,0.0,1.0
14971,46050,1706,0,1706,0.0,1.0
14972,46051,2826,0,2826,0.0,1.0
14973,46052,22060,15415,6645,0.699,0.301
14974,46055,10193,8857,1336,0.869,0.131
14975,46056,2246,0,2246,0.0,1.0
14976,46057,1179,0,1179,0.0,1.0
14977,46058,2149,0,2149,0.0,1.0
14978,46060,34708,30603,4105,0.882,0.118
14979,46062,29730,27703,2027,0.932,0.068
14980,46063,401,0,401,0.0,1.0
14981,46064,17148,12919,4229,0.753,0.247
14982,46065,3669,0,3669,0.0,1.0
14983,46068,2850,176,2674,0.062,0.938
14984,46069,6664,2745,3919,0.412,0.588
14985,46070,2351,0,2351,0.0,1.0
14986,46071,3417,0,3417,0.0,1.0
14987,46072,9324,5768,3556,0.619,0.381
14988,46074,26745,25240,1505,0.944,0.056
14989,46075,2913,1856,1057,0.637,0.363
14990,46076,1696,0,1696,0.0,1.0
14991,46077,24512,20352,4160,0.83,0.17
14992,46103,159,0,159,0.0,1.0
14993,46104,970,0,970,0.0,1.0
14994,46105,1928,0,1928,0.0,1.0
14995,46106,5928,4311,1617,0.727,0.273
14996,46107,12774,12774,0,1.0,0.0
14997,46110,500,0,500,0.0,1.0
14998,46111,322,322,0,1.0,0.0
14999,46112,33662,30751,2911,0.914,0.086
15000,46113,14063,13030,1033,0.927,0.073
15001,46115,1933,0,1933,0.0,1.0
15002,46117,671,0,671,0.0,1.0
15003,46118,5015,0,5015,0.0,1.0
15004,46120,5954,0,5954,0.0,1.0
15005,46121,5276,2448,2828,0.464,0.536
15006,46122,14671,9190,5481,0.626,0.374
15007,46123,31754,30430,1324,0.958,0.042
15008,46124,8127,5757,2370,0.708,0.292
15009,46125,51,0,51,0.0,1.0
15010,46126,4668,794,3874,0.17,0.83
15011,46127,416,0,416,0.0,1.0
15012,46128,1949,289,1660,0.148,0.852
15013,46130,2508,0,2508,0.0,1.0
15014,46131,31036,24910,6126,0.803,0.197
15015,46133,816,0,816,0.0,1.0
15016,46135,20992,10625,10367,0.506,0.494
15017,46140,38543,26953,11590,0.699,0.301
15018,46142,30413,30361,52,0.998,0.002
15019,46143,48555,46217,2338,0.952,0.048
15020,46144,211,0,211,0.0,1.0
15021,46146,117,0,117,0.0,1.0
15022,46147,3264,0,3264,0.0,1.0
15023,46148,5097,2723,2374,0.534,0.466
15024,46149,1890,0,1890,0.0,1.0
15025,46150,764,0,764,0.0,1.0
15026,46151,30921,13982,16939,0.452,0.548
15027,46155,103,0,103,0.0,1.0
15028,46156,1470,0,1470,0.0,1.0
15029,46157,3639,0,3639,0.0,1.0
15030,46158,23053,15482,7571,0.672,0.328
15031,46160,6421,0,6421,0.0,1.0
15032,46161,2655,0,2655,0.0,1.0
15033,46162,458,0,458,0.0,1.0
15034,46163,11963,9498,2465,0.794,0.206
15035,46164,3957,0,3957,0.0,1.0
15036,46165,1498,0,1498,0.0,1.0
15037,46166,2306,0,2306,0.0,1.0
15038,46167,6336,4049,2287,0.639,0.361
15039,46168,30309,28900,1409,0.954,0.046
15040,46171,1695,0,1695,0.0,1.0
15041,46172,2427,0,2427,0.0,1.0
15042,46173,11190,6738,4452,0.602,0.398
15043,46175,597,0,597,0.0,1.0
15044,46176,27816,20457,7359,0.735,0.265
15045,46180,1028,0,1028,0.0,1.0
15046,46181,4832,0,4832,0.0,1.0
15047,46182,1927,0,1927,0.0,1.0
15048,46183,82,82,0,1.0,0.0
15049,46184,11806,10424,1382,0.883,0.117
15050,46186,1753,0,1753,0.0,1.0
15051,46201,30962,30962,0,1.0,0.0
15052,46202,16335,16335,0,1.0,0.0
15053,46203,38950,38950,0,1.0,0.0
15054,46204,5125,5125,0,1.0,0.0
15055,46205,25356,25356,0,1.0,0.0
15056,46208,22239,22239,0,1.0,0.0
15057,46214,24306,24306,0,1.0,0.0
15058,46216,1697,1697,0,1.0,0.0
15059,46217,29358,28844,514,0.982,0.018
15060,46218,29028,29028,0,1.0,0.0
15061,46219,33930,33930,0,1.0,0.0
15062,46220,34830,34830,0,1.0,0.0
15063,46221,26393,25857,536,0.98,0.02
15064,46222,34044,34044,0,1.0,0.0
15065,46224,35094,35094,0,1.0,0.0
15066,46225,7319,7319,0,1.0,0.0
15067,46226,43904,43904,0,1.0,0.0
15068,46227,57086,57086,0,1.0,0.0
15069,46228,14755,14755,0,1.0,0.0
15070,46229,27262,27262,0,1.0,0.0
15071,46231,10440,10430,10,0.999,0.001
15072,46234,24810,24727,83,0.997,0.003
15073,46235,30825,30825,0,1.0,0.0
15074,46236,27294,27294,0,1.0,0.0
15075,46237,39624,39624,0,1.0,0.0
15076,46239,25345,23532,1813,0.928,0.072
15077,46240,18731,18731,0,1.0,0.0
15078,46241,30670,30651,19,0.999,0.001
15079,46250,18546,18546,0,1.0,0.0
15080,46254,38095,38095,0,1.0,0.0
15081,46256,23647,23647,0,1.0,0.0
15082,46259,11617,9286,2331,0.799,0.201
15083,46260,32406,32406,0,1.0,0.0
15084,46268,24965,24965,0,1.0,0.0
15085,46278,8197,7686,511,0.938,0.062
15086,46280,6793,6793,0,1.0,0.0
15087,46290,170,170,0,1.0,0.0
15088,46301,669,0,669,0.0,1.0
15089,46303,14170,11639,2531,0.821,0.179
15090,46304,24207,20550,3657,0.849,0.151
15091,46307,60619,54246,6373,0.895,0.105
15092,46310,13565,4652,8913,0.343,0.657
15093,46311,20816,20499,317,0.985,0.015
15094,46312,29698,29698,0,1.0,0.0
15095,46319,18404,18404,0,1.0,0.0
15096,46320,15508,15508,0,1.0,0.0
15097,46321,23603,23603,0,1.0,0.0
15098,46322,23727,23727,0,1.0,0.0
15099,46323,22743,22743,0,1.0,0.0
15100,46324,23165,23165,0,1.0,0.0
15101,46327,12153,12153,0,1.0,0.0
15102,46340,1068,0,1068,0.0,1.0
15103,46341,10426,3922,6504,0.376,0.624
15104,46342,31244,28960,2284,0.927,0.073
15105,46345,249,0,249,0.0,1.0
15106,46346,1423,0,1423,0.0,1.0
15107,46347,4760,0,4760,0.0,1.0
15108,46348,1045,0,1045,0.0,1.0
15109,46349,3336,0,3336,0.0,1.0
15110,46350,43650,27716,15934,0.635,0.365
15111,46356,17524,11563,5961,0.66,0.34
15112,46360,43625,37716,5909,0.865,0.135
15113,46365,1068,0,1068,0.0,1.0
15114,46366,5791,0,5791,0.0,1.0
15115,46368,38691,38586,105,0.997,0.003
15116,46371,3599,0,3599,0.0,1.0
15117,46373,13859,13769,90,0.994,0.006
15118,46374,1012,0,1012,0.0,1.0
15119,46375,23820,23820,0,1.0,0.0
15120,46376,398,0,398,0.0,1.0
15121,46377,386,0,386,0.0,1.0
15122,46379,202,0,202,0.0,1.0
15123,46381,235,0,235,0.0,1.0
15124,46382,2108,0,2108,0.0,1.0
15125,46383,39687,31609,8078,0.796,0.204
15126,46385,38866,31268,7598,0.805,0.195
15127,46390,2796,0,2796,0.0,1.0
15128,46391,9726,5929,3797,0.61,0.39
15129,46392,7957,0,7957,0.0,1.0
15130,46393,399,197,202,0.494,0.506
15131,46394,12258,12258,0,1.0,0.0
15132,46402,6726,6726,0,1.0,0.0
15133,46403,12601,12601,0,1.0,0.0
15134,46404,17326,17326,0,1.0,0.0
15135,46405,11746,11746,0,1.0,0.0
15136,46406,9900,9900,0,1.0,0.0
15137,46407,12656,12656,0,1.0,0.0
15138,46408,17030,17030,0,1.0,0.0
15139,46409,8932,8932,0,1.0,0.0
15140,46410,38340,37146,1194,0.969,0.031
15141,46501,3856,0,3856,0.0,1.0
15142,46502,115,115,0,1.0,0.0
15143,46504,3413,0,3413,0.0,1.0
15144,46506,10070,4663,5407,0.463,0.537
15145,46507,9128,4847,4281,0.531,0.469
15146,46508,217,0,217,0.0,1.0
15147,46510,3631,0,3631,0.0,1.0
15148,46511,4435,0,4435,0.0,1.0
15149,46514,40263,37798,2465,0.939,0.061
15150,46516,33501,33484,17,0.999,0.001
15151,46517,23764,22259,1505,0.937,0.063
15152,46524,2326,2,2324,0.001,0.999
15153,46526,30671,25418,5253,0.829,0.171
15154,46528,26104,17811,8293,0.682,0.318
15155,46530,30614,30538,76,0.998,0.002
15156,46531,1458,0,1458,0.0,1.0
15157,46532,1905,0,1905,0.0,1.0
15158,46534,11263,3309,7954,0.294,0.706
15159,46536,3445,0,3445,0.0,1.0
15160,46537,433,0,433,0.0,1.0
15161,46538,3867,1261,2606,0.326,0.674
15162,46539,2298,0,2298,0.0,1.0
15163,46540,11702,4064,7638,0.347,0.653
15164,46542,4198,222,3976,0.053,0.947
15165,46543,3654,0,3654,0.0,1.0
15166,46544,30759,29183,1576,0.949,0.051
15167,46545,25082,24522,560,0.978,0.022
15168,46550,12311,6937,5374,0.563,0.437
15169,46552,6834,3662,3172,0.536,0.464
15170,46553,3428,1401,2027,0.409,0.591
15171,46554,4942,0,4942,0.0,1.0
15172,46555,2835,2004,831,0.707,0.293
15173,46556,7314,7314,0,1.0,0.0
15174,46561,13343,12439,904,0.932,0.068
15175,46562,4788,567,4221,0.118,0.882
15176,46563,23599,12498,11101,0.53,0.47
15177,46565,7950,0,7950,0.0,1.0
15178,46567,9405,5558,3847,0.591,0.409
15179,46570,1060,0,1060,0.0,1.0
15180,46571,5532,0,5532,0.0,1.0
15181,46573,3565,0,3565,0.0,1.0
15182,46574,8339,3035,5304,0.364,0.636
15183,46580,21338,15413,5925,0.722,0.278
15184,46582,12378,9571,2807,0.773,0.227
15185,46590,4908,4895,13,0.997,0.003
15186,46595,163,0,163,0.0,1.0
15187,46601,6090,6090,0,1.0,0.0
15188,46613,10893,10893,0,1.0,0.0
15189,46614,29573,25282,4291,0.855,0.145
15190,46615,14609,14609,0,1.0,0.0
15191,46616,5667,5667,0,1.0,0.0
15192,46617,9601,9601,0,1.0,0.0
15193,46619,21408,20479,929,0.957,0.043
15194,46628,25650,22959,2691,0.895,0.105
15195,46635,6654,6654,0,1.0,0.0
15196,46637,15314,15314,0,1.0,0.0
15197,46701,7979,0,7979,0.0,1.0
15198,46702,2304,0,2304,0.0,1.0
15199,46703,18029,10635,7394,0.59,0.41
15200,46704,60,0,60,0.0,1.0
15201,46705,1583,0,1583,0.0,1.0
15202,46706,18630,12849,5781,0.69,0.31
15203,46710,4679,0,4679,0.0,1.0
15204,46711,7698,4063,3635,0.528,0.472
15205,46714,14645,9952,4693,0.68,0.32
15206,46721,5058,2651,2407,0.524,0.476
15207,46723,7692,0,7692,0.0,1.0
15208,46725,23080,9311,13769,0.403,0.597
15209,46730,1381,0,1381,0.0,1.0
15210,46731,559,0,559,0.0,1.0
15211,46732,3169,1128,2041,0.356,0.644
15212,46733,18777,10440,8337,0.556,0.444
15213,46737,7068,437,6631,0.062,0.938
15214,46738,7918,6618,1300,0.836,0.164
15215,46740,4060,1427,2633,0.351,0.649
15216,46741,4647,1242,3405,0.267,0.733
15217,46742,3488,0,3488,0.0,1.0
15218,46743,1971,0,1971,0.0,1.0
15219,46745,1841,0,1841,0.0,1.0
15220,46746,4036,0,4036,0.0,1.0
15221,46747,2693,0,2693,0.0,1.0
15222,46748,5134,3410,1724,0.664,0.336
15223,46750,27221,18207,9014,0.669,0.331
15224,46755,15062,10399,4663,0.69,0.31
15225,46759,652,0,652,0.0,1.0
15226,46760,1382,0,1382,0.0,1.0
15227,46761,12039,3113,8926,0.259,0.741
15228,46763,1631,0,1631,0.0,1.0
15229,46764,1497,0,1497,0.0,1.0
15230,46765,5341,3526,1815,0.66,0.34
15231,46766,685,0,685,0.0,1.0
15232,46767,8564,4789,3775,0.559,0.441
15233,46770,2716,0,2716,0.0,1.0
15234,46771,105,0,105,0.0,1.0
15235,46772,3411,0,3411,0.0,1.0
15236,46773,3662,0,3662,0.0,1.0
15237,46774,16008,12821,3187,0.801,0.199
15238,46776,1484,20,1464,0.013,0.987
15239,46777,6259,3711,2548,0.593,0.407
15240,46779,2166,104,2062,0.048,0.952
15241,46781,793,0,793,0.0,1.0
15242,46783,6396,316,6080,0.049,0.951
15243,46784,2236,0,2236,0.0,1.0
15244,46785,1542,0,1542,0.0,1.0
15245,46786,102,0,102,0.0,1.0
15246,46787,3893,0,3893,0.0,1.0
15247,46788,3260,0,3260,0.0,1.0
15248,46791,918,0,918,0.0,1.0
15249,46792,3499,0,3499,0.0,1.0
15250,46793,4292,2245,2047,0.523,0.477
15251,46794,1587,0,1587,0.0,1.0
15252,46795,5608,0,5608,0.0,1.0
15253,46797,3957,0,3957,0.0,1.0
15254,46798,1661,442,1219,0.266,0.734
15255,46799,212,0,212,0.0,1.0
15256,46802,11086,11086,0,1.0,0.0
15257,46803,9758,9758,0,1.0,0.0
15258,46804,27245,26975,270,0.99,0.01
15259,46805,21306,21306,0,1.0,0.0
15260,46806,23560,23560,0,1.0,0.0
15261,46807,16072,16072,0,1.0,0.0
15262,46808,19309,19288,21,0.999,0.001
15263,46809,8947,8113,834,0.907,0.093
15264,46814,12281,11210,1071,0.913,0.087
15265,46815,26522,26491,31,0.999,0.001
15266,46816,18116,15011,3105,0.829,0.171
15267,46818,18790,14818,3972,0.789,0.211
15268,46819,8765,6975,1790,0.796,0.204
15269,46825,27931,27931,0,1.0,0.0
15270,46835,33604,32574,1030,0.969,0.031
15271,46845,22117,20481,1636,0.926,0.074
15272,46901,37633,29178,8455,0.775,0.225
15273,46902,35697,32116,3581,0.9,0.1
15274,46910,3360,0,3360,0.0,1.0
15275,46911,1439,0,1439,0.0,1.0
15276,46913,1329,0,1329,0.0,1.0
15277,46914,4908,4032,876,0.822,0.178
15278,46915,679,0,679,0.0,1.0
15279,46917,1853,0,1853,0.0,1.0
15280,46919,2390,0,2390,0.0,1.0
15281,46920,1045,0,1045,0.0,1.0
15282,46922,61,0,61,0.0,1.0
15283,46923,8048,3008,5040,0.374,0.626
15284,46926,1708,0,1708,0.0,1.0
15285,46928,4951,2942,2009,0.594,0.406
15286,46929,3214,0,3214,0.0,1.0
15287,46930,133,0,133,0.0,1.0
15288,46931,188,0,188,0.0,1.0
15289,46932,3448,0,3448,0.0,1.0
15290,46933,6414,6009,405,0.937,0.063
15291,46936,5922,3219,2703,0.544,0.456
15292,46938,3200,1871,1329,0.585,0.415
15293,46939,2101,0,2101,0.0,1.0
15294,46940,2548,0,2548,0.0,1.0
15295,46941,1125,0,1125,0.0,1.0
15296,46943,247,0,247,0.0,1.0
15297,46946,136,0,136,0.0,1.0
15298,46947,28866,21561,7305,0.747,0.253
15299,46950,643,0,643,0.0,1.0
15300,46951,2170,0,2170,0.0,1.0
15301,46952,20308,15283,5025,0.753,0.247
15302,46953,24177,19580,4597,0.81,0.19
15303,46957,558,0,558,0.0,1.0
15304,46958,460,0,460,0.0,1.0
15305,46959,231,0,231,0.0,1.0
15306,46960,1218,0,1218,0.0,1.0
15307,46961,99,0,99,0.0,1.0
15308,46962,9728,6031,3697,0.62,0.38
15309,46967,98,0,98,0.0,1.0
15310,46968,73,0,73,0.0,1.0
15311,46970,23766,15422,8344,0.649,0.351
15312,46974,1699,0,1699,0.0,1.0
15313,46975,14691,7309,7382,0.498,0.502
15314,46978,2059,0,2059,0.0,1.0
15315,46979,4733,712,4021,0.15,0.85
15316,46982,2573,0,2573,0.0,1.0
15317,46984,224,0,224,0.0,1.0
15318,46985,1441,0,1441,0.0,1.0
15319,46986,1915,0,1915,0.0,1.0
15320,46987,776,776,0,1.0,0.0
15321,46988,823,0,823,0.0,1.0
15322,46989,5195,3343,1852,0.644,0.356
15323,46990,801,0,801,0.0,1.0
15324,46991,1797,0,1797,0.0,1.0
15325,46992,16759,10418,6341,0.622,0.378
15326,46994,2684,0,2684,0.0,1.0
15327,46996,7139,2554,4585,0.358,0.642
15328,46998,112,0,112,0.0,1.0
15329,47001,10422,3832,6590,0.368,0.632
15330,47003,1040,0,1040,0.0,1.0
15331,47006,11727,6984,4743,0.596,0.404
15332,47010,306,0,306,0.0,1.0
15333,47011,1277,0,1277,0.0,1.0
15334,47012,10188,0,10188,0.0,1.0
15335,47016,793,0,793,0.0,1.0
15336,47017,507,0,507,0.0,1.0
15337,47018,4275,0,4275,0.0,1.0
15338,47020,1309,0,1309,0.0,1.0
15339,47022,3358,0,3358,0.0,1.0
15340,47023,1636,0,1636,0.0,1.0
15341,47024,3226,0,3226,0.0,1.0
15342,47025,22932,18699,4233,0.815,0.185
15343,47030,1636,0,1636,0.0,1.0
15344,47031,5368,0,5368,0.0,1.0
15345,47032,3289,0,3289,0.0,1.0
15346,47034,158,0,158,0.0,1.0
15347,47035,233,0,233,0.0,1.0
15348,47036,1023,417,606,0.408,0.592
15349,47037,4333,0,4333,0.0,1.0
15350,47038,1504,0,1504,0.0,1.0
15351,47040,5480,0,5480,0.0,1.0
15352,47041,6125,0,6125,0.0,1.0
15353,47042,4504,0,4504,0.0,1.0
15354,47043,5250,0,5250,0.0,1.0
15355,47060,6448,962,5486,0.149,0.851
15356,47102,7255,4261,2994,0.587,0.413
15357,47104,41,0,41,0.0,1.0
15358,47106,4718,0,4718,0.0,1.0
15359,47108,2463,0,2463,0.0,1.0
15360,47110,350,0,350,0.0,1.0
15361,47111,14533,9471,5062,0.652,0.348
15362,47112,16722,5073,11649,0.303,0.697
15363,47114,399,0,399,0.0,1.0
15364,47115,2622,0,2622,0.0,1.0
15365,47116,805,0,805,0.0,1.0
15366,47117,4429,0,4429,0.0,1.0
15367,47118,3502,0,3502,0.0,1.0
15368,47119,10911,5792,5119,0.531,0.469
15369,47120,938,0,938,0.0,1.0
15370,47122,9979,4623,5356,0.463,0.537
15371,47123,189,0,189,0.0,1.0
15372,47124,4264,586,3678,0.137,0.863
15373,47125,1658,0,1658,0.0,1.0
15374,47126,4250,0,4250,0.0,1.0
15375,47129,19527,19527,0,1.0,0.0
15376,47130,44722,44549,173,0.996,0.004
15377,47135,1372,0,1372,0.0,1.0
15378,47136,4178,763,3415,0.183,0.817
15379,47137,1421,0,1421,0.0,1.0
15380,47138,4373,0,4373,0.0,1.0
15381,47140,2669,0,2669,0.0,1.0
15382,47141,1668,0,1668,0.0,1.0
15383,47142,1174,0,1174,0.0,1.0
15384,47143,3015,650,2365,0.216,0.784
15385,47145,1998,0,1998,0.0,1.0
15386,47147,945,0,945,0.0,1.0
15387,47150,47472,46162,1310,0.972,0.028
15388,47160,93,0,93,0.0,1.0
15389,47161,3735,433,3302,0.116,0.884
15390,47162,829,0,829,0.0,1.0
15391,47163,1746,0,1746,0.0,1.0
15392,47164,3779,0,3779,0.0,1.0
15393,47165,6438,0,6438,0.0,1.0
15394,47166,1302,0,1302,0.0,1.0
15395,47167,15014,6544,8470,0.436,0.564
15396,47170,14795,7173,7622,0.485,0.515
15397,47172,16059,14978,1081,0.933,0.067
15398,47175,909,0,909,0.0,1.0
15399,47177,1221,0,1221,0.0,1.0
15400,47201,41662,27455,14207,0.659,0.341
15401,47203,25806,21070,4736,0.816,0.184
15402,47220,5652,3149,2503,0.557,0.443
15403,47223,1490,0,1490,0.0,1.0
15404,47224,636,0,636,0.0,1.0
15405,47226,202,0,202,0.0,1.0
15406,47227,1598,0,1598,0.0,1.0
15407,47229,3231,0,3231,0.0,1.0
15408,47230,2029,0,2029,0.0,1.0
15409,47231,1167,0,1167,0.0,1.0
15410,47232,2839,0,2839,0.0,1.0
15411,47234,1379,0,1379,0.0,1.0
15412,47235,1784,0,1784,0.0,1.0
15413,47240,20832,11666,9166,0.56,0.44
15414,47243,5951,3768,2183,0.633,0.367
15415,47244,786,0,786,0.0,1.0
15416,47246,4342,0,4342,0.0,1.0
15417,47247,156,0,156,0.0,1.0
15418,47250,21944,14036,7908,0.64,0.36
15419,47260,1911,0,1911,0.0,1.0
15420,47263,236,227,9,0.962,0.038
15421,47264,1428,0,1428,0.0,1.0
15422,47265,20911,11077,9834,0.53,0.47
15423,47270,807,0,807,0.0,1.0
15424,47272,2041,0,2041,0.0,1.0
15425,47273,1849,0,1849,0.0,1.0
15426,47274,28770,20695,8075,0.719,0.281
15427,47280,813,651,162,0.801,0.199
15428,47281,1324,0,1324,0.0,1.0
15429,47282,289,277,12,0.958,0.042
15430,47283,3386,0,3386,0.0,1.0
15431,47302,27592,22860,4732,0.829,0.171
15432,47303,25365,21390,3975,0.843,0.157
15433,47304,30516,28284,2232,0.927,0.073
15434,47305,4106,4106,0,1.0,0.0
15435,47306,6189,6189,0,1.0,0.0
15436,47320,4134,0,4134,0.0,1.0
15437,47324,138,0,138,0.0,1.0
15438,47325,667,0,667,0.0,1.0
15439,47326,2295,0,2295,0.0,1.0
15440,47327,4597,2577,2020,0.561,0.439
15441,47330,5755,2457,3298,0.427,0.573
15442,47331,23429,15347,8082,0.655,0.345
15443,47334,3263,1615,1648,0.495,0.505
15444,47335,761,747,14,0.982,0.018
15445,47336,3807,2284,1523,0.6,0.4
15446,47337,203,190,13,0.936,0.064
15447,47338,2827,0,2827,0.0,1.0
15448,47339,669,0,669,0.0,1.0
15449,47340,2914,0,2914,0.0,1.0
15450,47341,2283,0,2283,0.0,1.0
15451,47342,2693,0,2693,0.0,1.0
15452,47344,140,0,140,0.0,1.0
15453,47345,1448,0,1448,0.0,1.0
15454,47346,4082,0,4082,0.0,1.0
15455,47348,9828,6160,3668,0.627,0.373
15456,47351,471,0,471,0.0,1.0
15457,47352,965,8,957,0.008,0.992
15458,47353,5879,0,5879,0.0,1.0
15459,47354,1129,0,1129,0.0,1.0
15460,47355,2885,0,2885,0.0,1.0
15461,47356,5781,2543,3238,0.44,0.56
15462,47357,1215,481,734,0.396,0.604
15463,47358,996,0,996,0.0,1.0
15464,47359,3143,0,3143,0.0,1.0
15465,47360,1546,0,1546,0.0,1.0
15466,47361,135,0,135,0.0,1.0
15467,47362,30243,22816,7427,0.754,0.246
15468,47367,191,0,191,0.0,1.0
15469,47368,2845,1440,1405,0.506,0.494
15470,47369,1343,0,1343,0.0,1.0
15471,47371,12226,6006,6220,0.491,0.509
15472,47373,2226,1280,946,0.575,0.425
15473,47374,46875,39878,6997,0.851,0.149
15474,47380,2004,0,2004,0.0,1.0
15475,47381,145,0,145,0.0,1.0
15476,47382,200,0,200,0.0,1.0
15477,47383,2960,995,1965,0.336,0.664
15478,47384,2000,0,2000,0.0,1.0
15479,47385,1612,2,1610,0.001,0.999
15480,47386,1231,0,1231,0.0,1.0
15481,47387,726,0,726,0.0,1.0
15482,47388,384,0,384,0.0,1.0
15483,47390,5310,3619,1691,0.682,0.318
15484,47393,1704,0,1704,0.0,1.0
15485,47394,8470,4978,3492,0.588,0.412
15486,47396,7030,5316,1714,0.756,0.244
15487,47401,41011,33735,7276,0.823,0.177
15488,47403,30955,23811,7144,0.769,0.231
15489,47404,21026,17666,3360,0.84,0.16
15490,47405,4427,4427,0,1.0,0.0
15491,47406,4730,4730,0,1.0,0.0
15492,47408,24776,18679,6097,0.754,0.246
15493,47420,135,116,19,0.859,0.141
15494,47421,27831,13533,14298,0.486,0.514
15495,47424,9525,2521,7004,0.265,0.735
15496,47427,1093,0,1093,0.0,1.0
15497,47429,7986,5609,2377,0.702,0.298
15498,47431,1366,0,1366,0.0,1.0
15499,47432,4537,0,4537,0.0,1.0
15500,47433,4025,0,4025,0.0,1.0
15501,47434,76,0,76,0.0,1.0
15502,47436,1663,0,1663,0.0,1.0
15503,47437,123,0,123,0.0,1.0
15504,47438,4798,0,4798,0.0,1.0
15505,47441,9269,5822,3447,0.628,0.372
15506,47443,1233,0,1233,0.0,1.0
15507,47446,9990,4302,5688,0.431,0.569
15508,47448,7505,0,7505,0.0,1.0
15509,47449,413,0,413,0.0,1.0
15510,47451,1228,1190,38,0.969,0.031
15511,47452,5359,0,5359,0.0,1.0
15512,47453,498,0,498,0.0,1.0
15513,47454,7688,3282,4406,0.427,0.573
15514,47455,124,0,124,0.0,1.0
15515,47456,1200,0,1200,0.0,1.0
15516,47457,134,0,134,0.0,1.0
15517,47458,36,0,36,0.0,1.0
15518,47459,3795,0,3795,0.0,1.0
15519,47460,11471,0,11471,0.0,1.0
15520,47462,4871,29,4842,0.006,0.994
15521,47464,198,0,198,0.0,1.0
15522,47465,750,0,750,0.0,1.0
15523,47467,72,0,72,0.0,1.0
15524,47468,1250,0,1250,0.0,1.0
15525,47469,1749,0,1749,0.0,1.0
15526,47470,1735,0,1735,0.0,1.0
15527,47471,2727,0,2727,0.0,1.0
15528,47501,17535,12462,5073,0.711,0.289
15529,47512,3981,2939,1042,0.738,0.262
15530,47513,1841,0,1841,0.0,1.0
15531,47514,1559,0,1559,0.0,1.0
15532,47515,965,0,965,0.0,1.0
15533,47516,1249,0,1249,0.0,1.0
15534,47519,513,0,513,0.0,1.0
15535,47520,3267,1523,1744,0.466,0.534
15536,47521,927,0,927,0.0,1.0
15537,47522,246,0,246,0.0,1.0
15538,47523,3435,0,3435,0.0,1.0
15539,47524,605,0,605,0.0,1.0
15540,47525,382,0,382,0.0,1.0
15541,47527,1897,0,1897,0.0,1.0
15542,47528,476,278,198,0.584,0.416
15543,47529,1042,0,1042,0.0,1.0
15544,47531,1004,0,1004,0.0,1.0
15545,47532,4627,0,4627,0.0,1.0
15546,47535,566,0,566,0.0,1.0
15547,47536,40,0,40,0.0,1.0
15548,47537,826,0,826,0.0,1.0
15549,47541,1224,0,1224,0.0,1.0
15550,47542,9622,5501,4121,0.572,0.428
15551,47546,21009,15759,5250,0.75,0.25
15552,47550,854,0,854,0.0,1.0
15553,47551,649,0,649,0.0,1.0
15554,47552,182,0,182,0.0,1.0
15555,47553,8495,2972,5523,0.35,0.65
15556,47557,1432,0,1432,0.0,1.0
15557,47558,4406,0,4406,0.0,1.0
15558,47561,1588,0,1588,0.0,1.0
15559,47562,4658,0,4658,0.0,1.0
15560,47564,1352,0,1352,0.0,1.0
15561,47567,6021,0,6021,0.0,1.0
15562,47568,834,0,834,0.0,1.0
15563,47574,148,0,148,0.0,1.0
15564,47575,976,0,976,0.0,1.0
15565,47576,388,0,388,0.0,1.0
15566,47577,1143,0,1143,0.0,1.0
15567,47578,776,0,776,0.0,1.0
15568,47579,2659,0,2659,0.0,1.0
15569,47580,289,0,289,0.0,1.0
15570,47581,3883,0,3883,0.0,1.0
15571,47584,179,0,179,0.0,1.0
15572,47585,592,0,592,0.0,1.0
15573,47586,10932,7171,3761,0.656,0.344
15574,47588,698,0,698,0.0,1.0
15575,47590,713,0,713,0.0,1.0
15576,47591,26770,21302,5468,0.796,0.204
15577,47596,202,0,202,0.0,1.0
15578,47597,1023,0,1023,0.0,1.0
15579,47598,3418,0,3418,0.0,1.0
15580,47601,13896,6322,7574,0.455,0.545
15581,47610,5195,3917,1278,0.754,0.246
15582,47611,1257,0,1257,0.0,1.0
15583,47612,861,0,861,0.0,1.0
15584,47613,2679,0,2679,0.0,1.0
15585,47615,1611,0,1611,0.0,1.0
15586,47616,364,0,364,0.0,1.0
15587,47619,1696,0,1696,0.0,1.0
15588,47620,13427,7409,6018,0.552,0.448
15589,47630,34423,31957,2466,0.928,0.072
15590,47631,2042,0,2042,0.0,1.0
15591,47633,2542,0,2542,0.0,1.0
15592,47634,2382,0,2382,0.0,1.0
15593,47635,5671,0,5671,0.0,1.0
15594,47637,1507,0,1507,0.0,1.0
15595,47638,3577,0,3577,0.0,1.0
15596,47639,4069,1587,2482,0.39,0.61
15597,47640,1089,0,1089,0.0,1.0
15598,47648,4373,2792,1581,0.638,0.362
15599,47649,1402,0,1402,0.0,1.0
15600,47654,70,0,70,0.0,1.0
15601,47660,4934,2515,2419,0.51,0.49
15602,47665,3637,0,3637,0.0,1.0
15603,47666,1447,0,1447,0.0,1.0
15604,47670,12352,8645,3707,0.7,0.3
15605,47683,210,0,210,0.0,1.0
15606,47708,439,439,0,1.0,0.0
15607,47710,19527,19155,372,0.981,0.019
15608,47711,31457,31240,217,0.993,0.007
15609,47712,26012,22232,3780,0.855,0.145
15610,47713,11032,11032,0,1.0,0.0
15611,47714,34107,34107,0,1.0,0.0
15612,47715,27063,26239,824,0.97,0.03
15613,47720,17413,8978,8435,0.516,0.484
15614,47725,15851,11010,4841,0.695,0.305
15615,47802,34532,24347,10185,0.705,0.295
15616,47803,21102,19284,1818,0.914,0.086
15617,47804,11020,11020,0,1.0,0.0
15618,47805,12852,8856,3996,0.689,0.311
15619,47807,13045,13045,0,1.0,0.0
15620,47809,2687,2687,0,1.0,0.0
15621,47832,1040,0,1040,0.0,1.0
15622,47833,1010,0,1010,0.0,1.0
15623,47834,19215,9864,9351,0.513,0.487
15624,47836,47,0,47,0.0,1.0
15625,47837,1231,0,1231,0.0,1.0
15626,47838,4081,0,4081,0.0,1.0
15627,47840,1500,0,1500,0.0,1.0
15628,47841,2138,0,2138,0.0,1.0
15629,47842,10085,6425,3660,0.637,0.363
15630,47846,638,0,638,0.0,1.0
15631,47847,1077,0,1077,0.0,1.0
15632,47848,1691,0,1691,0.0,1.0
15633,47849,496,0,496,0.0,1.0
15634,47850,2456,0,2456,0.0,1.0
15635,47853,134,134,0,1.0,0.0
15636,47854,849,0,849,0.0,1.0
15637,47855,546,0,546,0.0,1.0
15638,47857,571,519,52,0.909,0.091
15639,47858,698,0,698,0.0,1.0
15640,47859,1066,0,1066,0.0,1.0
15641,47860,321,0,321,0.0,1.0
15642,47861,616,0,616,0.0,1.0
15643,47862,1610,0,1610,0.0,1.0
15644,47863,205,0,205,0.0,1.0
15645,47865,79,0,79,0.0,1.0
15646,47866,347,0,347,0.0,1.0
15647,47868,2937,0,2937,0.0,1.0
15648,47869,137,0,137,0.0,1.0
15649,47871,220,0,220,0.0,1.0
15650,47872,8890,4339,4551,0.488,0.512
15651,47874,3414,0,3414,0.0,1.0
15652,47876,394,0,394,0.0,1.0
15653,47879,3302,0,3302,0.0,1.0
15654,47880,67,0,67,0.0,1.0
15655,47881,465,0,465,0.0,1.0
15656,47882,8430,4518,3912,0.536,0.464
15657,47884,229,0,229,0.0,1.0
15658,47885,9009,2986,6023,0.331,0.669
15659,47901,3518,3518,0,1.0,0.0
15660,47904,16277,16135,142,0.991,0.009
15661,47905,38910,30699,8211,0.789,0.211
15662,47906,66972,60844,6128,0.908,0.092
15663,47907,0,0,0,,
15664,47909,39373,34551,4822,0.878,0.122
15665,47916,64,0,64,0.0,1.0
15666,47917,491,0,491,0.0,1.0
15667,47918,6321,3304,3017,0.523,0.477
15668,47920,2414,678,1736,0.281,0.719
15669,47921,1078,0,1078,0.0,1.0
15670,47922,1623,0,1623,0.0,1.0
15671,47923,3494,0,3494,0.0,1.0
15672,47924,141,0,141,0.0,1.0
15673,47925,203,0,203,0.0,1.0
15674,47926,1097,0,1097,0.0,1.0
15675,47928,2047,0,2047,0.0,1.0
15676,47929,774,0,774,0.0,1.0
15677,47930,1094,0,1094,0.0,1.0
15678,47932,5357,2625,2732,0.49,0.51
15679,47933,27937,18012,9925,0.645,0.355
15680,47940,1433,0,1433,0.0,1.0
15681,47941,1300,1300,0,1.0,0.0
15682,47942,660,0,660,0.0,1.0
15683,47943,932,0,932,0.0,1.0
15684,47944,3623,0,3623,0.0,1.0
15685,47946,2044,0,2044,0.0,1.0
15686,47948,1359,0,1359,0.0,1.0
15687,47949,1332,0,1332,0.0,1.0
15688,47950,912,0,912,0.0,1.0
15689,47951,2252,0,2252,0.0,1.0
15690,47952,2798,0,2798,0.0,1.0
15691,47954,2220,0,2220,0.0,1.0
15692,47955,1088,0,1088,0.0,1.0
15693,47957,1894,0,1894,0.0,1.0
15694,47958,209,0,209,0.0,1.0
15695,47959,2822,73,2749,0.026,0.974
15696,47960,15003,8561,6442,0.571,0.429
15697,47963,1949,0,1949,0.0,1.0
15698,47964,122,0,122,0.0,1.0
15699,47965,646,0,646,0.0,1.0
15700,47966,461,0,461,0.0,1.0
15701,47967,772,0,772,0.0,1.0
15702,47968,982,0,982,0.0,1.0
15703,47969,145,0,145,0.0,1.0
15704,47970,2034,0,2034,0.0,1.0
15705,47971,1865,0,1865,0.0,1.0
15706,47974,1186,0,1186,0.0,1.0
15707,47975,653,0,653,0.0,1.0
15708,47977,2206,0,2206,0.0,1.0
15709,47978,11793,6048,5745,0.513,0.487
15710,47980,1096,0,1096,0.0,1.0
15711,47981,849,0,849,0.0,1.0
15712,47982,143,0,143,0.0,1.0
15713,47983,347,0,347,0.0,1.0
15714,47987,4049,0,4049,0.0,1.0
15715,47989,1281,0,1281,0.0,1.0
15716,47990,1627,0,1627,0.0,1.0
15717,47991,1070,0,1070,0.0,1.0
15718,47992,1465,0,1465,0.0,1.0
15719,47993,3918,1889,2029,0.482,0.518
15720,47994,476,0,476,0.0,1.0
15721,47995,1743,0,1743,0.0,1.0
15722,47997,139,0,139,0.0,1.0
15723,48001,11986,10180,1806,0.849,0.151
15724,48002,3285,0,3285,0.0,1.0
15725,48003,6070,2719,3351,0.448,0.552
15726,48005,5379,0,5379,0.0,1.0
15727,48006,4007,0,4007,0.0,1.0
15728,48009,20107,20107,0,1.0,0.0
15729,48014,4256,0,4256,0.0,1.0
15730,48015,8257,8257,0,1.0,0.0
15731,48017,11805,11805,0,1.0,0.0
15732,48021,32353,32353,0,1.0,0.0
15733,48022,2654,0,2654,0.0,1.0
15734,48023,5178,3515,1663,0.679,0.321
15735,48025,14543,14543,0,1.0,0.0
15736,48026,14480,14480,0,1.0,0.0
15737,48027,3249,0,3249,0.0,1.0
15738,48028,1190,0,1190,0.0,1.0
15739,48030,16422,16422,0,1.0,0.0
15740,48032,2322,0,2322,0.0,1.0
15741,48033,16064,16064,0,1.0,0.0
15742,48034,12590,12590,0,1.0,0.0
15743,48035,34788,34788,0,1.0,0.0
15744,48036,20980,20980,0,1.0,0.0
15745,48038,41057,41057,0,1.0,0.0
15746,48039,7807,4811,2996,0.616,0.384
15747,48040,9956,9956,0,1.0,0.0
15748,48041,4561,0,4561,0.0,1.0
15749,48042,27291,26424,867,0.968,0.032
15750,48043,16305,16305,0,1.0,0.0
15751,48044,52289,52289,0,1.0,0.0
15752,48045,24604,24604,0,1.0,0.0
15753,48047,39415,39296,119,0.997,0.003
15754,48048,7548,5971,1577,0.791,0.209
15755,48049,5582,1864,3718,0.334,0.666
15756,48050,1653,72,1581,0.044,0.956
15757,48051,17319,16771,548,0.968,0.032
15758,48054,7339,3121,4218,0.425,0.575
15759,48059,15123,13063,2060,0.864,0.136
15760,48060,40831,40831,0,1.0,0.0
15761,48062,9373,6064,3309,0.647,0.353
15762,48063,4070,0,4070,0.0,1.0
15763,48064,4107,796,3311,0.194,0.806
15764,48065,10547,7084,3463,0.672,0.328
15765,48066,47388,47388,0,1.0,0.0
15766,48067,24458,24458,0,1.0,0.0
15767,48069,2526,2526,0,1.0,0.0
15768,48070,6238,6238,0,1.0,0.0
15769,48071,29694,29694,0,1.0,0.0
15770,48072,14970,14970,0,1.0,0.0
15771,48073,32798,32798,0,1.0,0.0
15772,48074,9356,4124,5232,0.441,0.559
15773,48075,21790,21790,0,1.0,0.0
15774,48076,25386,25386,0,1.0,0.0
15775,48079,12304,7771,4533,0.632,0.368
15776,48080,22494,22494,0,1.0,0.0
15777,48081,20635,20635,0,1.0,0.0
15778,48082,16549,16549,0,1.0,0.0
15779,48083,22507,22507,0,1.0,0.0
15780,48084,14231,14231,0,1.0,0.0
15781,48085,24660,24660,0,1.0,0.0
15782,48088,22255,22255,0,1.0,0.0
15783,48089,31978,31978,0,1.0,0.0
15784,48091,31106,31106,0,1.0,0.0
15785,48092,25680,25680,0,1.0,0.0
15786,48093,23037,23037,0,1.0,0.0
15787,48094,18028,17219,809,0.955,0.045
15788,48095,4906,3427,1479,0.699,0.301
15789,48096,3739,126,3613,0.034,0.966
15790,48097,5499,0,5499,0.0,1.0
15791,48098,19582,19582,0,1.0,0.0
15792,48101,28200,28200,0,1.0,0.0
15793,48103,53057,49343,3714,0.93,0.07
15794,48104,38315,38315,0,1.0,0.0
15795,48105,33905,29506,4399,0.87,0.13
15796,48108,26164,26078,86,0.997,0.003
15797,48109,6904,6904,0,1.0,0.0
15798,48111,42313,35172,7141,0.831,0.169
15799,48114,19702,17062,2640,0.866,0.134
15800,48116,26432,24796,1636,0.938,0.062
15801,48117,10124,3226,6898,0.319,0.681
15802,48118,12552,5329,7223,0.425,0.575
15803,48120,8274,8274,0,1.0,0.0
15804,48122,10727,10727,0,1.0,0.0
15805,48124,31732,31732,0,1.0,0.0
15806,48125,21273,21273,0,1.0,0.0
15807,48126,47465,47465,0,1.0,0.0
15808,48127,36501,36501,0,1.0,0.0
15809,48128,10682,10682,0,1.0,0.0
15810,48130,14420,6795,7625,0.471,0.529
15811,48131,6764,3799,2965,0.562,0.438
15812,48133,5753,2656,3097,0.462,0.538
15813,48134,21408,21327,81,0.996,0.004
15814,48135,27665,27665,0,1.0,0.0
15815,48137,4796,0,4796,0.0,1.0
15816,48138,10371,10371,0,1.0,0.0
15817,48139,206,206,0,1.0,0.0
15818,48140,3095,0,3095,0.0,1.0
15819,48141,25366,25366,0,1.0,0.0
15820,48143,32,32,0,1.0,0.0
15821,48144,9952,9558,394,0.96,0.04
15822,48145,3503,907,2596,0.259,0.741
15823,48146,38098,38098,0,1.0,0.0
15824,48150,27127,27127,0,1.0,0.0
15825,48152,31173,31173,0,1.0,0.0
15826,48154,38642,38642,0,1.0,0.0
15827,48157,1436,0,1436,0.0,1.0
15828,48158,7309,0,7309,0.0,1.0
15829,48159,2582,0,2582,0.0,1.0
15830,48160,13785,8381,5404,0.608,0.392
15831,48161,26470,22395,4075,0.846,0.154
15832,48162,29344,23095,6249,0.787,0.213
15833,48164,9175,5753,3422,0.627,0.373
15834,48165,6339,5650,689,0.891,0.109
15835,48166,11569,8581,2988,0.742,0.258
15836,48167,21534,20284,1250,0.942,0.058
15837,48168,21781,20532,1249,0.943,0.057
15838,48169,20813,14785,6028,0.71,0.29
15839,48170,39963,38118,1845,0.954,0.046
15840,48173,12700,12059,641,0.95,0.05
15841,48174,31515,30499,1016,0.968,0.032
15842,48176,21447,16391,5056,0.764,0.236
15843,48177,218,80,138,0.367,0.633
15844,48178,29320,23345,5975,0.796,0.204
15845,48179,3274,1658,1616,0.506,0.494
15846,48180,63131,63131,0,1.0,0.0
15847,48182,21708,15532,6176,0.715,0.285
15848,48183,43182,43182,0,1.0,0.0
15849,48184,17643,17643,0,1.0,0.0
15850,48185,47618,47618,0,1.0,0.0
15851,48186,36506,36506,0,1.0,0.0
15852,48187,49148,48875,273,0.994,0.006
15853,48188,41025,40902,123,0.997,0.003
15854,48189,13632,10769,2863,0.79,0.21
15855,48190,107,0,107,0.0,1.0
15856,48191,4054,1132,2922,0.279,0.721
15857,48192,25883,25883,0,1.0,0.0
15858,48193,15623,15623,0,1.0,0.0
15859,48195,30047,30047,0,1.0,0.0
15860,48197,61132,58019,3113,0.949,0.051
15861,48198,38186,36950,1236,0.968,0.032
15862,48201,12814,12814,0,1.0,0.0
15863,48202,16603,16603,0,1.0,0.0
15864,48203,28409,28409,0,1.0,0.0
15865,48204,27997,27997,0,1.0,0.0
15866,48205,44045,44045,0,1.0,0.0
15867,48206,21954,21954,0,1.0,0.0
15868,48207,20252,20241,11,0.999,0.001
15869,48208,10234,10234,0,1.0,0.0
15870,48209,32262,32262,0,1.0,0.0
15871,48210,31017,31017,0,1.0,0.0
15872,48211,7082,7082,0,1.0,0.0
15873,48212,39038,39038,0,1.0,0.0
15874,48213,27712,27712,0,1.0,0.0
15875,48214,22759,22759,0,1.0,0.0
15876,48215,13565,13565,0,1.0,0.0
15877,48216,5645,5645,0,1.0,0.0
15878,48217,8210,8210,0,1.0,0.0
15879,48218,7903,7903,0,1.0,0.0
15880,48219,46931,46931,0,1.0,0.0
15881,48220,22319,22319,0,1.0,0.0
15882,48221,38727,38727,0,1.0,0.0
15883,48223,25336,25336,0,1.0,0.0
15884,48224,44439,44439,0,1.0,0.0
15885,48225,14554,14554,0,1.0,0.0
15886,48226,5302,5302,0,1.0,0.0
15887,48227,45380,45380,0,1.0,0.0
15888,48228,52130,52130,0,1.0,0.0
15889,48229,9556,9556,0,1.0,0.0
15890,48230,16976,16976,0,1.0,0.0
15891,48233,0,0,0,,
15892,48234,36140,36140,0,1.0,0.0
15893,48235,45063,45063,0,1.0,0.0
15894,48236,30607,30607,0,1.0,0.0
15895,48237,29319,29319,0,1.0,0.0
15896,48238,31743,31743,0,1.0,0.0
15897,48239,35524,35524,0,1.0,0.0
15898,48240,17722,17722,0,1.0,0.0
15899,48242,0,0,0,,
15900,48243,0,0,0,,
15901,48301,14127,14127,0,1.0,0.0
15902,48302,15360,15360,0,1.0,0.0
15903,48304,16009,16009,0,1.0,0.0
15904,48306,26691,25991,700,0.974,0.026
15905,48307,41369,41369,0,1.0,0.0
15906,48309,29135,29135,0,1.0,0.0
15907,48310,42766,42766,0,1.0,0.0
15908,48312,32720,32720,0,1.0,0.0
15909,48313,33952,33952,0,1.0,0.0
15910,48314,20245,20245,0,1.0,0.0
15911,48315,26563,26563,0,1.0,0.0
15912,48316,25404,25404,0,1.0,0.0
15913,48317,26610,26610,0,1.0,0.0
15914,48320,4589,4589,0,1.0,0.0
15915,48322,31265,31265,0,1.0,0.0
15916,48323,17708,17708,0,1.0,0.0
15917,48324,17350,17350,0,1.0,0.0
15918,48326,20298,20298,0,1.0,0.0
15919,48327,21559,21559,0,1.0,0.0
15920,48328,24960,24960,0,1.0,0.0
15921,48329,25009,25009,0,1.0,0.0
15922,48331,21503,21503,0,1.0,0.0
15923,48334,18540,18540,0,1.0,0.0
15924,48335,22398,22398,0,1.0,0.0
15925,48336,25486,25486,0,1.0,0.0
15926,48340,24307,24307,0,1.0,0.0
15927,48341,17139,17139,0,1.0,0.0
15928,48342,18407,18407,0,1.0,0.0
15929,48346,22567,21851,716,0.968,0.032
15930,48348,23387,18544,4843,0.793,0.207
15931,48350,7100,2972,4128,0.419,0.581
15932,48353,6481,4597,1884,0.709,0.291
15933,48356,8407,7555,852,0.899,0.101
15934,48357,8170,5815,2355,0.712,0.288
15935,48359,8044,8044,0,1.0,0.0
15936,48360,11651,11200,451,0.961,0.039
15937,48362,15141,15141,0,1.0,0.0
15938,48363,4978,2586,2392,0.519,0.481
15939,48367,4727,0,4727,0.0,1.0
15940,48370,1685,137,1548,0.081,0.919
15941,48371,23155,19868,3287,0.858,0.142
15942,48374,14049,14049,0,1.0,0.0
15943,48375,21801,21801,0,1.0,0.0
15944,48377,15244,15244,0,1.0,0.0
15945,48380,7404,3172,4232,0.428,0.572
15946,48381,12605,9796,2809,0.777,0.223
15947,48382,21945,21638,307,0.986,0.014
15948,48383,12701,10992,1709,0.865,0.135
15949,48386,17434,17101,333,0.981,0.019
15950,48390,22898,22763,135,0.994,0.006
15951,48393,16111,16000,111,0.993,0.007
15952,48397,0,0,0,,
15953,48401,1439,0,1439,0.0,1.0
15954,48411,156,0,156,0.0,1.0
15955,48412,5682,0,5682,0.0,1.0
15956,48413,7551,3490,4061,0.462,0.538
15957,48414,2492,0,2492,0.0,1.0
15958,48415,9471,0,9471,0.0,1.0
15959,48416,5002,0,5002,0.0,1.0
15960,48417,2983,0,2983,0.0,1.0
15961,48418,4312,0,4312,0.0,1.0
15962,48419,2740,0,2740,0.0,1.0
15963,48420,22078,11012,11066,0.499,0.501
15964,48421,6647,0,6647,0.0,1.0
15965,48422,6400,0,6400,0.0,1.0
15966,48423,32708,23061,9647,0.705,0.295
15967,48426,1022,0,1022,0.0,1.0
15968,48427,2879,0,2879,0.0,1.0
15969,48428,5027,0,5027,0.0,1.0
15970,48429,8944,4279,4665,0.478,0.522
15971,48430,36738,24484,12254,0.666,0.334
15972,48432,636,0,636,0.0,1.0
15973,48433,26497,21036,5461,0.794,0.206
15974,48434,104,0,104,0.0,1.0
15975,48435,2083,0,2083,0.0,1.0
15976,48436,3764,0,3764,0.0,1.0
15977,48437,581,474,107,0.816,0.184
15978,48438,6951,2840,4111,0.409,0.591
15979,48439,49209,45633,3576,0.927,0.073
15980,48440,157,0,157,0.0,1.0
15981,48441,4085,0,4085,0.0,1.0
15982,48442,20669,10434,10235,0.505,0.495
15983,48444,9327,3792,5535,0.407,0.593
15984,48445,1370,0,1370,0.0,1.0
15985,48446,30749,13424,17325,0.437,0.563
15986,48449,3147,0,3147,0.0,1.0
15987,48450,4780,1451,3329,0.304,0.696
15988,48451,14767,11468,3299,0.777,0.223
15989,48453,5146,0,5146,0.0,1.0
15990,48454,1324,0,1324,0.0,1.0
15991,48455,7974,0,7974,0.0,1.0
15992,48456,858,0,858,0.0,1.0
15993,48457,8436,0,8436,0.0,1.0
15994,48458,20538,15800,4738,0.769,0.231
15995,48460,2330,0,2330,0.0,1.0
15996,48461,8428,0,8428,0.0,1.0
15997,48462,13266,3073,10193,0.232,0.768
15998,48463,4627,0,4627,0.0,1.0
15999,48464,2231,0,2231,0.0,1.0
16000,48465,629,0,629,0.0,1.0
16001,48466,1578,0,1578,0.0,1.0
16002,48467,2337,0,2337,0.0,1.0
16003,48468,1294,0,1294,0.0,1.0
16004,48469,1245,0,1245,0.0,1.0
16005,48470,784,0,784,0.0,1.0
16006,48471,5745,2775,2970,0.483,0.517
16007,48472,1912,0,1912,0.0,1.0
16008,48473,22507,14124,8383,0.628,0.372
16009,48475,2766,0,2766,0.0,1.0
16010,48476,577,575,2,0.997,0.003
16011,48502,1164,1164,0,1.0,0.0
16012,48503,25168,25168,0,1.0,0.0
16013,48504,30926,29749,1177,0.962,0.038
16014,48505,25710,25641,69,0.997,0.003
16015,48506,30019,29668,351,0.988,0.012
16016,48507,30607,30563,44,0.999,0.001
16017,48509,9470,9470,0,1.0,0.0
16018,48519,7465,7465,0,1.0,0.0
16019,48529,10271,10271,0,1.0,0.0
16020,48532,19375,18297,1078,0.944,0.056
16021,48551,0,0,0,,
16022,48553,0,0,0,,
16023,48554,0,0,0,,
16024,48601,38406,32889,5517,0.856,0.144
16025,48602,30119,30119,0,1.0,0.0
16026,48603,26913,25783,1130,0.958,0.042
16027,48604,13074,11836,1238,0.905,0.095
16028,48607,1774,1774,0,1.0,0.0
16029,48609,12461,8447,4014,0.678,0.322
16030,48610,3083,0,3083,0.0,1.0
16031,48611,6554,3265,3289,0.498,0.502
16032,48612,9259,0,9259,0.0,1.0
16033,48613,1158,0,1158,0.0,1.0
16034,48614,1376,0,1376,0.0,1.0
16035,48615,3058,0,3058,0.0,1.0
16036,48616,7513,0,7513,0.0,1.0
16037,48617,8857,3415,5442,0.386,0.614
16038,48618,5393,0,5393,0.0,1.0
16039,48619,465,0,465,0.0,1.0
16040,48621,1359,0,1359,0.0,1.0
16041,48622,6491,2182,4309,0.336,0.664
16042,48623,13993,7877,6116,0.563,0.437
16043,48624,15810,2934,12876,0.186,0.814
16044,48625,13152,3589,9563,0.273,0.727
16045,48626,6078,0,6078,0.0,1.0
16046,48627,141,0,141,0.0,1.0
16047,48628,1938,0,1938,0.0,1.0
16048,48629,7854,5225,2629,0.665,0.335
16049,48630,69,69,0,1.0,0.0
16050,48631,4643,273,4370,0.059,0.941
16051,48632,5125,0,5125,0.0,1.0
16052,48633,210,0,210,0.0,1.0
16053,48634,4371,0,4371,0.0,1.0
16054,48635,1573,0,1573,0.0,1.0
16055,48636,864,0,864,0.0,1.0
16056,48637,3359,0,3359,0.0,1.0
16057,48638,12922,12922,0,1.0,0.0
16058,48640,32690,21347,11343,0.653,0.347
16059,48642,32277,23816,8461,0.738,0.262
16060,48647,4420,0,4420,0.0,1.0
16061,48649,1576,0,1576,0.0,1.0
16062,48650,7253,0,7253,0.0,1.0
16063,48651,4690,3006,1684,0.641,0.359
16064,48652,1548,0,1548,0.0,1.0
16065,48653,10293,0,10293,0.0,1.0
16066,48654,2521,0,2521,0.0,1.0
16067,48655,6460,0,6460,0.0,1.0
16068,48656,4058,0,4058,0.0,1.0
16069,48657,7981,3472,4509,0.435,0.565
16070,48658,5138,0,5138,0.0,1.0
16071,48659,2850,0,2850,0.0,1.0
16072,48661,10691,0,10691,0.0,1.0
16073,48662,1594,0,1594,0.0,1.0
16074,48667,0,0,0,,
16075,48701,1368,0,1368,0.0,1.0
16076,48703,3238,0,3238,0.0,1.0
16077,48705,535,0,535,0.0,1.0
16078,48706,40596,35082,5514,0.864,0.136
16079,48708,27262,25860,1402,0.949,0.051
16080,48710,0,0,0,,
16081,48720,1042,0,1042,0.0,1.0
16082,48721,411,0,411,0.0,1.0
16083,48722,3123,1140,1983,0.365,0.635
16084,48723,12479,5113,7366,0.41,0.59
16085,48724,359,349,10,0.972,0.028
16086,48725,2464,0,2464,0.0,1.0
16087,48726,6172,0,6172,0.0,1.0
16088,48727,1269,0,1269,0.0,1.0
16089,48728,290,0,290,0.0,1.0
16090,48729,1586,0,1586,0.0,1.0
16091,48730,4716,2397,2319,0.508,0.492
16092,48731,1683,0,1683,0.0,1.0
16093,48732,11483,9613,1870,0.837,0.163
16094,48733,1758,0,1758,0.0,1.0
16095,48734,7444,4972,2472,0.668,0.332
16096,48735,1051,0,1051,0.0,1.0
16097,48737,1245,0,1245,0.0,1.0
16098,48738,1269,231,1038,0.182,0.818
16099,48739,4043,0,4043,0.0,1.0
16100,48740,2556,0,2556,0.0,1.0
16101,48741,2086,0,2086,0.0,1.0
16102,48742,1647,0,1647,0.0,1.0
16103,48743,63,0,63,0.0,1.0
16104,48744,4615,0,4615,0.0,1.0
16105,48745,1346,0,1346,0.0,1.0
16106,48746,8528,358,8170,0.042,0.958
16107,48747,1494,0,1494,0.0,1.0
16108,48748,1693,0,1693,0.0,1.0
16109,48749,1094,0,1094,0.0,1.0
16110,48750,8846,6153,2693,0.696,0.304
16111,48754,1001,0,1001,0.0,1.0
16112,48755,3110,0,3110,0.0,1.0
16113,48756,4640,0,4640,0.0,1.0
16114,48757,3817,0,3817,0.0,1.0
16115,48759,3293,0,3293,0.0,1.0
16116,48760,1351,0,1351,0.0,1.0
16117,48761,1026,0,1026,0.0,1.0
16118,48762,1139,0,1139,0.0,1.0
16119,48763,5012,1975,3037,0.394,0.606
16120,48765,725,0,725,0.0,1.0
16121,48766,1270,0,1270,0.0,1.0
16122,48767,2162,0,2162,0.0,1.0
16123,48768,9832,3356,6476,0.341,0.659
16124,48770,1891,0,1891,0.0,1.0
16125,48801,12923,9345,3578,0.723,0.277
16126,48806,1676,0,1676,0.0,1.0
16127,48807,916,0,916,0.0,1.0
16128,48808,5178,2682,2496,0.518,0.482
16129,48809,11015,5789,5226,0.526,0.474
16130,48811,5641,0,5641,0.0,1.0
16131,48813,21182,9993,11189,0.472,0.528
16132,48815,2259,0,2259,0.0,1.0
16133,48816,121,0,121,0.0,1.0
16134,48817,6422,3483,2939,0.542,0.458
16135,48818,2407,0,2407,0.0,1.0
16136,48819,2701,0,2701,0.0,1.0
16137,48820,16641,11493,5148,0.691,0.309
16138,48821,5836,4111,1725,0.704,0.296
16139,48822,2714,0,2714,0.0,1.0
16140,48823,51302,51202,100,0.998,0.002
16141,48825,12596,12596,0,1.0,0.0
16142,48827,15971,5408,10563,0.339,0.661
16143,48829,3254,0,3254,0.0,1.0
16144,48831,3512,0,3512,0.0,1.0
16145,48832,1393,0,1393,0.0,1.0
16146,48834,2090,0,2090,0.0,1.0
16147,48835,2680,0,2680,0.0,1.0
16148,48836,13510,3794,9716,0.281,0.719
16149,48837,18926,12545,6381,0.663,0.337
16150,48838,17863,9743,8120,0.545,0.455
16151,48840,12501,10908,1593,0.873,0.127
16152,48841,826,0,826,0.0,1.0
16153,48842,20432,19709,723,0.965,0.035
16154,48843,42931,28940,13991,0.674,0.326
16155,48845,1003,0,1003,0.0,1.0
16156,48846,20269,14409,5860,0.711,0.289
16157,48847,6041,0,6041,0.0,1.0
16158,48848,7789,0,7789,0.0,1.0
16159,48849,5717,0,5717,0.0,1.0
16160,48850,4474,0,4474,0.0,1.0
16161,48851,2365,0,2365,0.0,1.0
16162,48852,150,0,150,0.0,1.0
16163,48853,671,0,671,0.0,1.0
16164,48854,18598,9290,9308,0.5,0.5
16165,48855,14752,3886,10866,0.263,0.737
16166,48856,966,0,966,0.0,1.0
16167,48857,2453,844,1609,0.344,0.656
16168,48858,50025,37420,12605,0.748,0.252
16169,48860,1334,0,1334,0.0,1.0
16170,48861,1522,0,1522,0.0,1.0
16171,48864,20148,18997,1151,0.943,0.057
16172,48865,1903,0,1903,0.0,1.0
16173,48866,4851,0,4851,0.0,1.0
16174,48867,28264,18943,9321,0.67,0.33
16175,48870,148,0,148,0.0,1.0
16176,48871,1952,0,1952,0.0,1.0
16177,48872,7840,3446,4394,0.44,0.56
16178,48873,1615,0,1615,0.0,1.0
16179,48874,180,0,180,0.0,1.0
16180,48875,10186,5020,5166,0.493,0.507
16181,48876,4014,2737,1277,0.682,0.318
16182,48877,2392,0,2392,0.0,1.0
16183,48878,1677,0,1677,0.0,1.0
16184,48879,18075,8425,9650,0.466,0.534
16185,48880,10669,7579,3090,0.71,0.29
16186,48881,5501,0,5501,0.0,1.0
16187,48883,7122,27,7095,0.004,0.996
16188,48884,4427,0,4427,0.0,1.0
16189,48885,927,0,927,0.0,1.0
16190,48886,2116,0,2116,0.0,1.0
16191,48888,6366,0,6366,0.0,1.0
16192,48889,1322,0,1322,0.0,1.0
16193,48890,2152,0,2152,0.0,1.0
16194,48891,2985,0,2985,0.0,1.0
16195,48892,4382,1243,3139,0.284,0.716
16196,48893,5212,0,5212,0.0,1.0
16197,48894,2059,0,2059,0.0,1.0
16198,48895,11189,5733,5456,0.512,0.488
16199,48896,154,0,154,0.0,1.0
16200,48897,1525,0,1525,0.0,1.0
16201,48906,26634,24175,2459,0.908,0.092
16202,48910,34560,34541,19,0.999,0.001
16203,48911,40111,39961,150,0.996,0.004
16204,48912,17035,17035,0,1.0,0.0
16205,48915,9218,9218,0,1.0,0.0
16206,48917,32062,31832,230,0.993,0.007
16207,48921,0,0,0,,
16208,48933,2530,2530,0,1.0,0.0
16209,49001,22095,22095,0,1.0,0.0
16210,49002,18786,18560,226,0.988,0.012
16211,49004,15645,14054,1591,0.898,0.102
16212,49006,26455,26450,5,1.0,0.0
16213,49007,10762,10762,0,1.0,0.0
16214,49008,16186,16186,0,1.0,0.0
16215,49009,42362,29494,12868,0.696,0.304
16216,49010,17374,6322,11052,0.364,0.636
16217,49011,2285,0,2285,0.0,1.0
16218,49012,3339,1104,2235,0.331,0.669
16219,49013,5508,0,5508,0.0,1.0
16220,49014,22127,15330,6797,0.693,0.307
16221,49015,26782,25387,1395,0.948,0.052
16222,49017,20785,14818,5967,0.713,0.287
16223,49021,6182,0,6182,0.0,1.0
16224,49022,31814,26294,5520,0.826,0.174
16225,49024,28552,28122,430,0.985,0.015
16226,49026,2186,0,2186,0.0,1.0
16227,49027,161,0,161,0.0,1.0
16228,49028,6387,0,6387,0.0,1.0
16229,49029,1606,0,1606,0.0,1.0
16230,49030,2523,0,2523,0.0,1.0
16231,49031,7884,0,7884,0.0,1.0
16232,49032,3105,0,3105,0.0,1.0
16233,49033,1760,0,1760,0.0,1.0
16234,49034,2389,0,2389,0.0,1.0
16235,49036,24868,14788,10080,0.595,0.405
16236,49037,22576,21754,822,0.964,0.036
16237,49038,9310,4285,5025,0.46,0.54
16238,49040,3388,0,3388,0.0,1.0
16239,49042,4892,2323,2569,0.475,0.525
16240,49043,2462,0,2462,0.0,1.0
16241,49045,5598,0,5598,0.0,1.0
16242,49046,7281,28,7253,0.004,0.996
16243,49047,14805,6082,8723,0.411,0.589
16244,49048,25432,22822,2610,0.897,0.103
16245,49050,1557,0,1557,0.0,1.0
16246,49051,2436,0,2436,0.0,1.0
16247,49052,975,0,975,0.0,1.0
16248,49053,7028,4537,2491,0.646,0.354
16249,49055,6276,0,6276,0.0,1.0
16250,49056,4016,0,4016,0.0,1.0
16251,49057,6795,3482,3313,0.512,0.488
16252,49058,19127,7713,11414,0.403,0.597
16253,49060,1738,0,1738,0.0,1.0
16254,49061,1622,0,1622,0.0,1.0
16255,49064,3717,0,3717,0.0,1.0
16256,49065,6662,3222,3440,0.484,0.516
16257,49066,722,0,722,0.0,1.0
16258,49067,4522,0,4522,0.0,1.0
16259,49068,14646,7683,6963,0.525,0.475
16260,49070,2451,0,2451,0.0,1.0
16261,49071,9174,5050,4124,0.55,0.45
16262,49072,3164,18,3146,0.006,0.994
16263,49073,4951,0,4951,0.0,1.0
16264,49074,149,149,0,1.0,0.0
16265,49075,121,0,121,0.0,1.0
16266,49076,4589,0,4589,0.0,1.0
16267,49078,8902,4919,3983,0.553,0.447
16268,49079,13606,5657,7949,0.416,0.584
16269,49080,15802,6821,8981,0.432,0.568
16270,49082,6579,2088,4491,0.317,0.683
16271,49083,6961,2307,4654,0.331,0.669
16272,49084,36,0,36,0.0,1.0
16273,49085,23804,22292,1512,0.936,0.064
16274,49087,6126,2249,3877,0.367,0.633
16275,49088,3648,1538,2110,0.422,0.578
16276,49089,1875,0,1875,0.0,1.0
16277,49090,13810,5791,8019,0.419,0.581
16278,49091,19872,13040,6832,0.656,0.344
16279,49092,2187,0,2187,0.0,1.0
16280,49093,18380,10802,7578,0.588,0.412
16281,49094,4104,0,4104,0.0,1.0
16282,49095,1960,0,1960,0.0,1.0
16283,49096,3316,0,3316,0.0,1.0
16284,49097,10326,5133,5193,0.497,0.503
16285,49098,5966,3822,2144,0.641,0.359
16286,49099,5629,1751,3878,0.311,0.689
16287,49101,3104,0,3104,0.0,1.0
16288,49102,1563,0,1563,0.0,1.0
16289,49103,11082,6490,4592,0.586,0.414
16290,49104,868,868,0,1.0,0.0
16291,49106,4636,2464,2172,0.531,0.469
16292,49107,10382,5522,4860,0.532,0.468
16293,49111,3346,0,3346,0.0,1.0
16294,49112,10171,5757,4414,0.566,0.434
16295,49113,1904,0,1904,0.0,1.0
16296,49115,294,0,294,0.0,1.0
16297,49116,394,0,394,0.0,1.0
16298,49117,3951,595,3356,0.151,0.849
16299,49119,136,0,136,0.0,1.0
16300,49120,37122,25916,11206,0.698,0.302
16301,49125,2046,0,2046,0.0,1.0
16302,49126,1341,321,1020,0.239,0.761
16303,49127,10694,9651,1043,0.902,0.098
16304,49128,3715,0,3715,0.0,1.0
16305,49129,609,0,609,0.0,1.0
16306,49130,1659,0,1659,0.0,1.0
16307,49201,45190,24958,20232,0.552,0.448
16308,49202,20661,20553,108,0.995,0.005
16309,49203,38280,37845,435,0.989,0.011
16310,49220,2290,0,2290,0.0,1.0
16311,49221,41310,31881,9429,0.772,0.228
16312,49224,14224,9219,5005,0.648,0.352
16313,49227,1284,0,1284,0.0,1.0
16314,49228,5545,3202,2343,0.577,0.423
16315,49229,3245,0,3245,0.0,1.0
16316,49230,10475,2773,7702,0.265,0.735
16317,49232,2801,0,2801,0.0,1.0
16318,49233,2646,949,1697,0.359,0.641
16319,49234,2579,0,2579,0.0,1.0
16320,49235,2117,0,2117,0.0,1.0
16321,49236,4838,2382,2456,0.492,0.508
16322,49237,2980,0,2980,0.0,1.0
16323,49238,1735,0,1735,0.0,1.0
16324,49240,8703,0,8703,0.0,1.0
16325,49241,2579,0,2579,0.0,1.0
16326,49242,15248,8946,6302,0.587,0.413
16327,49245,4845,0,4845,0.0,1.0
16328,49246,3255,0,3255,0.0,1.0
16329,49247,5768,0,5768,0.0,1.0
16330,49248,899,0,899,0.0,1.0
16331,49249,3408,1789,1619,0.525,0.475
16332,49250,6182,2078,4104,0.336,0.664
16333,49251,6229,0,6229,0.0,1.0
16334,49252,2605,0,2605,0.0,1.0
16335,49253,3166,0,3166,0.0,1.0
16336,49254,3321,2851,470,0.858,0.142
16337,49255,1939,0,1939,0.0,1.0
16338,49256,3888,0,3888,0.0,1.0
16339,49259,2523,0,2523,0.0,1.0
16340,49261,290,0,290,0.0,1.0
16341,49262,1280,0,1280,0.0,1.0
16342,49263,85,0,85,0.0,1.0
16343,49264,1992,0,1992,0.0,1.0
16344,49265,4958,0,4958,0.0,1.0
16345,49266,2942,622,2320,0.211,0.789
16346,49267,4072,635,3437,0.156,0.844
16347,49268,1059,101,958,0.095,0.905
16348,49269,5998,721,5277,0.12,0.88
16349,49270,5874,0,5874,0.0,1.0
16350,49271,2256,0,2256,0.0,1.0
16351,49272,2417,0,2417,0.0,1.0
16352,49274,3670,0,3670,0.0,1.0
16353,49276,1003,0,1003,0.0,1.0
16354,49277,3668,0,3668,0.0,1.0
16355,49279,797,0,797,0.0,1.0
16356,49282,372,172,200,0.462,0.538
16357,49283,4362,3129,1233,0.717,0.283
16358,49284,3028,0,3028,0.0,1.0
16359,49285,5720,0,5720,0.0,1.0
16360,49286,14797,10560,4237,0.714,0.286
16361,49287,2099,0,2099,0.0,1.0
16362,49288,1384,0,1384,0.0,1.0
16363,49289,167,0,167,0.0,1.0
16364,49301,18701,10553,8148,0.564,0.436
16365,49302,7585,1476,6109,0.195,0.805
16366,49303,1129,0,1129,0.0,1.0
16367,49304,4328,0,4328,0.0,1.0
16368,49305,2264,0,2264,0.0,1.0
16369,49306,9244,5973,3271,0.646,0.354
16370,49307,20112,14241,5871,0.708,0.292
16371,49309,1843,0,1843,0.0,1.0
16372,49310,3016,0,3016,0.0,1.0
16373,49312,274,0,274,0.0,1.0
16374,49315,19915,14085,5830,0.707,0.293
16375,49316,20074,11429,8645,0.569,0.431
16376,49318,1398,0,1398,0.0,1.0
16377,49319,16181,3832,12349,0.237,0.763
16378,49320,21,0,21,0.0,1.0
16379,49321,16241,14209,2032,0.875,0.125
16380,49322,1212,0,1212,0.0,1.0
16381,49323,9410,3519,5891,0.374,0.626
16382,49325,1909,0,1909,0.0,1.0
16383,49326,3752,0,3752,0.0,1.0
16384,49327,8406,449,7957,0.053,0.947
16385,49328,3885,0,3885,0.0,1.0
16386,49329,8641,0,8641,0.0,1.0
16387,49330,5440,0,5440,0.0,1.0
16388,49331,16627,6803,9824,0.409,0.591
16389,49332,3019,0,3019,0.0,1.0
16390,49333,11191,3629,7562,0.324,0.676
16391,49335,314,252,62,0.803,0.197
16392,49336,4352,0,4352,0.0,1.0
16393,49337,12088,2886,9202,0.239,0.761
16394,49338,1842,0,1842,0.0,1.0
16395,49339,2283,0,2283,0.0,1.0
16396,49340,2912,0,2912,0.0,1.0
16397,49341,33737,16588,17149,0.492,0.508
16398,49342,1649,0,1649,0.0,1.0
16399,49343,5489,0,5489,0.0,1.0
16400,49344,3410,634,2776,0.186,0.814
16401,49345,13040,5778,7262,0.443,0.557
16402,49346,5446,0,5446,0.0,1.0
16403,49347,1257,0,1257,0.0,1.0
16404,49348,12153,7054,5099,0.58,0.42
16405,49349,8087,0,8087,0.0,1.0
16406,49401,20735,18118,2617,0.874,0.126
16407,49402,1380,0,1380,0.0,1.0
16408,49403,2473,0,2473,0.0,1.0
16409,49404,8269,3951,4318,0.478,0.522
16410,49405,1559,0,1559,0.0,1.0
16411,49406,884,772,112,0.873,0.127
16412,49408,9091,444,8647,0.049,0.951
16413,49410,2005,0,2005,0.0,1.0
16414,49411,1538,0,1538,0.0,1.0
16415,49412,11065,4496,6569,0.406,0.594
16416,49415,6480,3211,3269,0.496,0.504
16417,49417,29183,23443,5740,0.803,0.197
16418,49418,27417,26986,431,0.984,0.016
16419,49419,7791,0,7791,0.0,1.0
16420,49420,6420,2350,4070,0.366,0.634
16421,49421,5991,0,5991,0.0,1.0
16422,49423,44977,38953,6024,0.866,0.134
16423,49424,44760,41257,3503,0.922,0.078
16424,49425,3660,0,3660,0.0,1.0
16425,49426,33244,26915,6329,0.81,0.19
16426,49428,25420,24806,614,0.976,0.024
16427,49431,16875,10710,6165,0.635,0.365
16428,49434,20,19,1,0.95,0.05
16429,49435,3549,0,3549,0.0,1.0
16430,49436,1622,206,1416,0.127,0.873
16431,49437,6902,2532,4370,0.367,0.633
16432,49440,953,953,0,1.0,0.0
16433,49441,36308,35985,323,0.991,0.009
16434,49442,41214,37520,3694,0.91,0.09
16435,49444,29456,28410,1046,0.964,0.036
16436,49445,20784,13252,7532,0.638,0.362
16437,49446,2321,0,2321,0.0,1.0
16438,49448,3410,244,3166,0.072,0.928
16439,49449,2675,0,2675,0.0,1.0
16440,49450,3302,0,3302,0.0,1.0
16441,49451,6012,0,6012,0.0,1.0
16442,49452,1952,0,1952,0.0,1.0
16443,49453,2626,1354,1272,0.516,0.484
16444,49454,4574,0,4574,0.0,1.0
16445,49455,5034,0,5034,0.0,1.0
16446,49456,18581,16272,2309,0.876,0.124
16447,49457,10565,5451,5114,0.516,0.484
16448,49458,119,0,119,0.0,1.0
16449,49459,1351,0,1351,0.0,1.0
16450,49460,8126,498,7628,0.061,0.939
16451,49461,8929,4152,4777,0.465,0.535
16452,49464,27481,19637,7844,0.715,0.285
16453,49503,35940,35940,0,1.0,0.0
16454,49504,39994,39994,0,1.0,0.0
16455,49505,31216,31216,0,1.0,0.0
16456,49506,31354,31354,0,1.0,0.0
16457,49507,35459,35459,0,1.0,0.0
16458,49508,39148,39148,0,1.0,0.0
16459,49509,26720,26720,0,1.0,0.0
16460,49512,15448,15132,316,0.98,0.02
16461,49519,27424,27424,0,1.0,0.0
16462,49525,27383,26579,804,0.971,0.029
16463,49534,21570,17902,3668,0.83,0.17
16464,49544,8944,7535,1409,0.842,0.158
16465,49546,31880,31880,0,1.0,0.0
16466,49548,30524,30524,0,1.0,0.0
16467,49601,21236,11690,9546,0.55,0.45
16468,49611,236,0,236,0.0,1.0
16469,49612,1121,0,1121,0.0,1.0
16470,49613,680,0,680,0.0,1.0
16471,49614,2790,0,2790,0.0,1.0
16472,49615,4131,0,4131,0.0,1.0
16473,49616,1974,0,1974,0.0,1.0
16474,49617,3363,0,3363,0.0,1.0
16475,49618,761,0,761,0.0,1.0
16476,49619,1110,0,1110,0.0,1.0
16477,49620,2445,0,2445,0.0,1.0
16478,49621,3096,13,3083,0.004,0.996
16479,49622,2494,0,2494,0.0,1.0
16480,49623,1164,0,1164,0.0,1.0
16481,49625,1379,0,1379,0.0,1.0
16482,49626,421,305,116,0.724,0.276
16483,49627,206,0,206,0.0,1.0
16484,49628,372,0,372,0.0,1.0
16485,49629,2223,0,2223,0.0,1.0
16486,49630,1429,0,1429,0.0,1.0
16487,49631,6357,0,6357,0.0,1.0
16488,49632,1126,0,1126,0.0,1.0
16489,49633,3703,0,3703,0.0,1.0
16490,49634,116,116,0,1.0,0.0
16491,49635,3350,0,3350,0.0,1.0
16492,49636,560,0,560,0.0,1.0
16493,49637,3405,1582,1823,0.465,0.535
16494,49638,824,0,824,0.0,1.0
16495,49639,2557,0,2557,0.0,1.0
16496,49640,1618,0,1618,0.0,1.0
16497,49642,842,0,842,0.0,1.0
16498,49643,6253,0,6253,0.0,1.0
16499,49644,2033,0,2033,0.0,1.0
16500,49645,1632,0,1632,0.0,1.0
16501,49646,8229,2668,5561,0.324,0.676
16502,49648,2098,0,2098,0.0,1.0
16503,49649,7789,0,7789,0.0,1.0
16504,49650,3144,0,3144,0.0,1.0
16505,49651,7665,0,7665,0.0,1.0
16506,49653,1922,0,1922,0.0,1.0
16507,49654,690,0,690,0.0,1.0
16508,49655,3173,0,3173,0.0,1.0
16509,49656,1534,0,1534,0.0,1.0
16510,49657,3683,0,3683,0.0,1.0
16511,49659,6801,0,6801,0.0,1.0
16512,49660,14066,9185,4881,0.653,0.347
16513,49663,5874,0,5874,0.0,1.0
16514,49664,2067,0,2067,0.0,1.0
16515,49665,4413,0,4413,0.0,1.0
16516,49666,106,0,106,0.0,1.0
16517,49667,549,0,549,0.0,1.0
16518,49668,3625,0,3625,0.0,1.0
16519,49670,1891,0,1891,0.0,1.0
16520,49674,110,0,110,0.0,1.0
16521,49675,1030,0,1030,0.0,1.0
16522,49676,3407,0,3407,0.0,1.0
16523,49677,6631,0,6631,0.0,1.0
16524,49679,1428,0,1428,0.0,1.0
16525,49680,1916,0,1916,0.0,1.0
16526,49682,4253,126,4127,0.03,0.97
16527,49683,1939,0,1939,0.0,1.0
16528,49684,37963,24214,13749,0.638,0.362
16529,49686,32056,20264,11792,0.632,0.368
16530,49688,2703,0,2703,0.0,1.0
16531,49689,1560,0,1560,0.0,1.0
16532,49690,6182,910,5272,0.147,0.853
16533,49701,1036,0,1036,0.0,1.0
16534,49705,937,0,937,0.0,1.0
16535,49706,4585,0,4585,0.0,1.0
16536,49707,22701,14258,8443,0.628,0.372
16537,49709,3618,0,3618,0.0,1.0
16538,49710,409,0,409,0.0,1.0
16539,49712,7890,3501,4389,0.444,0.556
16540,49713,1864,0,1864,0.0,1.0
16541,49715,3130,0,3130,0.0,1.0
16542,49716,806,0,806,0.0,1.0
16543,49717,72,0,72,0.0,1.0
16544,49718,701,0,701,0.0,1.0
16545,49719,1362,0,1362,0.0,1.0
16546,49720,9172,4179,4993,0.456,0.544
16547,49721,14436,4517,9919,0.313,0.687
16548,49722,220,132,88,0.6,0.4
16549,49724,1146,0,1146,0.0,1.0
16550,49725,766,0,766,0.0,1.0
16551,49726,1058,0,1058,0.0,1.0
16552,49727,7145,0,7145,0.0,1.0
16553,49728,334,0,334,0.0,1.0
16554,49729,1446,0,1446,0.0,1.0
16555,49730,2187,0,2187,0.0,1.0
16556,49733,1965,0,1965,0.0,1.0
16557,49735,19515,8298,11217,0.425,0.575
16558,49736,578,0,578,0.0,1.0
16559,49738,9924,3858,6066,0.389,0.611
16560,49740,7042,0,7042,0.0,1.0
16561,49743,769,0,769,0.0,1.0
16562,49744,823,0,823,0.0,1.0
16563,49745,1089,0,1089,0.0,1.0
16564,49746,3685,0,3685,0.0,1.0
16565,49747,1921,0,1921,0.0,1.0
16566,49748,170,0,170,0.0,1.0
16567,49749,4283,0,4283,0.0,1.0
16568,49751,2087,0,2087,0.0,1.0
16569,49752,515,66,449,0.128,0.872
16570,49753,2057,0,2057,0.0,1.0
16571,49755,1892,0,1892,0.0,1.0
16572,49756,3857,0,3857,0.0,1.0
16573,49757,492,0,492,0.0,1.0
16574,49759,1682,0,1682,0.0,1.0
16575,49760,713,0,713,0.0,1.0
16576,49762,639,0,639,0.0,1.0
16577,49764,139,0,139,0.0,1.0
16578,49765,4154,0,4154,0.0,1.0
16579,49766,2417,0,2417,0.0,1.0
16580,49768,476,0,476,0.0,1.0
16581,49769,1644,0,1644,0.0,1.0
16582,49770,16862,8078,8784,0.479,0.521
16583,49774,1851,0,1851,0.0,1.0
16584,49775,95,0,95,0.0,1.0
16585,49776,1888,0,1888,0.0,1.0
16586,49777,1640,0,1640,0.0,1.0
16587,49779,4639,2560,2079,0.552,0.448
16588,49780,1946,0,1946,0.0,1.0
16589,49781,4020,2531,1489,0.63,0.37
16590,49782,657,0,657,0.0,1.0
16591,49783,19668,13114,6554,0.667,0.333
16592,49788,6609,6489,120,0.982,0.018
16593,49791,329,0,329,0.0,1.0
16594,49793,322,0,322,0.0,1.0
16595,49795,2097,0,2097,0.0,1.0
16596,49796,320,0,320,0.0,1.0
16597,49799,2327,0,2327,0.0,1.0
16598,49801,11424,7786,3638,0.682,0.318
16599,49802,6230,6007,223,0.964,0.036
16600,49805,336,0,336,0.0,1.0
16601,49806,627,0,627,0.0,1.0
16602,49807,3390,0,3390,0.0,1.0
16603,49808,352,0,352,0.0,1.0
16604,49812,925,0,925,0.0,1.0
16605,49814,1429,0,1429,0.0,1.0
16606,49815,488,0,488,0.0,1.0
16607,49816,724,0,724,0.0,1.0
16608,49817,615,0,615,0.0,1.0
16609,49818,988,0,988,0.0,1.0
16610,49819,36,0,36,0.0,1.0
16611,49820,382,0,382,0.0,1.0
16612,49821,1354,0,1354,0.0,1.0
16613,49822,220,0,220,0.0,1.0
16614,49825,299,0,299,0.0,1.0
16615,49826,137,0,137,0.0,1.0
16616,49827,897,0,897,0.0,1.0
16617,49829,17347,13811,3536,0.796,0.204
16618,49831,780,0,780,0.0,1.0
16619,49833,266,0,266,0.0,1.0
16620,49834,284,0,284,0.0,1.0
16621,49835,802,0,802,0.0,1.0
16622,49836,938,0,938,0.0,1.0
16623,49837,9795,6359,3436,0.649,0.351
16624,49838,504,0,504,0.0,1.0
16625,49839,479,0,479,0.0,1.0
16626,49840,771,0,771,0.0,1.0
16627,49841,7016,0,7016,0.0,1.0
16628,49847,998,0,998,0.0,1.0
16629,49848,128,0,128,0.0,1.0
16630,49849,12242,8596,3646,0.702,0.298
16631,49852,120,0,120,0.0,1.0
16632,49853,1278,0,1278,0.0,1.0
16633,49854,6469,3482,2987,0.538,0.462
16634,49855,33561,26946,6615,0.803,0.197
16635,49858,12088,8570,3518,0.709,0.291
16636,49861,616,0,616,0.0,1.0
16637,49862,5025,2751,2274,0.547,0.453
16638,49863,130,0,130,0.0,1.0
16639,49864,54,0,54,0.0,1.0
16640,49866,8034,3705,4329,0.461,0.539
16641,49868,5409,3225,2184,0.596,0.404
16642,49870,3329,2229,1100,0.67,0.33
16643,49871,510,0,510,0.0,1.0
16644,49872,206,0,206,0.0,1.0
16645,49873,120,0,120,0.0,1.0
16646,49874,1126,0,1126,0.0,1.0
16647,49876,1240,1202,38,0.969,0.031
16648,49877,67,0,67,0.0,1.0
16649,49878,3583,0,3583,0.0,1.0
16650,49879,1038,0,1038,0.0,1.0
16651,49880,1142,0,1142,0.0,1.0
16652,49881,345,0,345,0.0,1.0
16653,49883,151,0,151,0.0,1.0
16654,49884,552,0,552,0.0,1.0
16655,49885,1897,0,1897,0.0,1.0
16656,49886,435,0,435,0.0,1.0
16657,49887,2474,0,2474,0.0,1.0
16658,49891,816,0,816,0.0,1.0
16659,49892,1948,370,1578,0.19,0.81
16660,49893,1784,0,1784,0.0,1.0
16661,49894,680,680,0,1.0,0.0
16662,49895,765,221,544,0.289,0.711
16663,49896,1749,0,1749,0.0,1.0
16664,49901,346,0,346,0.0,1.0
16665,49902,145,0,145,0.0,1.0
16666,49903,133,0,133,0.0,1.0
16667,49905,2005,417,1588,0.208,0.792
16668,49908,3292,0,3292,0.0,1.0
16669,49910,385,0,385,0.0,1.0
16670,49911,2744,0,2744,0.0,1.0
16671,49912,1081,0,1081,0.0,1.0
16672,49913,7248,5476,1772,0.756,0.244
16673,49915,630,561,69,0.89,0.11
16674,49916,2765,556,2209,0.201,0.799
16675,49917,205,0,205,0.0,1.0
16676,49918,120,0,120,0.0,1.0
16677,49919,242,0,242,0.0,1.0
16678,49920,4273,0,4273,0.0,1.0
16679,49921,360,284,76,0.789,0.211
16680,49922,1043,724,319,0.694,0.306
16681,49925,494,0,494,0.0,1.0
16682,49927,483,218,265,0.451,0.549
16683,49929,216,0,216,0.0,1.0
16684,49930,6987,5111,1876,0.732,0.268
16685,49931,9630,8360,1270,0.868,0.132
16686,49934,900,533,367,0.592,0.408
16687,49935,6096,2429,3667,0.398,0.602
16688,49938,7945,5229,2716,0.658,0.342
16689,49942,156,0,156,0.0,1.0
16690,49945,2621,1316,1305,0.502,0.498
16691,49946,4040,0,4040,0.0,1.0
16692,49947,1818,0,1818,0.0,1.0
16693,49948,590,0,590,0.0,1.0
16694,49950,1121,0,1121,0.0,1.0
16695,49952,143,0,143,0.0,1.0
16696,49953,2879,0,2879,0.0,1.0
16697,49955,371,0,371,0.0,1.0
16698,49958,1270,0,1270,0.0,1.0
16699,49959,344,0,344,0.0,1.0
16700,49960,185,0,185,0.0,1.0
16701,49961,107,0,107,0.0,1.0
16702,49962,260,0,260,0.0,1.0
16703,49963,1024,0,1024,0.0,1.0
16704,49965,440,0,440,0.0,1.0
16705,49967,492,0,492,0.0,1.0
16706,49968,2247,0,2247,0.0,1.0
16707,49969,1401,0,1401,0.0,1.0
16708,49970,243,0,243,0.0,1.0
16709,49971,483,0,483,0.0,1.0
16710,50001,680,0,680,0.0,1.0
16711,50002,1297,0,1297,0.0,1.0
16712,50003,6594,3170,3424,0.481,0.519
16713,50005,730,0,730,0.0,1.0
16714,50006,1676,0,1676,0.0,1.0
16715,50007,474,0,474,0.0,1.0
16716,50008,878,0,878,0.0,1.0
16717,50009,16136,14624,1512,0.906,0.094
16718,50010,29359,27875,1484,0.949,0.051
16719,50011,1390,1390,0,1.0,0.0
16720,50012,4062,4062,0,1.0,0.0
16721,50014,28094,26173,1921,0.932,0.068
16722,50020,1407,0,1407,0.0,1.0
16723,50021,21595,21126,469,0.978,0.022
16724,50022,8494,6471,2023,0.762,0.238
16725,50023,27986,27324,662,0.976,0.024
16726,50025,3325,0,3325,0.0,1.0
16727,50026,584,0,584,0.0,1.0
16728,50027,285,0,285,0.0,1.0
16729,50028,1681,0,1681,0.0,1.0
16730,50029,691,0,691,0.0,1.0
16731,50032,399,329,70,0.825,0.175
16732,50033,44,0,44,0.0,1.0
16733,50034,490,0,490,0.0,1.0
16734,50035,5387,3622,1765,0.672,0.328
16735,50036,16287,12793,3494,0.785,0.215
16736,50038,205,0,205,0.0,1.0
16737,50039,329,0,329,0.0,1.0
16738,50041,92,0,92,0.0,1.0
16739,50042,309,0,309,0.0,1.0
16740,50044,887,0,887,0.0,1.0
16741,50046,1524,823,701,0.54,0.46
16742,50047,5559,3968,1591,0.714,0.286
16743,50048,861,0,861,0.0,1.0
16744,50049,6493,3893,2600,0.6,0.4
16745,50050,710,0,710,0.0,1.0
16746,50051,283,0,283,0.0,1.0
16747,50052,138,0,138,0.0,1.0
16748,50054,3356,0,3356,0.0,1.0
16749,50055,913,0,913,0.0,1.0
16750,50056,1372,0,1372,0.0,1.0
16751,50057,238,0,238,0.0,1.0
16752,50058,1927,0,1927,0.0,1.0
16753,50060,2507,0,2507,0.0,1.0
16754,50061,1701,0,1701,0.0,1.0
16755,50062,741,0,741,0.0,1.0
16756,50063,2604,0,2604,0.0,1.0
16757,50064,126,0,126,0.0,1.0
16758,50065,583,0,583,0.0,1.0
16759,50066,262,0,262,0.0,1.0
16760,50067,302,0,302,0.0,1.0
16761,50068,366,0,366,0.0,1.0
16762,50069,1118,0,1118,0.0,1.0
16763,50070,1489,0,1489,0.0,1.0
16764,50071,1007,0,1007,0.0,1.0
16765,50072,2671,0,2671,0.0,1.0
16766,50073,1195,0,1195,0.0,1.0
16767,50074,334,0,334,0.0,1.0
16768,50075,862,0,862,0.0,1.0
16769,50076,1502,0,1502,0.0,1.0
16770,50078,126,0,126,0.0,1.0
16771,50101,66,0,66,0.0,1.0
16772,50102,87,0,87,0.0,1.0
16773,50103,452,0,452,0.0,1.0
16774,50104,128,0,128,0.0,1.0
16775,50105,1158,938,220,0.81,0.19
16776,50106,1039,0,1039,0.0,1.0
16777,50107,1099,0,1099,0.0,1.0
16778,50108,471,0,471,0.0,1.0
16779,50109,2762,0,2762,0.0,1.0
16780,50111,9407,8837,570,0.939,0.061
16781,50112,11536,9080,2456,0.787,0.213
16782,50115,2674,0,2674,0.0,1.0
16783,50116,299,0,299,0.0,1.0
16784,50117,193,0,193,0.0,1.0
16785,50118,1027,0,1027,0.0,1.0
16786,50119,498,0,498,0.0,1.0
16787,50120,323,0,323,0.0,1.0
16788,50122,1373,0,1373,0.0,1.0
16789,50123,818,0,818,0.0,1.0
16790,50124,3750,3271,479,0.872,0.128
16791,50125,19556,14281,5275,0.73,0.27
16792,50126,6853,5070,1783,0.74,0.26
16793,50127,29,0,29,0.0,1.0
16794,50128,360,0,360,0.0,1.0
16795,50129,5228,3906,1322,0.747,0.253
16796,50130,1648,0,1648,0.0,1.0
16797,50131,17499,16467,1032,0.941,0.059
16798,50132,367,0,367,0.0,1.0
16799,50133,567,0,567,0.0,1.0
16800,50134,660,0,660,0.0,1.0
16801,50135,1605,0,1605,0.0,1.0
16802,50136,445,0,445,0.0,1.0
16803,50138,11720,7346,4374,0.627,0.373
16804,50139,1288,0,1288,0.0,1.0
16805,50140,2969,0,2969,0.0,1.0
16806,50141,569,0,569,0.0,1.0
16807,50142,931,0,931,0.0,1.0
16808,50143,600,0,600,0.0,1.0
16809,50144,2901,0,2901,0.0,1.0
16810,50146,438,0,438,0.0,1.0
16811,50147,440,0,440,0.0,1.0
16812,50148,432,0,432,0.0,1.0
16813,50149,964,0,964,0.0,1.0
16814,50150,984,0,984,0.0,1.0
16815,50151,724,0,724,0.0,1.0
16816,50153,734,0,734,0.0,1.0
16817,50154,466,0,466,0.0,1.0
16818,50155,255,0,255,0.0,1.0
16819,50156,4412,0,4412,0.0,1.0
16820,50157,762,0,762,0.0,1.0
16821,50158,31591,26858,4733,0.85,0.15
16822,50160,465,0,465,0.0,1.0
16823,50161,2047,0,2047,0.0,1.0
16824,50162,1233,0,1233,0.0,1.0
16825,50163,858,0,858,0.0,1.0
16826,50164,652,0,652,0.0,1.0
16827,50165,49,0,49,0.0,1.0
16828,50166,1582,0,1582,0.0,1.0
16829,50167,748,0,748,0.0,1.0
16830,50168,842,0,842,0.0,1.0
16831,50169,3093,0,3093,0.0,1.0
16832,50170,2745,0,2745,0.0,1.0
16833,50171,2923,0,2923,0.0,1.0
16834,50173,696,0,696,0.0,1.0
16835,50174,1429,0,1429,0.0,1.0
16836,50201,8199,6728,1471,0.821,0.179
16837,50206,526,0,526,0.0,1.0
16838,50207,2537,0,2537,0.0,1.0
16839,50208,20417,15655,4762,0.767,0.233
16840,50210,1691,0,1691,0.0,1.0
16841,50211,11192,7742,3450,0.692,0.308
16842,50212,3131,0,3131,0.0,1.0
16843,50213,6812,4819,1993,0.707,0.293
16844,50214,850,0,850,0.0,1.0
16845,50216,2824,0,2824,0.0,1.0
16846,50217,631,0,631,0.0,1.0
16847,50218,139,0,139,0.0,1.0
16848,50219,13939,9745,4194,0.699,0.301
16849,50220,9020,7628,1392,0.846,0.154
16850,50222,498,0,498,0.0,1.0
16851,50223,480,0,480,0.0,1.0
16852,50225,2940,0,2940,0.0,1.0
16853,50226,4724,3605,1119,0.763,0.237
16854,50227,40,0,40,0.0,1.0
16855,50228,2417,0,2417,0.0,1.0
16856,50229,932,0,932,0.0,1.0
16857,50230,1083,0,1083,0.0,1.0
16858,50231,173,0,173,0.0,1.0
16859,50232,537,0,537,0.0,1.0
16860,50233,1388,0,1388,0.0,1.0
16861,50234,613,0,613,0.0,1.0
16862,50235,483,0,483,0.0,1.0
16863,50236,1550,0,1550,0.0,1.0
16864,50237,3095,0,3095,0.0,1.0
16865,50238,1182,0,1182,0.0,1.0
16866,50239,210,0,210,0.0,1.0
16867,50240,2453,0,2453,0.0,1.0
16868,50242,439,0,439,0.0,1.0
16869,50243,244,0,244,0.0,1.0
16870,50244,1813,0,1813,0.0,1.0
16871,50246,735,0,735,0.0,1.0
16872,50247,2515,0,2515,0.0,1.0
16873,50248,4420,3311,1109,0.749,0.251
16874,50249,1332,0,1332,0.0,1.0
16875,50250,2330,0,2330,0.0,1.0
16876,50251,1270,0,1270,0.0,1.0
16877,50252,243,0,243,0.0,1.0
16878,50254,282,0,282,0.0,1.0
16879,50255,65,0,65,0.0,1.0
16880,50256,501,0,501,0.0,1.0
16881,50257,992,0,992,0.0,1.0
16882,50258,1002,0,1002,0.0,1.0
16883,50261,2211,0,2211,0.0,1.0
16884,50262,453,0,453,0.0,1.0
16885,50263,16069,14406,1663,0.897,0.103
16886,50264,466,0,466,0.0,1.0
16887,50265,31653,31159,494,0.984,0.016
16888,50266,23625,23285,340,0.986,0.014
16889,50268,993,0,993,0.0,1.0
16890,50271,628,0,628,0.0,1.0
16891,50272,152,0,152,0.0,1.0
16892,50273,8251,5043,3208,0.611,0.389
16893,50274,398,0,398,0.0,1.0
16894,50275,532,0,532,0.0,1.0
16895,50276,2517,0,2517,0.0,1.0
16896,50277,483,0,483,0.0,1.0
16897,50278,842,0,842,0.0,1.0
16898,50309,5431,5431,0,1.0,0.0
16899,50310,30221,30221,0,1.0,0.0
16900,50311,15113,15113,0,1.0,0.0
16901,50312,15339,15224,115,0.993,0.007
16902,50313,17376,17165,211,0.988,0.012
16903,50314,12465,12465,0,1.0,0.0
16904,50315,35853,35853,0,1.0,0.0
16905,50316,16440,16440,0,1.0,0.0
16906,50317,36207,35791,416,0.989,0.011
16907,50319,0,0,0,,
16908,50320,20027,19038,989,0.951,0.049
16909,50321,7846,7834,12,0.998,0.002
16910,50322,31530,31530,0,1.0,0.0
16911,50323,10201,9707,494,0.952,0.048
16912,50324,4903,4903,0,1.0,0.0
16913,50325,15448,15394,54,0.997,0.003
16914,50327,10467,8557,1910,0.818,0.182
16915,50401,29837,27115,2722,0.909,0.091
16916,50420,377,0,377,0.0,1.0
16917,50421,3032,0,3032,0.0,1.0
16918,50423,2976,0,2976,0.0,1.0
16919,50424,1482,0,1482,0.0,1.0
16920,50426,56,0,56,0.0,1.0
16921,50428,9384,7454,1930,0.794,0.206
16922,50430,518,0,518,0.0,1.0
16923,50431,273,0,273,0.0,1.0
16924,50432,252,0,252,0.0,1.0
16925,50433,256,0,256,0.0,1.0
16926,50434,498,0,498,0.0,1.0
16927,50435,721,0,721,0.0,1.0
16928,50436,5848,3966,1882,0.678,0.322
16929,50438,4159,3115,1044,0.749,0.251
16930,50439,289,0,289,0.0,1.0
16931,50440,422,0,422,0.0,1.0
16932,50441,5776,4246,1530,0.735,0.265
16933,50444,353,0,353,0.0,1.0
16934,50446,548,0,548,0.0,1.0
16935,50447,1081,0,1081,0.0,1.0
16936,50448,695,0,695,0.0,1.0
16937,50449,724,0,724,0.0,1.0
16938,50450,2897,0,2897,0.0,1.0
16939,50451,537,0,537,0.0,1.0
16940,50452,804,0,804,0.0,1.0
16941,50453,588,0,588,0.0,1.0
16942,50454,127,0,127,0.0,1.0
16943,50455,450,0,450,0.0,1.0
16944,50456,1741,0,1741,0.0,1.0
16945,50457,441,0,441,0.0,1.0
16946,50458,2097,0,2097,0.0,1.0
16947,50459,3018,0,3018,0.0,1.0
16948,50460,364,0,364,0.0,1.0
16949,50461,5613,3535,2078,0.63,0.37
16950,50464,673,0,673,0.0,1.0
16951,50465,250,0,250,0.0,1.0
16952,50466,1828,0,1828,0.0,1.0
16953,50467,94,0,94,0.0,1.0
16954,50468,1615,0,1615,0.0,1.0
16955,50469,1574,0,1574,0.0,1.0
16956,50470,275,0,275,0.0,1.0
16957,50471,689,0,689,0.0,1.0
16958,50472,2394,0,2394,0.0,1.0
16959,50473,268,0,268,0.0,1.0
16960,50475,1757,0,1757,0.0,1.0
16961,50476,804,0,804,0.0,1.0
16962,50477,347,0,347,0.0,1.0
16963,50478,775,0,775,0.0,1.0
16964,50479,684,0,684,0.0,1.0
16965,50480,880,0,880,0.0,1.0
16966,50482,774,490,284,0.633,0.367
16967,50483,781,0,781,0.0,1.0
16968,50484,444,0,444,0.0,1.0
16969,50501,29078,25122,3956,0.864,0.136
16970,50510,1116,0,1116,0.0,1.0
16971,50511,7137,5340,1797,0.748,0.252
16972,50514,1452,0,1452,0.0,1.0
16973,50515,279,0,279,0.0,1.0
16974,50516,719,0,719,0.0,1.0
16975,50517,1051,0,1051,0.0,1.0
16976,50518,381,0,381,0.0,1.0
16977,50519,624,0,624,0.0,1.0
16978,50520,144,0,144,0.0,1.0
16979,50521,104,0,104,0.0,1.0
16980,50522,857,0,857,0.0,1.0
16981,50523,604,0,604,0.0,1.0
16982,50524,521,0,521,0.0,1.0
16983,50525,3583,2639,944,0.737,0.263
16984,50527,223,0,223,0.0,1.0
16985,50528,383,0,383,0.0,1.0
16986,50529,837,836,1,0.999,0.001
16987,50530,1205,0,1205,0.0,1.0
16988,50531,242,0,242,0.0,1.0
16989,50532,873,0,873,0.0,1.0
16990,50533,4130,3076,1054,0.745,0.255
16991,50535,885,0,885,0.0,1.0
16992,50536,4541,3628,913,0.799,0.201
16993,50538,503,0,503,0.0,1.0
16994,50539,566,0,566,0.0,1.0
16995,50540,1022,0,1022,0.0,1.0
16996,50541,872,0,872,0.0,1.0
16997,50542,933,0,933,0.0,1.0
16998,50543,1492,0,1492,0.0,1.0
16999,50544,515,0,515,0.0,1.0
17000,50545,205,0,205,0.0,1.0
17001,50546,346,0,346,0.0,1.0
17002,50548,5869,4407,1462,0.751,0.249
17003,50551,158,0,158,0.0,1.0
17004,50554,1625,0,1625,0.0,1.0
17005,50556,292,0,292,0.0,1.0
17006,50557,750,0,750,0.0,1.0
17007,50558,618,0,618,0.0,1.0
17008,50559,348,0,348,0.0,1.0
17009,50560,590,0,590,0.0,1.0
17010,50561,520,0,520,0.0,1.0
17011,50562,527,0,527,0.0,1.0
17012,50563,2500,0,2500,0.0,1.0
17013,50565,468,0,468,0.0,1.0
17014,50566,433,0,433,0.0,1.0
17015,50567,226,0,226,0.0,1.0
17016,50568,1398,0,1398,0.0,1.0
17017,50569,836,0,836,0.0,1.0
17018,50570,248,0,248,0.0,1.0
17019,50571,394,0,394,0.0,1.0
17020,50573,68,0,68,0.0,1.0
17021,50574,2181,0,2181,0.0,1.0
17022,50575,969,0,969,0.0,1.0
17023,50576,423,0,423,0.0,1.0
17024,50577,410,0,410,0.0,1.0
17025,50578,646,0,646,0.0,1.0
17026,50579,2405,0,2405,0.0,1.0
17027,50581,996,0,996,0.0,1.0
17028,50582,234,0,234,0.0,1.0
17029,50583,2855,0,2855,0.0,1.0
17030,50585,1176,0,1176,0.0,1.0
17031,50586,307,0,307,0.0,1.0
17032,50588,12756,11275,1481,0.884,0.116
17033,50590,879,0,879,0.0,1.0
17034,50591,320,0,320,0.0,1.0
17035,50593,64,0,64,0.0,1.0
17036,50594,298,0,298,0.0,1.0
17037,50595,9165,7761,1404,0.847,0.153
17038,50597,1293,0,1293,0.0,1.0
17039,50598,912,0,912,0.0,1.0
17040,50599,380,0,380,0.0,1.0
17041,50601,2464,0,2464,0.0,1.0
17042,50602,1603,0,1603,0.0,1.0
17043,50603,625,0,625,0.0,1.0
17044,50604,1850,0,1850,0.0,1.0
17045,50605,168,0,168,0.0,1.0
17046,50606,885,0,885,0.0,1.0
17047,50607,481,0,481,0.0,1.0
17048,50609,446,0,446,0.0,1.0
17049,50611,392,0,392,0.0,1.0
17050,50612,335,0,335,0.0,1.0
17051,50613,42031,37814,4217,0.9,0.1
17052,50616,10344,7706,2638,0.745,0.255
17053,50619,2410,0,2410,0.0,1.0
17054,50620,54,0,54,0.0,1.0
17055,50621,1530,0,1530,0.0,1.0
17056,50622,3206,0,3206,0.0,1.0
17057,50624,1743,0,1743,0.0,1.0
17058,50625,1004,0,1004,0.0,1.0
17059,50626,1804,0,1804,0.0,1.0
17060,50627,3456,0,3456,0.0,1.0
17061,50628,1374,0,1374,0.0,1.0
17062,50629,2418,0,2418,0.0,1.0
17063,50630,1728,0,1728,0.0,1.0
17064,50632,1107,0,1107,0.0,1.0
17065,50633,373,0,373,0.0,1.0
17066,50634,713,0,713,0.0,1.0
17067,50635,1602,0,1602,0.0,1.0
17068,50636,1982,0,1982,0.0,1.0
17069,50638,3313,0,3313,0.0,1.0
17070,50641,2017,836,1181,0.414,0.586
17071,50642,581,0,581,0.0,1.0
17072,50643,2747,1930,817,0.703,0.297
17073,50644,8648,5743,2905,0.664,0.336
17074,50645,1204,0,1204,0.0,1.0
17075,50647,1894,0,1894,0.0,1.0
17076,50648,4054,0,4054,0.0,1.0
17077,50650,737,0,737,0.0,1.0
17078,50651,3578,0,3578,0.0,1.0
17079,50652,128,0,128,0.0,1.0
17080,50653,639,0,639,0.0,1.0
17081,50654,499,0,499,0.0,1.0
17082,50655,873,0,873,0.0,1.0
17083,50658,2518,0,2518,0.0,1.0
17084,50659,5488,3292,2196,0.6,0.4
17085,50660,1333,0,1333,0.0,1.0
17086,50662,7238,6158,1080,0.851,0.149
17087,50664,53,0,53,0.0,1.0
17088,50665,2841,0,2841,0.0,1.0
17089,50666,1027,0,1027,0.0,1.0
17090,50667,795,600,195,0.755,0.245
17091,50668,1249,0,1249,0.0,1.0
17092,50669,2436,0,2436,0.0,1.0
17093,50670,2024,0,2024,0.0,1.0
17094,50671,269,0,269,0.0,1.0
17095,50672,594,0,594,0.0,1.0
17096,50673,219,0,219,0.0,1.0
17097,50674,3555,0,3555,0.0,1.0
17098,50675,2456,0,2456,0.0,1.0
17099,50676,2105,0,2105,0.0,1.0
17100,50677,12131,8621,3510,0.711,0.289
17101,50680,1095,0,1095,0.0,1.0
17102,50681,457,0,457,0.0,1.0
17103,50682,1572,0,1572,0.0,1.0
17104,50701,30324,28137,2187,0.928,0.072
17105,50702,19970,19750,220,0.989,0.011
17106,50703,19863,17191,2672,0.865,0.135
17107,50707,8509,7996,513,0.94,0.06
17108,50801,9590,7617,1973,0.794,0.206
17109,50830,1743,0,1743,0.0,1.0
17110,50833,2305,0,2305,0.0,1.0
17111,50835,92,0,92,0.0,1.0
17112,50836,457,0,457,0.0,1.0
17113,50837,376,0,376,0.0,1.0
17114,50839,34,0,34,0.0,1.0
17115,50840,560,0,560,0.0,1.0
17116,50841,2824,0,2824,0.0,1.0
17117,50842,105,0,105,0.0,1.0
17118,50843,596,0,596,0.0,1.0
17119,50845,811,0,811,0.0,1.0
17120,50846,1123,0,1123,0.0,1.0
17121,50847,87,0,87,0.0,1.0
17122,50848,378,0,378,0.0,1.0
17123,50849,2740,0,2740,0.0,1.0
17124,50851,2087,0,2087,0.0,1.0
17125,50853,702,0,702,0.0,1.0
17126,50854,2303,0,2303,0.0,1.0
17127,50857,272,0,272,0.0,1.0
17128,50858,796,0,796,0.0,1.0
17129,50859,584,0,584,0.0,1.0
17130,50860,474,0,474,0.0,1.0
17131,50861,274,0,274,0.0,1.0
17132,50862,148,0,148,0.0,1.0
17133,50863,293,0,293,0.0,1.0
17134,50864,2057,0,2057,0.0,1.0
17135,51001,2432,0,2432,0.0,1.0
17136,51002,2741,89,2652,0.032,0.968
17137,51003,1700,1085,615,0.638,0.362
17138,51004,1033,0,1033,0.0,1.0
17139,51005,1491,0,1491,0.0,1.0
17140,51006,1075,0,1075,0.0,1.0
17141,51007,730,0,730,0.0,1.0
17142,51008,151,0,151,0.0,1.0
17143,51009,164,0,164,0.0,1.0
17144,51010,456,0,456,0.0,1.0
17145,51011,79,0,79,0.0,1.0
17146,51012,6642,4662,1980,0.702,0.298
17147,51014,528,0,528,0.0,1.0
17148,51016,1378,0,1378,0.0,1.0
17149,51018,404,0,404,0.0,1.0
17150,51019,773,0,773,0.0,1.0
17151,51020,658,0,658,0.0,1.0
17152,51022,789,0,789,0.0,1.0
17153,51023,3216,0,3216,0.0,1.0
17154,51024,2070,0,2070,0.0,1.0
17155,51025,1989,0,1989,0.0,1.0
17156,51026,862,0,862,0.0,1.0
17157,51027,1260,0,1260,0.0,1.0
17158,51028,2065,0,2065,0.0,1.0
17159,51029,251,0,251,0.0,1.0
17160,51030,1737,0,1737,0.0,1.0
17161,51031,12336,9237,3099,0.749,0.251
17162,51033,428,0,428,0.0,1.0
17163,51034,1820,0,1820,0.0,1.0
17164,51035,1685,0,1685,0.0,1.0
17165,51036,726,0,726,0.0,1.0
17166,51037,322,0,322,0.0,1.0
17167,51038,1535,0,1535,0.0,1.0
17168,51039,2475,0,2475,0.0,1.0
17169,51040,3712,2662,1050,0.717,0.283
17170,51041,6976,5757,1219,0.825,0.175
17171,51044,253,0,253,0.0,1.0
17172,51046,1660,0,1660,0.0,1.0
17173,51047,646,0,646,0.0,1.0
17174,51048,554,0,554,0.0,1.0
17175,51049,506,0,506,0.0,1.0
17176,51050,2631,0,2631,0.0,1.0
17177,51051,90,0,90,0.0,1.0
17178,51052,1027,0,1027,0.0,1.0
17179,51053,1161,0,1161,0.0,1.0
17180,51054,5110,4217,893,0.825,0.175
17181,51055,1319,0,1319,0.0,1.0
17182,51056,478,0,478,0.0,1.0
17183,51058,1007,0,1007,0.0,1.0
17184,51060,615,0,615,0.0,1.0
17185,51061,510,0,510,0.0,1.0
17186,51062,526,0,526,0.0,1.0
17187,51063,1100,0,1100,0.0,1.0
17188,51101,809,809,0,1.0,0.0
17189,51103,17453,16943,510,0.971,0.029
17190,51104,22104,21605,499,0.977,0.023
17191,51105,10216,9309,907,0.911,0.089
17192,51106,26544,25349,1195,0.955,0.045
17193,51108,5566,3292,2274,0.591,0.409
17194,51109,3098,2742,356,0.885,0.115
17195,51111,94,93,1,0.989,0.011
17196,51201,6193,4887,1306,0.789,0.211
17197,51230,462,0,462,0.0,1.0
17198,51231,282,0,282,0.0,1.0
17199,51232,875,0,875,0.0,1.0
17200,51234,1268,0,1268,0.0,1.0
17201,51235,1079,0,1079,0.0,1.0
17202,51237,1703,0,1703,0.0,1.0
17203,51238,1184,0,1184,0.0,1.0
17204,51239,3123,0,3123,0.0,1.0
17205,51240,1746,0,1746,0.0,1.0
17206,51241,1737,0,1737,0.0,1.0
17207,51242,212,0,212,0.0,1.0
17208,51243,807,0,807,0.0,1.0
17209,51244,79,0,79,0.0,1.0
17210,51245,1359,0,1359,0.0,1.0
17211,51246,3844,0,3844,0.0,1.0
17212,51247,4870,3052,1818,0.627,0.373
17213,51248,1857,0,1857,0.0,1.0
17214,51249,3593,2690,903,0.749,0.251
17215,51250,8249,6649,1600,0.806,0.194
17216,51301,12691,10952,1739,0.863,0.137
17217,51331,1140,1120,20,0.982,0.018
17218,51333,522,0,522,0.0,1.0
17219,51334,7661,6192,1469,0.808,0.192
17220,51338,1000,0,1000,0.0,1.0
17221,51341,49,0,49,0.0,1.0
17222,51342,1249,0,1249,0.0,1.0
17223,51343,238,0,238,0.0,1.0
17224,51345,403,0,403,0.0,1.0
17225,51346,2451,0,2451,0.0,1.0
17226,51347,1431,0,1431,0.0,1.0
17227,51350,411,0,411,0.0,1.0
17228,51351,4365,2978,1387,0.682,0.318
17229,51354,1096,0,1096,0.0,1.0
17230,51355,874,592,282,0.677,0.323
17231,51357,728,0,728,0.0,1.0
17232,51358,1310,0,1310,0.0,1.0
17233,51360,8031,6136,1895,0.764,0.236
17234,51363,130,0,130,0.0,1.0
17235,51364,690,0,690,0.0,1.0
17236,51365,453,0,453,0.0,1.0
17237,51366,379,0,379,0.0,1.0
17238,51401,12373,9984,2389,0.807,0.193
17239,51430,761,0,761,0.0,1.0
17240,51431,394,0,394,0.0,1.0
17241,51433,676,0,676,0.0,1.0
17242,51436,904,0,904,0.0,1.0
17243,51439,1047,0,1047,0.0,1.0
17244,51440,400,0,400,0.0,1.0
17245,51441,353,0,353,0.0,1.0
17246,51442,9838,8240,1598,0.838,0.162
17247,51443,1798,0,1798,0.0,1.0
17248,51444,246,0,246,0.0,1.0
17249,51445,2867,0,2867,0.0,1.0
17250,51446,511,0,511,0.0,1.0
17251,51447,228,0,228,0.0,1.0
17252,51448,611,0,611,0.0,1.0
17253,51449,2128,0,2128,0.0,1.0
17254,51450,1583,0,1583,0.0,1.0
17255,51451,116,0,116,0.0,1.0
17256,51453,695,0,695,0.0,1.0
17257,51454,1346,0,1346,0.0,1.0
17258,51455,2306,0,2306,0.0,1.0
17259,51458,1467,0,1467,0.0,1.0
17260,51459,75,0,75,0.0,1.0
17261,51461,1165,0,1165,0.0,1.0
17262,51462,1013,0,1013,0.0,1.0
17263,51463,552,0,552,0.0,1.0
17264,51465,733,0,733,0.0,1.0
17265,51466,1092,0,1092,0.0,1.0
17266,51467,615,0,615,0.0,1.0
17267,51501,35406,34520,886,0.975,0.025
17268,51503,36376,30241,6135,0.831,0.169
17269,51510,3785,3785,0,1.0,0.0
17270,51520,233,0,233,0.0,1.0
17271,51521,2036,0,2036,0.0,1.0
17272,51523,357,0,357,0.0,1.0
17273,51525,1184,0,1184,0.0,1.0
17274,51526,1753,0,1753,0.0,1.0
17275,51527,530,0,530,0.0,1.0
17276,51528,931,0,931,0.0,1.0
17277,51529,1671,0,1671,0.0,1.0
17278,51530,854,0,854,0.0,1.0
17279,51531,914,0,914,0.0,1.0
17280,51532,622,0,622,0.0,1.0
17281,51533,895,0,895,0.0,1.0
17282,51534,9236,5645,3591,0.611,0.389
17283,51535,1923,0,1923,0.0,1.0
17284,51536,448,0,448,0.0,1.0
17285,51537,6703,4934,1769,0.736,0.264
17286,51540,449,0,449,0.0,1.0
17287,51541,363,0,363,0.0,1.0
17288,51542,1011,0,1011,0.0,1.0
17289,51543,445,0,445,0.0,1.0
17290,51544,721,0,721,0.0,1.0
17291,51545,378,0,378,0.0,1.0
17292,51546,2915,0,2915,0.0,1.0
17293,51548,433,0,433,0.0,1.0
17294,51549,465,0,465,0.0,1.0
17295,51550,181,0,181,0.0,1.0
17296,51551,1828,0,1828,0.0,1.0
17297,51552,301,0,301,0.0,1.0
17298,51553,1013,0,1013,0.0,1.0
17299,51554,187,0,187,0.0,1.0
17300,51555,5245,2819,2426,0.537,0.463
17301,51556,437,0,437,0.0,1.0
17302,51557,873,0,873,0.0,1.0
17303,51558,560,0,560,0.0,1.0
17304,51559,1788,0,1788,0.0,1.0
17305,51560,2099,0,2099,0.0,1.0
17306,51561,1455,443,1012,0.304,0.696
17307,51562,449,0,449,0.0,1.0
17308,51563,779,0,779,0.0,1.0
17309,51564,501,0,501,0.0,1.0
17310,51565,501,0,501,0.0,1.0
17311,51566,7035,5597,1438,0.796,0.204
17312,51570,1039,0,1039,0.0,1.0
17313,51571,649,0,649,0.0,1.0
17314,51572,398,0,398,0.0,1.0
17315,51573,1093,0,1093,0.0,1.0
17316,51575,1616,0,1616,0.0,1.0
17317,51576,2110,0,2110,0.0,1.0
17318,51577,1184,0,1184,0.0,1.0
17319,51578,79,0,79,0.0,1.0
17320,51579,2340,0,2340,0.0,1.0
17321,51601,6025,5203,822,0.864,0.136
17322,51630,173,0,173,0.0,1.0
17323,51631,306,0,306,0.0,1.0
17324,51632,7297,5415,1882,0.742,0.258
17325,51636,405,0,405,0.0,1.0
17326,51637,214,0,214,0.0,1.0
17327,51638,1299,0,1299,0.0,1.0
17328,51639,795,0,795,0.0,1.0
17329,51640,1748,0,1748,0.0,1.0
17330,51645,262,0,262,0.0,1.0
17331,51646,763,0,763,0.0,1.0
17332,51647,141,0,141,0.0,1.0
17333,51648,255,0,255,0.0,1.0
17334,51649,328,0,328,0.0,1.0
17335,51650,370,0,370,0.0,1.0
17336,51652,1783,0,1783,0.0,1.0
17337,51653,1379,0,1379,0.0,1.0
17338,51654,526,0,526,0.0,1.0
17339,51656,71,0,71,0.0,1.0
17340,52001,43173,42063,1110,0.974,0.026
17341,52002,14559,12410,2149,0.852,0.148
17342,52003,13436,10226,3210,0.761,0.239
17343,52030,434,0,434,0.0,1.0
17344,52031,5120,2543,2577,0.497,0.503
17345,52032,1456,0,1456,0.0,1.0
17346,52033,3202,0,3202,0.0,1.0
17347,52035,1010,0,1010,0.0,1.0
17348,52037,1223,0,1223,0.0,1.0
17349,52038,491,0,491,0.0,1.0
17350,52039,1158,0,1158,0.0,1.0
17351,52040,5526,3620,1906,0.655,0.345
17352,52041,1608,0,1608,0.0,1.0
17353,52042,1999,0,1999,0.0,1.0
17354,52043,2321,0,2321,0.0,1.0
17355,52044,153,0,153,0.0,1.0
17356,52045,2589,0,2589,0.0,1.0
17357,52046,2127,0,2127,0.0,1.0
17358,52047,567,0,567,0.0,1.0
17359,52048,333,0,333,0.0,1.0
17360,52049,1270,0,1270,0.0,1.0
17361,52050,515,0,515,0.0,1.0
17362,52052,3136,0,3136,0.0,1.0
17363,52053,1163,0,1163,0.0,1.0
17364,52054,940,0,940,0.0,1.0
17365,52057,8222,5032,3190,0.612,0.388
17366,52060,8658,6159,2499,0.711,0.289
17367,52064,847,0,847,0.0,1.0
17368,52065,1130,0,1130,0.0,1.0
17369,52066,80,0,80,0.0,1.0
17370,52068,3924,68,3856,0.017,0.983
17371,52069,1609,0,1609,0.0,1.0
17372,52070,1128,573,555,0.508,0.492
17373,52072,381,0,381,0.0,1.0
17374,52073,1414,0,1414,0.0,1.0
17375,52074,310,0,310,0.0,1.0
17376,52076,2295,0,2295,0.0,1.0
17377,52077,398,0,398,0.0,1.0
17378,52078,914,0,914,0.0,1.0
17379,52079,782,0,782,0.0,1.0
17380,52101,13864,8637,5227,0.623,0.377
17381,52132,1938,0,1938,0.0,1.0
17382,52133,558,0,558,0.0,1.0
17383,52134,285,0,285,0.0,1.0
17384,52135,864,0,864,0.0,1.0
17385,52136,5967,3540,2427,0.593,0.407
17386,52140,532,0,532,0.0,1.0
17387,52141,1435,0,1435,0.0,1.0
17388,52142,1871,0,1871,0.0,1.0
17389,52144,1261,0,1261,0.0,1.0
17390,52146,1039,0,1039,0.0,1.0
17391,52147,1050,0,1050,0.0,1.0
17392,52151,2138,0,2138,0.0,1.0
17393,52154,995,0,995,0.0,1.0
17394,52155,1323,0,1323,0.0,1.0
17395,52156,659,0,659,0.0,1.0
17396,52157,1828,550,1278,0.301,0.699
17397,52158,314,67,247,0.213,0.787
17398,52159,2330,0,2330,0.0,1.0
17399,52160,867,0,867,0.0,1.0
17400,52161,1505,0,1505,0.0,1.0
17401,52162,3285,0,3285,0.0,1.0
17402,52163,276,0,276,0.0,1.0
17403,52164,212,0,212,0.0,1.0
17404,52165,1004,0,1004,0.0,1.0
17405,52166,104,0,104,0.0,1.0
17406,52168,188,0,188,0.0,1.0
17407,52169,432,0,432,0.0,1.0
17408,52170,599,0,599,0.0,1.0
17409,52171,1048,0,1048,0.0,1.0
17410,52172,6303,3731,2572,0.592,0.408
17411,52175,3492,0,3492,0.0,1.0
17412,52201,1267,0,1267,0.0,1.0
17413,52202,1152,0,1152,0.0,1.0
17414,52203,1932,0,1932,0.0,1.0
17415,52205,8682,5497,3185,0.633,0.367
17416,52206,2303,0,2303,0.0,1.0
17417,52207,383,0,383,0.0,1.0
17418,52208,3153,0,3153,0.0,1.0
17419,52209,1074,0,1074,0.0,1.0
17420,52210,697,0,697,0.0,1.0
17421,52211,2624,0,2624,0.0,1.0
17422,52212,285,0,285,0.0,1.0
17423,52213,4340,0,4340,0.0,1.0
17424,52214,3090,0,3090,0.0,1.0
17425,52215,843,0,843,0.0,1.0
17426,52216,1428,0,1428,0.0,1.0
17427,52217,590,0,590,0.0,1.0
17428,52218,1788,0,1788,0.0,1.0
17429,52219,178,0,178,0.0,1.0
17430,52220,237,0,237,0.0,1.0
17431,52221,221,0,221,0.0,1.0
17432,52222,709,0,709,0.0,1.0
17433,52223,1351,0,1351,0.0,1.0
17434,52224,2016,0,2016,0.0,1.0
17435,52225,447,0,447,0.0,1.0
17436,52227,2461,1777,684,0.722,0.278
17437,52228,2772,1986,786,0.716,0.284
17438,52229,721,0,721,0.0,1.0
17439,52231,328,0,328,0.0,1.0
17440,52232,178,0,178,0.0,1.0
17441,52233,6981,6981,0,1.0,0.0
17442,52235,698,0,698,0.0,1.0
17443,52236,592,0,592,0.0,1.0
17444,52237,1522,0,1522,0.0,1.0
17445,52240,32230,27646,4584,0.858,0.142
17446,52241,18911,18901,10,0.999,0.001
17447,52242,1592,1592,0,1.0,0.0
17448,52245,22573,22569,4,1.0,0.0
17449,52246,21114,21068,46,0.998,0.002
17450,52247,5645,0,5645,0.0,1.0
17451,52248,1815,0,1815,0.0,1.0
17452,52249,965,0,965,0.0,1.0
17453,52251,590,0,590,0.0,1.0
17454,52253,3192,2054,1138,0.643,0.357
17455,52254,895,0,895,0.0,1.0
17456,52255,1208,0,1208,0.0,1.0
17457,52257,210,0,210,0.0,1.0
17458,52301,3873,0,3873,0.0,1.0
17459,52302,36980,35055,1925,0.948,0.052
17460,52305,629,0,629,0.0,1.0
17461,52306,1754,0,1754,0.0,1.0
17462,52307,90,0,90,0.0,1.0
17463,52308,132,0,132,0.0,1.0
17464,52309,397,0,397,0.0,1.0
17465,52310,6431,3180,3251,0.494,0.506
17466,52312,115,0,115,0.0,1.0
17467,52313,397,0,397,0.0,1.0
17468,52314,5865,4401,1464,0.75,0.25
17469,52315,1222,0,1222,0.0,1.0
17470,52316,1659,0,1659,0.0,1.0
17471,52317,14775,13340,1435,0.903,0.097
17472,52318,1033,0,1033,0.0,1.0
17473,52320,1203,0,1203,0.0,1.0
17474,52321,404,0,404,0.0,1.0
17475,52322,2436,0,2436,0.0,1.0
17476,52323,867,0,867,0.0,1.0
17477,52324,1890,0,1890,0.0,1.0
17478,52325,873,0,873,0.0,1.0
17479,52326,547,0,547,0.0,1.0
17480,52327,3012,0,3012,0.0,1.0
17481,52328,2826,2709,117,0.959,0.041
17482,52329,803,0,803,0.0,1.0
17483,52330,900,0,900,0.0,1.0
17484,52332,2006,0,2006,0.0,1.0
17485,52333,6168,0,6168,0.0,1.0
17486,52334,311,0,311,0.0,1.0
17487,52335,709,0,709,0.0,1.0
17488,52336,2363,0,2363,0.0,1.0
17489,52337,845,0,845,0.0,1.0
17490,52338,3283,0,3283,0.0,1.0
17491,52339,4504,2660,1844,0.591,0.409
17492,52340,2180,1505,675,0.69,0.31
17493,52341,1093,22,1071,0.02,0.98
17494,52342,3274,2244,1030,0.685,0.315
17495,52345,1468,0,1468,0.0,1.0
17496,52346,1085,0,1085,0.0,1.0
17497,52347,1410,0,1410,0.0,1.0
17498,52348,51,0,51,0.0,1.0
17499,52349,7643,5044,2599,0.66,0.34
17500,52351,1455,0,1455,0.0,1.0
17501,52352,2025,0,2025,0.0,1.0
17502,52353,9173,6628,2545,0.723,0.277
17503,52354,379,0,379,0.0,1.0
17504,52355,277,0,277,0.0,1.0
17505,52356,2656,0,2656,0.0,1.0
17506,52358,3733,0,3733,0.0,1.0
17507,52359,279,0,279,0.0,1.0
17508,52361,4527,2914,1613,0.644,0.356
17509,52362,1041,0,1041,0.0,1.0
17510,52401,2017,2017,0,1.0,0.0
17511,52402,40149,40146,3,1.0,0.0
17512,52403,23673,21777,1896,0.92,0.08
17513,52404,37796,36458,1338,0.965,0.035
17514,52405,23621,23297,324,0.986,0.014
17515,52411,6896,5619,1277,0.815,0.185
17516,52501,30220,24771,5449,0.82,0.18
17517,52530,1005,0,1005,0.0,1.0
17518,52531,5976,3573,2403,0.598,0.402
17519,52533,1215,0,1215,0.0,1.0
17520,52534,284,266,18,0.937,0.063
17521,52535,888,0,888,0.0,1.0
17522,52536,967,0,967,0.0,1.0
17523,52537,7098,0,7098,0.0,1.0
17524,52540,1420,0,1420,0.0,1.0
17525,52542,435,0,435,0.0,1.0
17526,52543,291,0,291,0.0,1.0
17527,52544,7847,5380,2467,0.686,0.314
17528,52548,97,0,97,0.0,1.0
17529,52549,762,0,762,0.0,1.0
17530,52550,585,0,585,0.0,1.0
17531,52551,688,0,688,0.0,1.0
17532,52552,830,0,830,0.0,1.0
17533,52553,1745,0,1745,0.0,1.0
17534,52554,1373,0,1373,0.0,1.0
17535,52555,344,0,344,0.0,1.0
17536,52556,13247,10235,3012,0.773,0.227
17537,52557,85,85,0,1.0,0.0
17538,52560,430,0,430,0.0,1.0
17539,52561,962,0,962,0.0,1.0
17540,52563,1583,0,1583,0.0,1.0
17541,52565,2027,0,2027,0.0,1.0
17542,52566,168,0,168,0.0,1.0
17543,52567,615,0,615,0.0,1.0
17544,52569,610,0,610,0.0,1.0
17545,52570,954,0,954,0.0,1.0
17546,52571,1407,0,1407,0.0,1.0
17547,52572,1132,0,1132,0.0,1.0
17548,52573,162,0,162,0.0,1.0
17549,52574,826,0,826,0.0,1.0
17550,52576,568,0,568,0.0,1.0
17551,52577,15055,11900,3155,0.79,0.21
17552,52580,460,0,460,0.0,1.0
17553,52581,305,0,305,0.0,1.0
17554,52583,342,0,342,0.0,1.0
17555,52584,438,0,438,0.0,1.0
17556,52585,988,0,988,0.0,1.0
17557,52586,521,0,521,0.0,1.0
17558,52588,134,0,134,0.0,1.0
17559,52590,1246,0,1246,0.0,1.0
17560,52591,3028,0,3028,0.0,1.0
17561,52593,142,0,142,0.0,1.0
17562,52594,399,0,399,0.0,1.0
17563,52595,416,379,37,0.911,0.089
17564,52601,29723,25822,3901,0.869,0.131
17565,52619,594,0,594,0.0,1.0
17566,52620,938,0,938,0.0,1.0
17567,52621,668,0,668,0.0,1.0
17568,52623,1993,0,1993,0.0,1.0
17569,52624,290,0,290,0.0,1.0
17570,52625,2802,0,2802,0.0,1.0
17571,52626,1346,0,1346,0.0,1.0
17572,52627,13105,10794,2311,0.824,0.176
17573,52630,445,0,445,0.0,1.0
17574,52632,13086,10502,2584,0.803,0.197
17575,52635,675,0,675,0.0,1.0
17576,52637,2449,0,2449,0.0,1.0
17577,52638,514,271,243,0.527,0.473
17578,52639,2002,0,2002,0.0,1.0
17579,52640,1447,0,1447,0.0,1.0
17580,52641,12357,8636,3721,0.699,0.301
17581,52644,412,0,412,0.0,1.0
17582,52645,3176,0,3176,0.0,1.0
17583,52646,376,0,376,0.0,1.0
17584,52647,229,0,229,0.0,1.0
17585,52649,887,0,887,0.0,1.0
17586,52650,826,0,826,0.0,1.0
17587,52651,646,0,646,0.0,1.0
17588,52653,3570,0,3570,0.0,1.0
17589,52654,1728,0,1728,0.0,1.0
17590,52655,4219,3451,768,0.818,0.182
17591,52656,2359,0,2359,0.0,1.0
17592,52657,95,0,95,0.0,1.0
17593,52658,1071,0,1071,0.0,1.0
17594,52659,1553,0,1553,0.0,1.0
17595,52660,226,0,226,0.0,1.0
17596,52701,108,0,108,0.0,1.0
17597,52720,861,0,861,0.0,1.0
17598,52721,798,0,798,0.0,1.0
17599,52722,34754,34261,493,0.986,0.014
17600,52726,4468,0,4468,0.0,1.0
17601,52727,409,0,409,0.0,1.0
17602,52728,1110,0,1110,0.0,1.0
17603,52729,874,0,874,0.0,1.0
17604,52730,4950,4037,913,0.816,0.184
17605,52731,894,0,894,0.0,1.0
17606,52732,28293,24608,3685,0.87,0.13
17607,52737,384,0,384,0.0,1.0
17608,52738,3567,0,3567,0.0,1.0
17609,52739,745,0,745,0.0,1.0
17610,52742,7618,4639,2979,0.609,0.391
17611,52745,633,0,633,0.0,1.0
17612,52746,967,0,967,0.0,1.0
17613,52747,2106,0,2106,0.0,1.0
17614,52748,8850,5293,3557,0.598,0.402
17615,52749,925,701,224,0.758,0.242
17616,52750,619,0,619,0.0,1.0
17617,52751,1054,0,1054,0.0,1.0
17618,52752,515,0,515,0.0,1.0
17619,52753,5153,3509,1644,0.681,0.319
17620,52754,1274,0,1274,0.0,1.0
17621,52755,1928,0,1928,0.0,1.0
17622,52756,2133,0,2133,0.0,1.0
17623,52757,201,0,201,0.0,1.0
17624,52758,199,0,199,0.0,1.0
17625,52760,533,0,533,0.0,1.0
17626,52761,30678,24641,6037,0.803,0.197
17627,52765,453,0,453,0.0,1.0
17628,52766,820,0,820,0.0,1.0
17629,52767,349,349,0,1.0,0.0
17630,52768,1426,408,1018,0.286,0.714
17631,52769,671,0,671,0.0,1.0
17632,52772,5029,3067,1962,0.61,0.39
17633,52773,2380,0,2380,0.0,1.0
17634,52774,136,0,136,0.0,1.0
17635,52776,4947,3690,1257,0.746,0.254
17636,52777,1357,0,1357,0.0,1.0
17637,52778,4043,2791,1252,0.69,0.31
17638,52801,1122,1122,0,1.0,0.0
17639,52802,10868,10594,274,0.975,0.025
17640,52803,22174,22174,0,1.0,0.0
17641,52804,27379,25686,1693,0.938,0.062
17642,52806,27503,26457,1046,0.962,0.038
17643,52807,13470,13048,422,0.969,0.031
17644,53001,1901,0,1901,0.0,1.0
17645,53002,2299,0,2299,0.0,1.0
17646,53003,141,0,141,0.0,1.0
17647,53004,3330,0,3330,0.0,1.0
17648,53005,19425,19425,0,1.0,0.0
17649,53006,1779,0,1779,0.0,1.0
17650,53007,1841,1841,0,1.0,0.0
17651,53010,7681,0,7681,0.0,1.0
17652,53011,2260,0,2260,0.0,1.0
17653,53012,18097,13067,5030,0.722,0.278
17654,53013,3308,0,3308,0.0,1.0
17655,53014,7962,3590,4372,0.451,0.549
17656,53015,2609,0,2609,0.0,1.0
17657,53016,384,0,384,0.0,1.0
17658,53017,5538,2919,2619,0.527,0.473
17659,53018,7899,6148,1751,0.778,0.222
17660,53019,2027,892,1135,0.44,0.56
17661,53020,3500,0,3500,0.0,1.0
17662,53021,4709,0,4709,0.0,1.0
17663,53022,18920,17050,1870,0.901,0.099
17664,53023,1496,0,1496,0.0,1.0
17665,53024,16579,13503,3076,0.814,0.186
17666,53027,22041,14666,7375,0.665,0.335
17667,53029,20799,18795,2004,0.904,0.096
17668,53031,43,0,43,0.0,1.0
17669,53032,4757,3493,1264,0.734,0.266
17670,53033,4885,3138,1747,0.642,0.358
17671,53034,1811,0,1811,0.0,1.0
17672,53035,2406,0,2406,0.0,1.0
17673,53036,2720,950,1770,0.349,0.651
17674,53037,9260,7439,1821,0.803,0.197
17675,53038,4013,2701,1312,0.673,0.327
17676,53039,4863,2736,2127,0.563,0.437
17677,53040,8064,4007,4057,0.497,0.503
17678,53042,6690,3741,2949,0.559,0.441
17679,53044,2297,2147,150,0.935,0.065
17680,53045,21686,21515,171,0.992,0.008
17681,53046,1107,924,183,0.835,0.165
17682,53047,78,0,78,0.0,1.0
17683,53048,3364,0,3364,0.0,1.0
17684,53049,2451,305,2146,0.124,0.876
17685,53050,6986,5134,1852,0.735,0.265
17686,53051,35651,33459,2192,0.939,0.061
17687,53057,1928,0,1928,0.0,1.0
17688,53058,3243,2679,564,0.826,0.174
17689,53059,1767,0,1767,0.0,1.0
17690,53061,5196,3171,2025,0.61,0.39
17691,53063,1552,0,1552,0.0,1.0
17692,53065,2226,0,2226,0.0,1.0
17693,53066,33830,25176,8654,0.744,0.256
17694,53069,697,697,0,1.0,0.0
17695,53070,4713,2724,1989,0.578,0.422
17696,53072,23907,23224,683,0.971,0.029
17697,53073,15757,8799,6958,0.558,0.442
17698,53074,12880,11419,1461,0.887,0.113
17699,53075,3345,0,3345,0.0,1.0
17700,53076,3648,676,2972,0.185,0.815
17701,53078,1912,0,1912,0.0,1.0
17702,53079,1413,0,1413,0.0,1.0
17703,53080,5715,4151,1564,0.726,0.274
17704,53081,43129,42584,545,0.987,0.013
17705,53083,20362,18841,1521,0.925,0.075
17706,53085,11267,7741,3526,0.687,0.313
17707,53086,8255,5858,2397,0.71,0.29
17708,53088,379,0,379,0.0,1.0
17709,53089,18568,16769,1799,0.903,0.097
17710,53090,21873,15779,6094,0.721,0.279
17711,53091,2018,0,2018,0.0,1.0
17712,53092,20024,19467,557,0.972,0.028
17713,53093,1981,0,1981,0.0,1.0
17714,53094,19169,15070,4099,0.786,0.214
17715,53095,27139,20695,6444,0.763,0.237
17716,53097,6319,3198,3121,0.506,0.494
17717,53098,11965,8278,3687,0.692,0.308
17718,53103,3724,2365,1359,0.635,0.365
17719,53104,5426,1967,3459,0.363,0.637
17720,53105,29225,16288,12937,0.557,0.443
17721,53108,3329,433,2896,0.13,0.87
17722,53110,18320,18320,0,1.0,0.0
17723,53114,2678,1552,1126,0.58,0.42
17724,53115,15788,10647,5141,0.674,0.326
17725,53118,7202,3058,4144,0.425,0.575
17726,53119,5608,2790,2818,0.498,0.502
17727,53120,9679,5479,4200,0.566,0.434
17728,53121,19045,12484,6561,0.656,0.344
17729,53122,5985,5985,0,1.0,0.0
17730,53125,1895,1341,554,0.708,0.292
17731,53126,6431,1529,4902,0.238,0.762
17732,53128,8947,7587,1360,0.848,0.152
17733,53129,13973,13973,0,1.0,0.0
17734,53130,7755,7755,0,1.0,0.0
17735,53132,34863,33334,1529,0.956,0.044
17736,53137,1702,0,1702,0.0,1.0
17737,53139,2802,1066,1736,0.38,0.62
17738,53140,30017,29753,264,0.991,0.009
17739,53142,32375,31696,679,0.979,0.021
17740,53143,23264,23264,0,1.0,0.0
17741,53144,27256,24381,2875,0.895,0.105
17742,53146,7458,5313,2145,0.712,0.288
17743,53147,16457,12120,4337,0.736,0.264
17744,53149,19057,14070,4987,0.738,0.262
17745,53150,24850,23025,1825,0.927,0.073
17746,53151,31987,31987,0,1.0,0.0
17747,53153,2328,1941,387,0.834,0.166
17748,53154,34451,34160,291,0.992,0.008
17749,53156,2992,0,2992,0.0,1.0
17750,53158,15917,15006,911,0.943,0.057
17751,53167,399,399,0,1.0,0.0
17752,53168,8643,6311,2332,0.73,0.27
17753,53170,2380,2380,0,1.0,0.0
17754,53172,21156,21156,0,1.0,0.0
17755,53177,8329,6858,1471,0.823,0.177
17756,53178,2626,0,2626,0.0,1.0
17757,53179,6310,4807,1503,0.762,0.238
17758,53181,7357,6416,941,0.872,0.128
17759,53182,9412,6335,3077,0.673,0.327
17760,53183,2815,2638,177,0.937,0.063
17761,53184,4271,3042,1229,0.712,0.288
17762,53185,18551,15078,3473,0.813,0.187
17763,53186,33592,33592,0,1.0,0.0
17764,53188,35195,33848,1347,0.962,0.038
17765,53189,26228,20919,5309,0.798,0.202
17766,53190,19200,14227,4973,0.741,0.259
17767,53191,2842,2601,241,0.915,0.085
17768,53192,217,113,104,0.521,0.479
17769,53195,114,0,114,0.0,1.0
17770,53202,23386,23386,0,1.0,0.0
17771,53203,938,938,0,1.0,0.0
17772,53204,42355,42355,0,1.0,0.0
17773,53205,10050,10050,0,1.0,0.0
17774,53206,28210,28210,0,1.0,0.0
17775,53207,35149,35149,0,1.0,0.0
17776,53208,31133,31133,0,1.0,0.0
17777,53209,46917,46917,0,1.0,0.0
17778,53210,28126,28126,0,1.0,0.0
17779,53211,35406,35406,0,1.0,0.0
17780,53212,30416,30416,0,1.0,0.0
17781,53213,26020,26020,0,1.0,0.0
17782,53214,34725,34725,0,1.0,0.0
17783,53215,60953,60953,0,1.0,0.0
17784,53216,32264,32264,0,1.0,0.0
17785,53217,29192,29192,0,1.0,0.0
17786,53218,40625,40625,0,1.0,0.0
17787,53219,33880,33880,0,1.0,0.0
17788,53220,26303,26303,0,1.0,0.0
17789,53221,37701,37701,0,1.0,0.0
17790,53222,25165,25165,0,1.0,0.0
17791,53223,29230,29230,0,1.0,0.0
17792,53224,21284,21284,0,1.0,0.0
17793,53225,25706,25706,0,1.0,0.0
17794,53226,18370,18370,0,1.0,0.0
17795,53227,23357,23357,0,1.0,0.0
17796,53228,14369,14369,0,1.0,0.0
17797,53233,16453,16453,0,1.0,0.0
17798,53235,9270,9270,0,1.0,0.0
17799,53295,359,359,0,1.0,0.0
17800,53402,33174,31625,1549,0.953,0.047
17801,53403,27432,27294,138,0.995,0.005
17802,53404,15658,15658,0,1.0,0.0
17803,53405,25193,25193,0,1.0,0.0
17804,53406,25845,25056,789,0.969,0.031
17805,53501,23,0,23,0.0,1.0
17806,53502,2421,0,2421,0.0,1.0
17807,53503,1947,0,1947,0.0,1.0
17808,53504,2084,0,2084,0.0,1.0
17809,53505,354,0,354,0.0,1.0
17810,53506,1125,0,1125,0.0,1.0
17811,53507,2196,0,2196,0.0,1.0
17812,53508,5262,0,5262,0.0,1.0
17813,53510,1482,0,1482,0.0,1.0
17814,53511,48929,43775,5154,0.895,0.105
17815,53515,2268,1269,999,0.56,0.44
17816,53516,2152,0,2152,0.0,1.0
17817,53517,1752,0,1752,0.0,1.0
17818,53518,1330,0,1330,0.0,1.0
17819,53520,6810,3506,3304,0.515,0.485
17820,53521,3656,1424,2232,0.389,0.611
17821,53522,1085,0,1085,0.0,1.0
17822,53523,4949,2577,2372,0.521,0.479
17823,53525,4052,0,4052,0.0,1.0
17824,53526,565,0,565,0.0,1.0
17825,53527,9963,6987,2976,0.701,0.299
17826,53528,5734,3575,2159,0.623,0.377
17827,53529,2031,0,2031,0.0,1.0
17828,53530,4566,0,4566,0.0,1.0
17829,53531,4338,0,4338,0.0,1.0
17830,53532,13606,10795,2811,0.793,0.207
17831,53533,7276,4756,2520,0.654,0.346
17832,53534,11512,7208,4304,0.626,0.374
17833,53536,8503,5669,2834,0.667,0.333
17834,53537,781,0,781,0.0,1.0
17835,53538,18468,13192,5276,0.714,0.286
17836,53540,169,0,169,0.0,1.0
17837,53541,861,0,861,0.0,1.0
17838,53543,1641,0,1641,0.0,1.0
17839,53544,800,0,800,0.0,1.0
17840,53545,23117,21212,1905,0.918,0.082
17841,53546,30648,27892,2756,0.91,0.09
17842,53548,18558,15136,3422,0.816,0.184
17843,53549,10414,7913,2501,0.76,0.24
17844,53550,1239,0,1239,0.0,1.0
17845,53551,8273,6581,1692,0.795,0.205
17846,53553,624,0,624,0.0,1.0
17847,53554,1134,0,1134,0.0,1.0
17848,53555,8465,3014,5451,0.356,0.644
17849,53556,2594,0,2594,0.0,1.0
17850,53557,482,0,482,0.0,1.0
17851,53558,10742,9935,807,0.925,0.075
17852,53559,6063,3834,2229,0.632,0.368
17853,53560,3458,1687,1771,0.488,0.512
17854,53561,1618,0,1618,0.0,1.0
17855,53562,23627,21718,1909,0.919,0.081
17856,53563,10728,6766,3962,0.631,0.369
17857,53565,4765,0,4765,0.0,1.0
17858,53566,15217,10883,4334,0.715,0.285
17859,53569,1155,0,1155,0.0,1.0
17860,53570,2627,0,2627,0.0,1.0
17861,53571,280,0,280,0.0,1.0
17862,53572,9970,6997,2973,0.702,0.298
17863,53573,3062,0,3062,0.0,1.0
17864,53574,3877,0,3877,0.0,1.0
17865,53575,15494,9635,5859,0.622,0.378
17866,53576,2319,0,2319,0.0,1.0
17867,53577,1371,0,1371,0.0,1.0
17868,53578,5924,3972,1952,0.67,0.33
17869,53579,1760,0,1760,0.0,1.0
17870,53580,564,0,564,0.0,1.0
17871,53581,10699,5021,5678,0.469,0.531
17872,53582,1079,0,1079,0.0,1.0
17873,53583,5747,3761,1986,0.654,0.346
17874,53585,2215,0,2215,0.0,1.0
17875,53586,2284,0,2284,0.0,1.0
17876,53587,1290,0,1290,0.0,1.0
17877,53588,4077,0,4077,0.0,1.0
17878,53589,19427,15521,3906,0.799,0.201
17879,53590,36294,32721,3573,0.902,0.098
17880,53593,19225,14872,4353,0.774,0.226
17881,53594,5144,3059,2085,0.595,0.405
17882,53597,16844,13713,3131,0.814,0.186
17883,53598,2511,2043,468,0.814,0.186
17884,53599,69,0,69,0.0,1.0
17885,53702,50,50,0,1.0,0.0
17886,53703,27958,27958,0,1.0,0.0
17887,53704,44034,43785,249,0.994,0.006
17888,53705,23494,23494,0,1.0,0.0
17889,53706,5133,5133,0,1.0,0.0
17890,53711,45728,43576,2152,0.953,0.047
17891,53713,22146,22138,8,1.0,0.0
17892,53714,16463,16463,0,1.0,0.0
17893,53715,12136,12136,0,1.0,0.0
17894,53716,18419,18419,0,1.0,0.0
17895,53717,11962,11962,0,1.0,0.0
17896,53718,11753,11078,675,0.943,0.057
17897,53719,28487,28462,25,0.999,0.001
17898,53726,5177,5177,0,1.0,0.0
17899,53792,0,0,0,,
17900,53801,878,0,878,0.0,1.0
17901,53802,58,0,58,0.0,1.0
17902,53803,1306,0,1306,0.0,1.0
17903,53804,1372,0,1372,0.0,1.0
17904,53805,5269,3261,2008,0.619,0.381
17905,53806,1831,0,1831,0.0,1.0
17906,53807,4843,0,4843,0.0,1.0
17907,53808,1049,0,1049,0.0,1.0
17908,53809,4120,0,4120,0.0,1.0
17909,53810,429,0,429,0.0,1.0
17910,53811,3371,0,3371,0.0,1.0
17911,53813,6075,3688,2387,0.607,0.393
17912,53816,810,0,810,0.0,1.0
17913,53817,205,0,205,0.0,1.0
17914,53818,15091,11236,3855,0.745,0.255
17915,53820,2532,0,2532,0.0,1.0
17916,53821,8456,6255,2201,0.74,0.26
17917,53825,487,0,487,0.0,1.0
17918,53826,1332,0,1332,0.0,1.0
17919,53827,292,0,292,0.0,1.0
17920,53901,14445,10146,4299,0.702,0.298
17921,53910,3508,0,3508,0.0,1.0
17922,53911,1351,0,1351,0.0,1.0
17923,53913,19881,14890,4991,0.749,0.251
17924,53916,22507,17833,4674,0.792,0.208
17925,53919,2629,0,2629,0.0,1.0
17926,53920,414,0,414,0.0,1.0
17927,53922,1036,0,1036,0.0,1.0
17928,53923,2098,0,2098,0.0,1.0
17929,53924,1360,0,1360,0.0,1.0
17930,53925,7781,4920,2861,0.632,0.368
17931,53926,1628,0,1628,0.0,1.0
17932,53928,128,0,128,0.0,1.0
17933,53929,2782,0,2782,0.0,1.0
17934,53930,1285,0,1285,0.0,1.0
17935,53931,237,0,237,0.0,1.0
17936,53932,2573,1703,870,0.662,0.338
17937,53933,4117,0,4117,0.0,1.0
17938,53934,4396,0,4396,0.0,1.0
17939,53935,307,0,307,0.0,1.0
17940,53936,1610,0,1610,0.0,1.0
17941,53937,1053,0,1053,0.0,1.0
17942,53939,244,0,244,0.0,1.0
17943,53941,2932,0,2932,0.0,1.0
17944,53943,1065,0,1065,0.0,1.0
17945,53944,2224,0,2224,0.0,1.0
17946,53946,4386,0,4386,0.0,1.0
17947,53947,137,0,137,0.0,1.0
17948,53948,8414,4401,4013,0.523,0.477
17949,53949,6011,0,6011,0.0,1.0
17950,53950,5449,0,5449,0.0,1.0
17951,53951,2601,0,2601,0.0,1.0
17952,53952,4377,0,4377,0.0,1.0
17953,53953,282,0,282,0.0,1.0
17954,53954,6926,245,6681,0.035,0.965
17955,53955,5692,0,5692,0.0,1.0
17956,53956,3397,0,3397,0.0,1.0
17957,53959,13384,9190,4194,0.687,0.313
17958,53960,3268,0,3268,0.0,1.0
17959,53961,837,0,837,0.0,1.0
17960,53963,13910,11373,2537,0.818,0.182
17961,53964,3604,0,3604,0.0,1.0
17962,53965,10398,4342,6056,0.418,0.582
17963,53968,2329,0,2329,0.0,1.0
17964,53969,419,0,419,0.0,1.0
17965,54001,8155,2832,5323,0.347,0.653
17966,54002,6278,3977,2301,0.633,0.367
17967,54003,1013,0,1013,0.0,1.0
17968,54004,2317,0,2317,0.0,1.0
17969,54005,3056,0,3056,0.0,1.0
17970,54006,743,0,743,0.0,1.0
17971,54007,1188,0,1188,0.0,1.0
17972,54009,2509,705,1804,0.281,0.719
17973,54010,50,50,0,1.0,0.0
17974,54011,6819,2773,4046,0.407,0.593
17975,54013,3475,0,3475,0.0,1.0
17976,54014,2232,0,2232,0.0,1.0
17977,54015,3586,1854,1732,0.517,0.483
17978,54016,30108,19201,10907,0.638,0.362
17979,54017,16743,8275,8468,0.494,0.506
17980,54020,7260,2888,4372,0.398,0.602
17981,54021,6622,4152,2470,0.627,0.373
17982,54022,22358,15351,7007,0.687,0.313
17983,54023,3833,0,3833,0.0,1.0
17984,54024,4811,0,4811,0.0,1.0
17985,54025,6864,2604,4260,0.379,0.621
17986,54026,1809,0,1809,0.0,1.0
17987,54027,989,0,989,0.0,1.0
17988,54028,2493,0,2493,0.0,1.0
17989,54082,1696,276,1420,0.163,0.837
17990,54101,2751,0,2751,0.0,1.0
17991,54102,875,0,875,0.0,1.0
17992,54103,418,0,418,0.0,1.0
17993,54104,1051,0,1051,0.0,1.0
17994,54106,4997,0,4997,0.0,1.0
17995,54107,3727,78,3649,0.021,0.979
17996,54110,5338,2968,2370,0.556,0.444
17997,54111,2132,515,1617,0.242,0.758
17998,54112,2284,0,2284,0.0,1.0
17999,54113,3325,3325,0,1.0,0.0
18000,54114,5178,0,5178,0.0,1.0
18001,54115,41178,31938,9240,0.776,0.224
18002,54119,1083,0,1083,0.0,1.0
18003,54120,245,0,245,0.0,1.0
18004,54121,2982,0,2982,0.0,1.0
18005,54123,238,0,238,0.0,1.0
18006,54124,3881,0,3881,0.0,1.0
18007,54125,519,0,519,0.0,1.0
18008,54126,3625,0,3625,0.0,1.0
18009,54127,76,0,76,0.0,1.0
18010,54128,1778,0,1778,0.0,1.0
18011,54129,3477,0,3477,0.0,1.0
18012,54130,25108,16899,8209,0.673,0.327
18013,54135,3096,0,3096,0.0,1.0
18014,54136,6406,6406,0,1.0,0.0
18015,54137,1115,0,1115,0.0,1.0
18016,54138,821,0,821,0.0,1.0
18017,54139,3096,0,3096,0.0,1.0
18018,54140,8533,8533,0,1.0,0.0
18019,54141,2549,132,2417,0.052,0.948
18020,54143,15225,10862,4363,0.713,0.287
18021,54149,1184,0,1184,0.0,1.0
18022,54150,1037,0,1037,0.0,1.0
18023,54151,3556,1634,1922,0.46,0.54
18024,54153,7252,4273,2979,0.589,0.411
18025,54154,5548,2621,2927,0.472,0.528
18026,54155,5451,1615,3836,0.296,0.704
18027,54156,1535,0,1535,0.0,1.0
18028,54157,5986,3440,2546,0.575,0.425
18029,54159,1434,0,1434,0.0,1.0
18030,54160,253,0,253,0.0,1.0
18031,54161,2696,0,2696,0.0,1.0
18032,54162,9065,3363,5702,0.371,0.629
18033,54165,7539,3500,4039,0.464,0.536
18034,54166,17002,9934,7068,0.584,0.416
18035,54169,2600,2475,125,0.952,0.048
18036,54170,3730,0,3730,0.0,1.0
18037,54171,3362,0,3362,0.0,1.0
18038,54173,4095,2358,1737,0.576,0.424
18039,54174,3013,0,3013,0.0,1.0
18040,54175,1018,0,1018,0.0,1.0
18041,54177,2898,0,2898,0.0,1.0
18042,54180,2861,2524,337,0.882,0.118
18043,54201,5345,3070,2275,0.574,0.426
18044,54202,1240,0,1240,0.0,1.0
18045,54204,1819,0,1819,0.0,1.0
18046,54205,2177,0,2177,0.0,1.0
18047,54207,176,0,176,0.0,1.0
18048,54208,6061,0,6061,0.0,1.0
18049,54209,1195,0,1195,0.0,1.0
18050,54210,897,0,897,0.0,1.0
18051,54211,277,0,277,0.0,1.0
18052,54212,997,0,997,0.0,1.0
18053,54213,1276,0,1276,0.0,1.0
18054,54214,334,0,334,0.0,1.0
18055,54216,6276,2622,3654,0.418,0.582
18056,54217,7405,0,7405,0.0,1.0
18057,54220,40220,34405,5815,0.855,0.145
18058,54227,1568,0,1568,0.0,1.0
18059,54228,2682,0,2682,0.0,1.0
18060,54229,4306,912,3394,0.212,0.788
18061,54230,4782,0,4782,0.0,1.0
18062,54232,779,0,779,0.0,1.0
18063,54234,1614,0,1614,0.0,1.0
18064,54235,17203,8617,8586,0.501,0.499
18065,54241,14884,11955,2929,0.803,0.197
18066,54245,2259,0,2259,0.0,1.0
18067,54246,708,0,708,0.0,1.0
18068,54247,2339,0,2339,0.0,1.0
18069,54301,22742,22742,0,1.0,0.0
18070,54302,30611,30611,0,1.0,0.0
18071,54303,27041,26995,46,0.998,0.002
18072,54304,28153,28153,0,1.0,0.0
18073,54307,1092,1092,0,1.0,0.0
18074,54311,33580,29491,4089,0.878,0.122
18075,54313,35897,30481,5416,0.849,0.151
18076,54401,30702,24926,5776,0.812,0.188
18077,54403,24272,19155,5117,0.789,0.211
18078,54405,3032,2138,894,0.705,0.295
18079,54406,3469,0,3469,0.0,1.0
18080,54407,1515,0,1515,0.0,1.0
18081,54408,1068,0,1068,0.0,1.0
18082,54409,13238,8158,5080,0.616,0.384
18083,54410,2392,0,2392,0.0,1.0
18084,54411,5406,0,5406,0.0,1.0
18085,54412,2181,0,2181,0.0,1.0
18086,54413,191,0,191,0.0,1.0
18087,54414,3404,0,3404,0.0,1.0
18088,54416,1684,0,1684,0.0,1.0
18089,54417,46,0,46,0.0,1.0
18090,54418,1080,0,1080,0.0,1.0
18091,54420,1307,0,1307,0.0,1.0
18092,54421,3455,1828,1627,0.529,0.471
18093,54422,1209,0,1209,0.0,1.0
18094,54423,2343,0,2343,0.0,1.0
18095,54424,1651,0,1651,0.0,1.0
18096,54425,2036,0,2036,0.0,1.0
18097,54426,4479,0,4479,0.0,1.0
18098,54427,1099,0,1099,0.0,1.0
18099,54428,1127,0,1127,0.0,1.0
18100,54430,135,0,135,0.0,1.0
18101,54433,1845,0,1845,0.0,1.0
18102,54435,2010,0,2010,0.0,1.0
18103,54436,2203,0,2203,0.0,1.0
18104,54437,3077,0,3077,0.0,1.0
18105,54440,2964,0,2964,0.0,1.0
18106,54441,828,562,266,0.679,0.321
18107,54442,1177,0,1177,0.0,1.0
18108,54443,2137,0,2137,0.0,1.0
18109,54446,3123,0,3123,0.0,1.0
18110,54447,498,0,498,0.0,1.0
18111,54448,4249,0,4249,0.0,1.0
18112,54449,26418,18859,7559,0.714,0.286
18113,54450,436,0,436,0.0,1.0
18114,54451,11755,4046,7709,0.344,0.656
18115,54452,19360,10282,9078,0.531,0.469
18116,54454,1279,0,1279,0.0,1.0
18117,54455,17029,9327,7702,0.548,0.452
18118,54456,6085,0,6085,0.0,1.0
18119,54457,8539,2253,6286,0.264,0.736
18120,54458,124,0,124,0.0,1.0
18121,54459,1148,0,1148,0.0,1.0
18122,54460,2746,0,2746,0.0,1.0
18123,54462,348,0,348,0.0,1.0
18124,54463,684,0,684,0.0,1.0
18125,54465,536,0,536,0.0,1.0
18126,54466,2815,0,2815,0.0,1.0
18127,54467,13635,11862,1773,0.87,0.13
18128,54469,1792,1726,66,0.963,0.037
18129,54470,2068,0,2068,0.0,1.0
18130,54471,1854,44,1810,0.024,0.976
18131,54473,2700,0,2700,0.0,1.0
18132,54474,4019,4019,0,1.0,0.0
18133,54475,1482,0,1482,0.0,1.0
18134,54476,18580,17161,1419,0.924,0.076
18135,54479,4119,0,4119,0.0,1.0
18136,54480,1332,0,1332,0.0,1.0
18137,54481,29340,27382,1958,0.933,0.067
18138,54482,8955,4979,3976,0.556,0.444
18139,54484,4984,0,4984,0.0,1.0
18140,54485,322,0,322,0.0,1.0
18141,54486,2290,0,2290,0.0,1.0
18142,54487,9594,2926,6668,0.305,0.695
18143,54488,1262,0,1262,0.0,1.0
18144,54489,1550,0,1550,0.0,1.0
18145,54490,893,0,893,0.0,1.0
18146,54491,1652,0,1652,0.0,1.0
18147,54493,668,0,668,0.0,1.0
18148,54494,27126,20149,6977,0.743,0.257
18149,54495,7637,5041,2596,0.66,0.34
18150,54498,2421,0,2421,0.0,1.0
18151,54499,3223,0,3223,0.0,1.0
18152,54501,20019,9010,11009,0.45,0.55
18153,54511,1216,0,1216,0.0,1.0
18154,54512,833,0,833,0.0,1.0
18155,54513,478,0,478,0.0,1.0
18156,54514,1717,0,1717,0.0,1.0
18157,54515,472,0,472,0.0,1.0
18158,54517,112,0,112,0.0,1.0
18159,54519,1231,0,1231,0.0,1.0
18160,54520,4141,0,4141,0.0,1.0
18161,54521,7509,0,7509,0.0,1.0
18162,54524,670,0,670,0.0,1.0
18163,54525,279,226,53,0.81,0.19
18164,54526,919,0,919,0.0,1.0
18165,54527,1081,0,1081,0.0,1.0
18166,54529,1133,0,1133,0.0,1.0
18167,54530,868,0,868,0.0,1.0
18168,54531,1454,0,1454,0.0,1.0
18169,54534,2459,1281,1178,0.521,0.479
18170,54536,184,0,184,0.0,1.0
18171,54537,561,0,561,0.0,1.0
18172,54538,3137,0,3137,0.0,1.0
18173,54539,1383,0,1383,0.0,1.0
18174,54540,947,0,947,0.0,1.0
18175,54541,1552,0,1552,0.0,1.0
18176,54542,470,0,470,0.0,1.0
18177,54545,736,0,736,0.0,1.0
18178,54546,1266,0,1266,0.0,1.0
18179,54547,1392,0,1392,0.0,1.0
18180,54548,4626,0,4626,0.0,1.0
18181,54550,685,398,287,0.581,0.419
18182,54552,4416,0,4416,0.0,1.0
18183,54554,1120,0,1120,0.0,1.0
18184,54555,4872,0,4872,0.0,1.0
18185,54556,1298,0,1298,0.0,1.0
18186,54557,925,0,925,0.0,1.0
18187,54558,2177,0,2177,0.0,1.0
18188,54559,795,0,795,0.0,1.0
18189,54560,589,0,589,0.0,1.0
18190,54561,35,0,35,0.0,1.0
18191,54562,1948,0,1948,0.0,1.0
18192,54563,720,0,720,0.0,1.0
18193,54564,387,0,387,0.0,1.0
18194,54565,60,0,60,0.0,1.0
18195,54566,1496,0,1496,0.0,1.0
18196,54568,5198,0,5198,0.0,1.0
18197,54601,49282,44274,5008,0.898,0.102
18198,54603,14305,14305,0,1.0,0.0
18199,54610,1624,0,1624,0.0,1.0
18200,54611,1307,0,1307,0.0,1.0
18201,54612,5152,2993,2159,0.581,0.419
18202,54613,1826,0,1826,0.0,1.0
18203,54614,2947,0,2947,0.0,1.0
18204,54615,10742,5677,5065,0.528,0.472
18205,54616,2601,0,2601,0.0,1.0
18206,54618,2262,0,2262,0.0,1.0
18207,54619,3923,0,3923,0.0,1.0
18208,54621,1147,0,1147,0.0,1.0
18209,54622,2121,0,2121,0.0,1.0
18210,54623,1930,0,1930,0.0,1.0
18211,54624,1383,0,1383,0.0,1.0
18212,54625,240,0,240,0.0,1.0
18213,54626,1215,0,1215,0.0,1.0
18214,54627,1819,0,1819,0.0,1.0
18215,54628,1092,0,1092,0.0,1.0
18216,54629,2576,0,2576,0.0,1.0
18217,54630,3770,0,3770,0.0,1.0
18218,54631,1844,0,1844,0.0,1.0
18219,54632,1247,0,1247,0.0,1.0
18220,54634,4258,0,4258,0.0,1.0
18221,54635,1799,0,1799,0.0,1.0
18222,54636,13737,9918,3819,0.722,0.278
18223,54637,187,0,187,0.0,1.0
18224,54638,1487,0,1487,0.0,1.0
18225,54639,2397,0,2397,0.0,1.0
18226,54641,2,0,2,0.0,1.0
18227,54642,2125,0,2125,0.0,1.0
18228,54643,12,0,12,0.0,1.0
18229,54644,1434,0,1434,0.0,1.0
18230,54645,81,0,81,0.0,1.0
18231,54646,3899,0,3899,0.0,1.0
18232,54648,1737,0,1737,0.0,1.0
18233,54650,23377,21471,1906,0.918,0.082
18234,54651,1382,0,1382,0.0,1.0
18235,54652,953,0,953,0.0,1.0
18236,54653,894,0,894,0.0,1.0
18237,54654,153,0,153,0.0,1.0
18238,54655,1778,0,1778,0.0,1.0
18239,54656,17377,9907,7470,0.57,0.43
18240,54657,411,0,411,0.0,1.0
18241,54658,2501,233,2268,0.093,0.907
18242,54659,1409,0,1409,0.0,1.0
18243,54660,15688,9002,6686,0.574,0.426
18244,54661,3415,0,3415,0.0,1.0
18245,54664,1516,0,1516,0.0,1.0
18246,54665,8427,4097,4330,0.486,0.514
18247,54666,2593,0,2593,0.0,1.0
18248,54667,4599,0,4599,0.0,1.0
18249,54669,7619,5309,2310,0.697,0.303
18250,54670,1878,0,1878,0.0,1.0
18251,54701,38803,33205,5598,0.856,0.144
18252,54703,42272,38138,4134,0.902,0.098
18253,54720,7039,7037,2,1.0,0.0
18254,54721,1373,0,1373,0.0,1.0
18255,54722,4016,0,4016,0.0,1.0
18256,54723,1191,0,1191,0.0,1.0
18257,54724,7174,3348,3826,0.467,0.533
18258,54725,2897,0,2897,0.0,1.0
18259,54726,1690,0,1690,0.0,1.0
18260,54727,4915,79,4836,0.016,0.984
18261,54728,6139,2700,3439,0.44,0.56
18262,54729,31469,24393,7076,0.775,0.225
18263,54730,4903,401,4502,0.082,0.918
18264,54731,802,0,802,0.0,1.0
18265,54732,2924,0,2924,0.0,1.0
18266,54733,1340,0,1340,0.0,1.0
18267,54734,856,0,856,0.0,1.0
18268,54736,4127,0,4127,0.0,1.0
18269,54737,487,0,487,0.0,1.0
18270,54738,3149,0,3149,0.0,1.0
18271,54739,4950,0,4950,0.0,1.0
18272,54740,2056,0,2056,0.0,1.0
18273,54741,1577,0,1577,0.0,1.0
18274,54742,4459,0,4459,0.0,1.0
18275,54745,2261,0,2261,0.0,1.0
18276,54746,746,0,746,0.0,1.0
18277,54747,2534,0,2534,0.0,1.0
18278,54748,1217,0,1217,0.0,1.0
18279,54749,1231,0,1231,0.0,1.0
18280,54750,1062,0,1062,0.0,1.0
18281,54751,25642,17443,8199,0.68,0.32
18282,54754,1552,0,1552,0.0,1.0
18283,54755,7502,0,7502,0.0,1.0
18284,54756,916,0,916,0.0,1.0
18285,54757,3314,0,3314,0.0,1.0
18286,54758,4626,0,4626,0.0,1.0
18287,54759,1533,0,1533,0.0,1.0
18288,54760,255,0,255,0.0,1.0
18289,54761,1216,0,1216,0.0,1.0
18290,54762,1246,0,1246,0.0,1.0
18291,54763,1134,0,1134,0.0,1.0
18292,54765,24,0,24,0.0,1.0
18293,54766,1707,0,1707,0.0,1.0
18294,54767,3221,0,3221,0.0,1.0
18295,54768,5990,3447,2543,0.575,0.425
18296,54769,502,0,502,0.0,1.0
18297,54770,2101,0,2101,0.0,1.0
18298,54771,4286,0,4286,0.0,1.0
18299,54772,1103,0,1103,0.0,1.0
18300,54773,3336,0,3336,0.0,1.0
18301,54801,6493,2673,3820,0.412,0.588
18302,54805,1471,0,1471,0.0,1.0
18303,54806,11810,7293,4517,0.618,0.382
18304,54810,2512,0,2512,0.0,1.0
18305,54812,5728,3292,2436,0.575,0.425
18306,54813,601,0,601,0.0,1.0
18307,54814,2478,0,2478,0.0,1.0
18308,54817,2188,0,2188,0.0,1.0
18309,54819,2544,0,2544,0.0,1.0
18310,54820,864,0,864,0.0,1.0
18311,54821,1276,0,1276,0.0,1.0
18312,54822,4516,137,4379,0.03,0.97
18313,54824,2271,0,2271,0.0,1.0
18314,54826,807,0,807,0.0,1.0
18315,54827,221,0,221,0.0,1.0
18316,54828,678,0,678,0.0,1.0
18317,54829,5236,0,5236,0.0,1.0
18318,54830,2752,0,2752,0.0,1.0
18319,54832,412,0,412,0.0,1.0
18320,54835,1018,0,1018,0.0,1.0
18321,54836,1080,0,1080,0.0,1.0
18322,54837,3778,0,3778,0.0,1.0
18323,54838,1103,0,1103,0.0,1.0
18324,54839,302,0,302,0.0,1.0
18325,54840,4643,0,4643,0.0,1.0
18326,54841,259,0,259,0.0,1.0
18327,54842,185,0,185,0.0,1.0
18328,54843,11487,2616,8871,0.228,0.772
18329,54844,267,0,267,0.0,1.0
18330,54845,147,0,147,0.0,1.0
18331,54846,547,0,547,0.0,1.0
18332,54847,2222,0,2222,0.0,1.0
18333,54848,6141,3449,2692,0.562,0.438
18334,54849,1967,0,1967,0.0,1.0
18335,54850,261,0,261,0.0,1.0
18336,54853,4009,0,4009,0.0,1.0
18337,54854,990,0,990,0.0,1.0
18338,54855,774,0,774,0.0,1.0
18339,54856,1616,0,1616,0.0,1.0
18340,54857,62,0,62,0.0,1.0
18341,54858,1518,0,1518,0.0,1.0
18342,54859,1896,0,1896,0.0,1.0
18343,54861,150,0,150,0.0,1.0
18344,54862,261,0,261,0.0,1.0
18345,54864,1322,0,1322,0.0,1.0
18346,54865,440,0,440,0.0,1.0
18347,54867,435,0,435,0.0,1.0
18348,54868,15512,9500,6012,0.612,0.388
18349,54870,1486,0,1486,0.0,1.0
18350,54871,3105,0,3105,0.0,1.0
18351,54872,2581,0,2581,0.0,1.0
18352,54873,2799,0,2799,0.0,1.0
18353,54874,3646,142,3504,0.039,0.961
18354,54875,1055,0,1055,0.0,1.0
18355,54876,1551,0,1551,0.0,1.0
18356,54880,30772,26903,3869,0.874,0.126
18357,54888,1345,0,1345,0.0,1.0
18358,54889,2742,0,2742,0.0,1.0
18359,54891,3389,0,3389,0.0,1.0
18360,54893,3767,0,3767,0.0,1.0
18361,54895,910,0,910,0.0,1.0
18362,54896,1478,0,1478,0.0,1.0
18363,54901,37710,37274,436,0.988,0.012
18364,54902,22375,20454,1921,0.914,0.086
18365,54904,20623,16388,4235,0.795,0.205
18366,54909,2181,0,2181,0.0,1.0
18367,54911,26674,26674,0,1.0,0.0
18368,54913,17629,10880,6749,0.617,0.383
18369,54914,30475,30200,275,0.991,0.009
18370,54915,41855,41772,83,0.998,0.002
18371,54921,1326,0,1326,0.0,1.0
18372,54922,1514,0,1514,0.0,1.0
18373,54923,8733,4891,3842,0.56,0.44
18374,54927,538,538,0,1.0,0.0
18375,54928,450,0,450,0.0,1.0
18376,54929,8746,4481,4265,0.512,0.488
18377,54930,1786,0,1786,0.0,1.0
18378,54931,260,0,260,0.0,1.0
18379,54932,1185,0,1185,0.0,1.0
18380,54933,231,0,231,0.0,1.0
18381,54934,148,0,148,0.0,1.0
18382,54935,41651,41450,201,0.995,0.005
18383,54937,19112,11805,7307,0.618,0.382
18384,54940,4020,0,4020,0.0,1.0
18385,54941,2613,0,2613,0.0,1.0
18386,54942,8580,6419,2161,0.748,0.252
18387,54943,1923,0,1923,0.0,1.0
18388,54944,8257,98,8159,0.012,0.988
18389,54945,3545,0,3545,0.0,1.0
18390,54946,108,108,0,1.0,0.0
18391,54947,2601,0,2601,0.0,1.0
18392,54948,320,0,320,0.0,1.0
18393,54949,3430,0,3430,0.0,1.0
18394,54950,3083,0,3083,0.0,1.0
18395,54952,25729,24940,789,0.969,0.031
18396,54956,42696,37533,5163,0.879,0.121
18397,54960,2800,0,2800,0.0,1.0
18398,54961,14266,7643,6623,0.536,0.464
18399,54962,1110,0,1110,0.0,1.0
18400,54963,6917,3358,3559,0.485,0.515
18401,54964,1022,0,1022,0.0,1.0
18402,54965,1344,0,1344,0.0,1.0
18403,54966,2008,0,2008,0.0,1.0
18404,54967,434,0,434,0.0,1.0
18405,54968,2779,0,2779,0.0,1.0
18406,54970,3902,0,3902,0.0,1.0
18407,54971,10827,7930,2897,0.732,0.268
18408,54974,1581,0,1581,0.0,1.0
18409,54977,1337,0,1337,0.0,1.0
18410,54979,1472,117,1355,0.079,0.921
18411,54980,149,0,149,0.0,1.0
18412,54981,15426,7647,7779,0.496,0.504
18413,54982,7117,2573,4544,0.362,0.638
18414,54983,4642,0,4642,0.0,1.0
18415,54984,2989,0,2989,0.0,1.0
18416,54985,836,836,0,1.0,0.0
18417,54986,4770,2991,1779,0.627,0.373
18418,55001,2916,0,2916,0.0,1.0
18419,55003,3471,3471,0,1.0,0.0
18420,55005,4422,187,4235,0.042,0.958
18421,55006,4069,0,4069,0.0,1.0
18422,55007,2498,0,2498,0.0,1.0
18423,55008,14685,8914,5771,0.607,0.393
18424,55009,8030,3931,4099,0.49,0.51
18425,55011,10170,1435,8735,0.141,0.859
18426,55012,2078,626,1452,0.301,0.699
18427,55013,6541,3581,2960,0.547,0.453
18428,55014,27274,26492,782,0.971,0.029
18429,55016,34204,32477,1727,0.95,0.05
18430,55017,714,0,714,0.0,1.0
18431,55018,997,0,997,0.0,1.0
18432,55019,1817,1179,638,0.649,0.351
18433,55020,3717,1896,1821,0.51,0.49
18434,55021,29732,23418,6314,0.788,0.212
18435,55024,32406,29032,3374,0.896,0.104
18436,55025,23244,16376,6868,0.705,0.295
18437,55026,455,0,455,0.0,1.0
18438,55027,3031,0,3031,0.0,1.0
18439,55029,38,0,38,0.0,1.0
18440,55030,1289,0,1289,0.0,1.0
18441,55031,2035,0,2035,0.0,1.0
18442,55032,3616,0,3616,0.0,1.0
18443,55033,29488,22328,7160,0.757,0.243
18444,55036,71,0,71,0.0,1.0
18445,55037,4940,0,4940,0.0,1.0
18446,55038,20816,17489,3327,0.84,0.16
18447,55040,12568,5356,7212,0.426,0.574
18448,55041,7601,5103,2498,0.671,0.329
18449,55042,8840,6195,2645,0.701,0.299
18450,55043,3540,3194,346,0.902,0.098
18451,55044,47218,43303,3915,0.917,0.083
18452,55045,7577,4494,3083,0.593,0.407
18453,55046,5211,3466,1745,0.665,0.335
18454,55047,2528,0,2528,0.0,1.0
18455,55049,2476,0,2476,0.0,1.0
18456,55051,9719,3670,6049,0.378,0.622
18457,55052,2090,12,2078,0.006,0.994
18458,55053,1009,0,1009,0.0,1.0
18459,55054,2171,2012,159,0.927,0.073
18460,55055,3418,3339,79,0.977,0.023
18461,55056,13546,6447,7099,0.476,0.524
18462,55057,24602,20356,4246,0.827,0.173
18463,55060,28911,25394,3517,0.878,0.122
18464,55063,9348,3032,6316,0.324,0.676
18465,55065,1201,0,1201,0.0,1.0
18466,55066,18564,14367,4197,0.774,0.226
18467,55068,27490,26751,739,0.973,0.027
18468,55069,5540,2883,2657,0.52,0.48
18469,55070,7541,4687,2854,0.622,0.378
18470,55071,5569,5303,266,0.952,0.048
18471,55072,4737,0,4737,0.0,1.0
18472,55073,3237,0,3237,0.0,1.0
18473,55074,2222,0,2222,0.0,1.0
18474,55075,20152,20152,0,1.0,0.0
18475,55076,21323,21195,128,0.994,0.006
18476,55077,12572,9910,2662,0.788,0.212
18477,55079,8329,0,8329,0.0,1.0
18478,55080,2607,0,2607,0.0,1.0
18479,55082,35024,24432,10592,0.698,0.302
18480,55084,1628,0,1628,0.0,1.0
18481,55085,417,0,417,0.0,1.0
18482,55087,268,266,2,0.993,0.007
18483,55088,1704,0,1704,0.0,1.0
18484,55089,1814,0,1814,0.0,1.0
18485,55090,401,401,0,1.0,0.0
18486,55092,10840,5933,4907,0.547,0.453
18487,55101,5592,5592,0,1.0,0.0
18488,55102,18207,18207,0,1.0,0.0
18489,55103,12991,12991,0,1.0,0.0
18490,55104,43248,43248,0,1.0,0.0
18491,55105,28455,28455,0,1.0,0.0
18492,55106,52730,52730,0,1.0,0.0
18493,55107,14776,14776,0,1.0,0.0
18494,55108,14688,14688,0,1.0,0.0
18495,55109,31444,31444,0,1.0,0.0
18496,55110,37759,36475,1284,0.966,0.034
18497,55111,0,0,0,,
18498,55112,43250,43250,0,1.0,0.0
18499,55113,38994,38994,0,1.0,0.0
18500,55114,3100,3100,0,1.0,0.0
18501,55115,8607,8130,477,0.945,0.055
18502,55116,23851,23851,0,1.0,0.0
18503,55117,41649,41649,0,1.0,0.0
18504,55118,27548,27548,0,1.0,0.0
18505,55119,38966,38966,0,1.0,0.0
18506,55120,4352,4352,0,1.0,0.0
18507,55121,7861,7813,48,0.994,0.006
18508,55122,30346,30346,0,1.0,0.0
18509,55123,26030,26030,0,1.0,0.0
18510,55124,49084,49084,0,1.0,0.0
18511,55125,43281,43281,0,1.0,0.0
18512,55126,25140,25064,76,0.997,0.003
18513,55127,16782,15847,935,0.944,0.056
18514,55128,28113,28113,0,1.0,0.0
18515,55129,18697,17308,1389,0.926,0.074
18516,55130,17575,17575,0,1.0,0.0
18517,55150,198,198,0,1.0,0.0
18518,55155,0,0,0,,
18519,55301,10535,9676,859,0.918,0.082
18520,55302,7107,3262,3845,0.459,0.541
18521,55303,46352,39400,6952,0.85,0.15
18522,55304,45967,38961,7006,0.848,0.152
18523,55305,19368,19368,0,1.0,0.0
18524,55306,15935,15935,0,1.0,0.0
18525,55307,3227,0,3227,0.0,1.0
18526,55308,9064,3898,5166,0.43,0.57
18527,55309,18208,11385,6823,0.625,0.375
18528,55310,1519,0,1519,0.0,1.0
18529,55311,32788,32432,356,0.989,0.011
18530,55312,1595,0,1595,0.0,1.0
18531,55313,23255,16013,7242,0.689,0.311
18532,55314,1337,0,1337,0.0,1.0
18533,55315,4762,3235,1527,0.679,0.321
18534,55316,23089,23089,0,1.0,0.0
18535,55317,19218,18833,385,0.98,0.02
18536,55318,25493,23260,2233,0.912,0.088
18537,55319,5038,0,5038,0.0,1.0
18538,55320,4973,0,4973,0.0,1.0
18539,55321,5341,2834,2507,0.531,0.469
18540,55322,3163,4,3159,0.001,0.999
18541,55324,1234,0,1234,0.0,1.0
18542,55325,4610,1410,3200,0.306,0.694
18543,55327,3478,2511,967,0.722,0.278
18544,55328,8541,5255,3286,0.615,0.385
18545,55329,2118,0,2118,0.0,1.0
18546,55330,36440,26463,9977,0.726,0.274
18547,55331,17524,17187,337,0.981,0.019
18548,55332,1922,0,1922,0.0,1.0
18549,55333,856,0,856,0.0,1.0
18550,55334,2939,0,2939,0.0,1.0
18551,55335,1629,0,1629,0.0,1.0
18552,55336,8054,5534,2520,0.687,0.313
18553,55337,44356,44356,0,1.0,0.0
18554,55338,1123,0,1123,0.0,1.0
18555,55339,988,0,988,0.0,1.0
18556,55340,6327,1786,4541,0.282,0.718
18557,55341,2850,2505,345,0.879,0.121
18558,55342,2015,0,2015,0.0,1.0
18559,55343,23933,23933,0,1.0,0.0
18560,55344,13952,13952,0,1.0,0.0
18561,55345,21147,21147,0,1.0,0.0
18562,55346,16776,16776,0,1.0,0.0
18563,55347,30069,29095,974,0.968,0.032
18564,55349,3887,0,3887,0.0,1.0
18565,55350,18280,14054,4226,0.769,0.231
18566,55352,8751,5428,3323,0.62,0.38
18567,55353,3162,0,3162,0.0,1.0
18568,55354,2741,0,2741,0.0,1.0
18569,55355,9656,6624,3032,0.686,0.314
18570,55356,5311,3796,1515,0.715,0.285
18571,55357,3246,0,3246,0.0,1.0
18572,55358,4982,0,4982,0.0,1.0
18573,55359,5954,0,5954,0.0,1.0
18574,55360,2672,0,2672,0.0,1.0
18575,55362,18089,14151,3938,0.782,0.218
18576,55363,4496,3362,1134,0.748,0.252
18577,55364,14353,12635,1718,0.88,0.12
18578,55366,443,0,443,0.0,1.0
18579,55367,913,0,913,0.0,1.0
18580,55368,2218,1519,699,0.685,0.315
18581,55369,32524,31647,877,0.973,0.027
18582,55370,802,0,802,0.0,1.0
18583,55371,16442,4942,11500,0.301,0.699
18584,55372,29811,23961,5850,0.804,0.196
18585,55373,5600,4577,1023,0.817,0.183
18586,55374,13576,10730,2846,0.79,0.21
18587,55375,4518,3863,655,0.855,0.145
18588,55376,16242,14003,2239,0.862,0.138
18589,55378,26958,26918,40,0.999,0.001
18590,55379,40416,36586,3830,0.905,0.095
18591,55381,2063,0,2063,0.0,1.0
18592,55382,3563,0,3563,0.0,1.0
18593,55384,1672,1672,0,1.0,0.0
18594,55385,1291,0,1291,0.0,1.0
18595,55386,6330,6060,270,0.957,0.043
18596,55387,12249,10744,1505,0.877,0.123
18597,55388,5619,4185,1434,0.745,0.255
18598,55389,2643,0,2643,0.0,1.0
18599,55390,2473,1108,1365,0.448,0.552
18600,55391,14486,13586,900,0.938,0.062
18601,55395,2892,0,2892,0.0,1.0
18602,55396,2252,0,2252,0.0,1.0
18603,55397,2693,1967,726,0.73,0.27
18604,55398,15540,8110,7430,0.522,0.478
18605,55401,6590,6590,0,1.0,0.0
18606,55402,368,368,0,1.0,0.0
18607,55403,14985,14985,0,1.0,0.0
18608,55404,27121,27121,0,1.0,0.0
18609,55405,15411,15411,0,1.0,0.0
18610,55406,32112,32112,0,1.0,0.0
18611,55407,37881,37881,0,1.0,0.0
18612,55408,29981,29981,0,1.0,0.0
18613,55409,11615,11615,0,1.0,0.0
18614,55410,19340,19340,0,1.0,0.0
18615,55411,27428,27428,0,1.0,0.0
18616,55412,22148,22148,0,1.0,0.0
18617,55413,12934,12934,0,1.0,0.0
18618,55414,28495,28495,0,1.0,0.0
18619,55415,2604,2604,0,1.0,0.0
18620,55416,29027,29027,0,1.0,0.0
18621,55417,24875,24875,0,1.0,0.0
18622,55418,29472,29472,0,1.0,0.0
18623,55419,26406,26406,0,1.0,0.0
18624,55420,21767,21767,0,1.0,0.0
18625,55421,27035,27035,0,1.0,0.0
18626,55422,27820,27820,0,1.0,0.0
18627,55423,35375,35375,0,1.0,0.0
18628,55424,9685,9685,0,1.0,0.0
18629,55425,8952,8952,0,1.0,0.0
18630,55426,24945,24945,0,1.0,0.0
18631,55427,22919,22919,0,1.0,0.0
18632,55428,29357,29357,0,1.0,0.0
18633,55429,26751,26751,0,1.0,0.0
18634,55430,21508,21508,0,1.0,0.0
18635,55431,18435,18435,0,1.0,0.0
18636,55432,30027,30027,0,1.0,0.0
18637,55433,33613,33613,0,1.0,0.0
18638,55434,28823,28823,0,1.0,0.0
18639,55435,11592,11592,0,1.0,0.0
18640,55436,13138,13138,0,1.0,0.0
18641,55437,17484,17484,0,1.0,0.0
18642,55438,16249,16249,0,1.0,0.0
18643,55439,8750,8750,0,1.0,0.0
18644,55441,17848,17848,0,1.0,0.0
18645,55442,13217,13217,0,1.0,0.0
18646,55443,32462,32462,0,1.0,0.0
18647,55444,15667,15667,0,1.0,0.0
18648,55445,9879,9879,0,1.0,0.0
18649,55446,18695,18695,0,1.0,0.0
18650,55447,21187,21187,0,1.0,0.0
18651,55448,27863,27863,0,1.0,0.0
18652,55449,23277,22169,1108,0.952,0.048
18653,55450,10,10,0,1.0,0.0
18654,55454,8125,8125,0,1.0,0.0
18655,55455,1050,1050,0,1.0,0.0
18656,55601,105,0,105,0.0,1.0
18657,55602,177,0,177,0.0,1.0
18658,55603,508,0,508,0.0,1.0
18659,55604,3360,0,3360,0.0,1.0
18660,55605,565,0,565,0.0,1.0
18661,55606,272,0,272,0.0,1.0
18662,55607,134,0,134,0.0,1.0
18663,55609,303,0,303,0.0,1.0
18664,55612,518,0,518,0.0,1.0
18665,55613,205,0,205,0.0,1.0
18666,55614,2627,0,2627,0.0,1.0
18667,55615,256,0,256,0.0,1.0
18668,55616,6994,3588,3406,0.513,0.487
18669,55702,500,0,500,0.0,1.0
18670,55703,701,0,701,0.0,1.0
18671,55704,1128,0,1128,0.0,1.0
18672,55705,3299,0,3299,0.0,1.0
18673,55706,1825,0,1825,0.0,1.0
18674,55707,3440,0,3440,0.0,1.0
18675,55708,959,0,959,0.0,1.0
18676,55709,4075,0,4075,0.0,1.0
18677,55710,1292,0,1292,0.0,1.0
18678,55711,607,0,607,0.0,1.0
18679,55712,586,0,586,0.0,1.0
18680,55713,1017,0,1017,0.0,1.0
18681,55716,341,0,341,0.0,1.0
18682,55717,335,0,335,0.0,1.0
18683,55718,3281,547,2734,0.167,0.833
18684,55719,5895,4472,1423,0.759,0.241
18685,55720,16999,11262,5737,0.663,0.337
18686,55721,3410,379,3031,0.111,0.889
18687,55722,1200,0,1200,0.0,1.0
18688,55723,2363,0,2363,0.0,1.0
18689,55724,741,0,741,0.0,1.0
18690,55725,103,0,103,0.0,1.0
18691,55726,1045,0,1045,0.0,1.0
18692,55731,5820,3459,2361,0.594,0.406
18693,55732,1453,0,1453,0.0,1.0
18694,55733,4616,1127,3489,0.244,0.756
18695,55734,6213,3034,3179,0.488,0.512
18696,55735,1809,0,1809,0.0,1.0
18697,55736,1550,0,1550,0.0,1.0
18698,55738,544,0,544,0.0,1.0
18699,55741,3164,0,3164,0.0,1.0
18700,55742,344,0,344,0.0,1.0
18701,55744,20164,8906,11258,0.442,0.558
18702,55746,17228,11766,5462,0.683,0.317
18703,55748,1476,0,1476,0.0,1.0
18704,55749,449,0,449,0.0,1.0
18705,55750,2025,0,2025,0.0,1.0
18706,55751,1553,0,1553,0.0,1.0
18707,55752,395,0,395,0.0,1.0
18708,55753,989,0,989,0.0,1.0
18709,55756,431,0,431,0.0,1.0
18710,55757,866,0,866,0.0,1.0
18711,55758,145,0,145,0.0,1.0
18712,55760,3108,0,3108,0.0,1.0
18713,55763,554,0,554,0.0,1.0
18714,55764,569,0,569,0.0,1.0
18715,55765,802,0,802,0.0,1.0
18716,55766,43,0,43,0.0,1.0
18717,55767,4532,3068,1464,0.677,0.323
18718,55768,2843,1155,1688,0.406,0.594
18719,55769,2313,0,2313,0.0,1.0
18720,55771,1680,0,1680,0.0,1.0
18721,55772,76,0,76,0.0,1.0
18722,55775,1205,0,1205,0.0,1.0
18723,55779,3755,0,3755,0.0,1.0
18724,55780,212,0,212,0.0,1.0
18725,55781,734,0,734,0.0,1.0
18726,55782,480,0,480,0.0,1.0
18727,55783,2437,12,2425,0.005,0.995
18728,55784,89,0,89,0.0,1.0
18729,55785,263,0,263,0.0,1.0
18730,55786,305,0,305,0.0,1.0
18731,55787,525,0,525,0.0,1.0
18732,55790,1866,0,1866,0.0,1.0
18733,55792,10107,8694,1413,0.86,0.14
18734,55793,615,0,615,0.0,1.0
18735,55795,1629,0,1629,0.0,1.0
18736,55797,1441,0,1441,0.0,1.0
18737,55798,581,0,581,0.0,1.0
18738,55802,2442,2442,0,1.0,0.0
18739,55803,17431,8734,8697,0.501,0.499
18740,55804,14592,10481,4111,0.718,0.282
18741,55805,10194,10194,0,1.0,0.0
18742,55806,9576,9576,0,1.0,0.0
18743,55807,9963,9963,0,1.0,0.0
18744,55808,5846,5480,366,0.937,0.063
18745,55810,8702,5094,3608,0.585,0.415
18746,55811,26246,19673,6573,0.75,0.25
18747,55812,10924,10924,0,1.0,0.0
18748,55814,772,772,0,1.0,0.0
18749,55901,51917,49507,2410,0.954,0.046
18750,55902,21968,20073,1895,0.914,0.086
18751,55904,26332,22192,4140,0.843,0.157
18752,55905,0,0,0,,
18753,55906,17598,15584,2014,0.886,0.114
18754,55909,1428,0,1428,0.0,1.0
18755,55910,1423,0,1423,0.0,1.0
18756,55912,28483,25103,3380,0.881,0.119
18757,55917,3696,0,3696,0.0,1.0
18758,55918,982,0,982,0.0,1.0
18759,55919,985,0,985,0.0,1.0
18760,55920,7026,4864,2162,0.692,0.308
18761,55921,4964,2749,2215,0.554,0.446
18762,55922,1021,0,1021,0.0,1.0
18763,55923,4469,2604,1865,0.583,0.417
18764,55924,1303,0,1303,0.0,1.0
18765,55925,1113,0,1113,0.0,1.0
18766,55926,853,0,853,0.0,1.0
18767,55927,4071,2641,1430,0.649,0.351
18768,55929,1209,0,1209,0.0,1.0
18769,55931,330,0,330,0.0,1.0
18770,55932,2042,0,2042,0.0,1.0
18771,55933,273,0,273,0.0,1.0
18772,55934,3338,0,3338,0.0,1.0
18773,55935,939,0,939,0.0,1.0
18774,55936,1861,0,1861,0.0,1.0
18775,55939,1963,0,1963,0.0,1.0
18776,55940,2666,0,2666,0.0,1.0
18777,55941,969,0,969,0.0,1.0
18778,55943,3059,0,3059,0.0,1.0
18779,55944,7151,5917,1234,0.827,0.173
18780,55945,1458,0,1458,0.0,1.0
18781,55946,3178,0,3178,0.0,1.0
18782,55947,7513,5358,2155,0.713,0.287
18783,55949,1808,0,1808,0.0,1.0
18784,55950,169,0,169,0.0,1.0
18785,55951,1567,0,1567,0.0,1.0
18786,55952,2529,0,2529,0.0,1.0
18787,55953,894,0,894,0.0,1.0
18788,55954,1442,0,1442,0.0,1.0
18789,55955,2746,1131,1615,0.412,0.588
18790,55956,1962,0,1962,0.0,1.0
18791,55957,756,0,756,0.0,1.0
18792,55959,2321,1525,796,0.657,0.343
18793,55960,3134,321,2813,0.102,0.898
18794,55961,447,0,447,0.0,1.0
18795,55962,763,0,763,0.0,1.0
18796,55963,4988,2945,2043,0.59,0.41
18797,55964,4389,3329,1060,0.758,0.242
18798,55965,2376,0,2376,0.0,1.0
18799,55967,938,0,938,0.0,1.0
18800,55968,121,0,121,0.0,1.0
18801,55969,1117,0,1117,0.0,1.0
18802,55970,1016,0,1016,0.0,1.0
18803,55971,2993,0,2993,0.0,1.0
18804,55972,4995,2977,2018,0.596,0.404
18805,55973,285,0,285,0.0,1.0
18806,55974,2132,0,2132,0.0,1.0
18807,55975,4335,0,4335,0.0,1.0
18808,55976,7582,5877,1705,0.775,0.225
18809,55977,203,0,203,0.0,1.0
18810,55979,1143,0,1143,0.0,1.0
18811,55981,3961,0,3961,0.0,1.0
18812,55982,436,0,436,0.0,1.0
18813,55983,1588,0,1588,0.0,1.0
18814,55985,1858,0,1858,0.0,1.0
18815,55987,35629,29187,6442,0.819,0.181
18816,55990,925,0,925,0.0,1.0
18817,55991,1490,0,1490,0.0,1.0
18818,55992,4693,3161,1532,0.674,0.326
18819,56001,46327,41847,4480,0.903,0.097
18820,56003,14335,13344,991,0.931,0.069
18821,56007,21228,17868,3360,0.842,0.158
18822,56009,1613,0,1613,0.0,1.0
18823,56010,1129,0,1129,0.0,1.0
18824,56011,8925,6174,2751,0.692,0.308
18825,56013,4531,3257,1274,0.719,0.281
18826,56014,797,0,797,0.0,1.0
18827,56016,1096,0,1096,0.0,1.0
18828,56017,1620,0,1620,0.0,1.0
18829,56019,914,0,914,0.0,1.0
18830,56020,115,0,115,0.0,1.0
18831,56021,1038,0,1038,0.0,1.0
18832,56022,70,0,70,0.0,1.0
18833,56023,485,0,485,0.0,1.0
18834,56024,2759,2393,366,0.867,0.133
18835,56025,507,0,507,0.0,1.0
18836,56026,2012,0,2012,0.0,1.0
18837,56027,969,0,969,0.0,1.0
18838,56028,1372,0,1372,0.0,1.0
18839,56029,744,0,744,0.0,1.0
18840,56031,12401,9578,2823,0.772,0.228
18841,56032,313,0,313,0.0,1.0
18842,56033,345,0,345,0.0,1.0
18843,56034,496,0,496,0.0,1.0
18844,56035,546,0,546,0.0,1.0
18845,56036,1959,0,1959,0.0,1.0
18846,56037,1635,0,1635,0.0,1.0
18847,56039,957,0,957,0.0,1.0
18848,56041,1066,0,1066,0.0,1.0
18849,56042,720,0,720,0.0,1.0
18850,56043,486,0,486,0.0,1.0
18851,56044,2082,0,2082,0.0,1.0
18852,56045,813,0,813,0.0,1.0
18853,56046,94,0,94,0.0,1.0
18854,56047,117,0,117,0.0,1.0
18855,56048,3898,0,3898,0.0,1.0
18856,56050,1464,511,953,0.349,0.651
18857,56051,703,0,703,0.0,1.0
18858,56052,699,0,699,0.0,1.0
18859,56054,923,0,923,0.0,1.0
18860,56055,3902,2558,1344,0.656,0.344
18861,56056,96,0,96,0.0,1.0
18862,56057,3867,0,3867,0.0,1.0
18863,56058,5985,3763,2222,0.629,0.371
18864,56060,452,0,452,0.0,1.0
18865,56062,3208,0,3208,0.0,1.0
18866,56063,2724,0,2724,0.0,1.0
18867,56065,2844,0,2844,0.0,1.0
18868,56068,1087,0,1087,0.0,1.0
18869,56069,4467,2586,1881,0.579,0.421
18870,56071,11817,7850,3967,0.664,0.336
18871,56072,2389,0,2389,0.0,1.0
18872,56073,16759,13367,3392,0.798,0.202
18873,56074,2004,0,2004,0.0,1.0
18874,56075,171,0,171,0.0,1.0
18875,56078,476,0,476,0.0,1.0
18876,56080,770,0,770,0.0,1.0
18877,56081,6098,4585,1513,0.752,0.248
18878,56082,13597,11123,2474,0.818,0.182
18879,56083,874,0,874,0.0,1.0
18880,56085,5451,3479,1972,0.638,0.362
18881,56087,3179,0,3179,0.0,1.0
18882,56088,1946,0,1946,0.0,1.0
18883,56089,155,0,155,0.0,1.0
18884,56090,694,0,694,0.0,1.0
18885,56091,367,0,367,0.0,1.0
18886,56093,12831,9537,3294,0.743,0.257
18887,56096,3021,0,3021,0.0,1.0
18888,56097,3715,0,3715,0.0,1.0
18889,56098,2124,0,2124,0.0,1.0
18890,56101,5867,4409,1458,0.751,0.249
18891,56110,1843,0,1843,0.0,1.0
18892,56111,420,0,420,0.0,1.0
18893,56113,238,0,238,0.0,1.0
18894,56114,361,0,361,0.0,1.0
18895,56115,1366,0,1366,0.0,1.0
18896,56116,628,0,628,0.0,1.0
18897,56117,399,0,399,0.0,1.0
18898,56118,421,0,421,0.0,1.0
18899,56119,1017,0,1017,0.0,1.0
18900,56120,1121,0,1121,0.0,1.0
18901,56121,659,0,659,0.0,1.0
18902,56122,586,0,586,0.0,1.0
18903,56123,514,0,514,0.0,1.0
18904,56125,65,0,65,0.0,1.0
18905,56127,398,0,398,0.0,1.0
18906,56128,1984,0,1984,0.0,1.0
18907,56129,741,0,741,0.0,1.0
18908,56131,2293,0,2293,0.0,1.0
18909,56132,540,0,540,0.0,1.0
18910,56134,462,0,462,0.0,1.0
18911,56136,1118,0,1118,0.0,1.0
18912,56137,1149,0,1149,0.0,1.0
18913,56138,899,0,899,0.0,1.0
18914,56139,430,0,430,0.0,1.0
18915,56140,59,0,59,0.0,1.0
18916,56141,323,0,323,0.0,1.0
18917,56142,981,0,981,0.0,1.0
18918,56143,4478,3169,1309,0.708,0.292
18919,56144,1143,0,1143,0.0,1.0
18920,56145,622,0,622,0.0,1.0
18921,56146,40,0,40,0.0,1.0
18922,56147,192,0,192,0.0,1.0
18923,56149,1268,0,1268,0.0,1.0
18924,56150,2742,0,2742,0.0,1.0
18925,56151,823,0,823,0.0,1.0
18926,56152,1507,0,1507,0.0,1.0
18927,56153,224,0,224,0.0,1.0
18928,56155,419,0,419,0.0,1.0
18929,56156,6066,4620,1446,0.762,0.238
18930,56157,788,0,788,0.0,1.0
18931,56158,434,0,434,0.0,1.0
18932,56159,2928,0,2928,0.0,1.0
18933,56160,214,0,214,0.0,1.0
18934,56161,400,0,400,0.0,1.0
18935,56162,285,0,285,0.0,1.0
18936,56164,5969,4098,1871,0.687,0.313
18937,56165,349,0,349,0.0,1.0
18938,56166,253,0,253,0.0,1.0
18939,56167,661,0,661,0.0,1.0
18940,56168,932,0,932,0.0,1.0
18941,56169,681,0,681,0.0,1.0
18942,56170,587,0,587,0.0,1.0
18943,56171,1821,0,1821,0.0,1.0
18944,56172,3164,0,3164,0.0,1.0
18945,56173,424,0,424,0.0,1.0
18946,56174,357,0,357,0.0,1.0
18947,56175,3085,0,3085,0.0,1.0
18948,56176,1137,0,1137,0.0,1.0
18949,56177,45,0,45,0.0,1.0
18950,56178,1746,0,1746,0.0,1.0
18951,56180,1408,0,1408,0.0,1.0
18952,56181,1147,0,1147,0.0,1.0
18953,56183,1263,0,1263,0.0,1.0
18954,56185,560,0,560,0.0,1.0
18955,56186,388,0,388,0.0,1.0
18956,56187,14170,12616,1554,0.89,0.11
18957,56201,23173,20244,2929,0.874,0.126
18958,56207,251,0,251,0.0,1.0
18959,56208,2066,0,2066,0.0,1.0
18960,56209,2339,0,2339,0.0,1.0
18961,56210,13,0,13,0.0,1.0
18962,56211,529,0,529,0.0,1.0
18963,56212,531,0,531,0.0,1.0
18964,56214,725,0,725,0.0,1.0
18965,56215,4693,3191,1502,0.68,0.32
18966,56216,670,0,670,0.0,1.0
18967,56218,628,0,628,0.0,1.0
18968,56219,1082,0,1082,0.0,1.0
18969,56220,3070,0,3070,0.0,1.0
18970,56221,773,0,773,0.0,1.0
18971,56222,1984,0,1984,0.0,1.0
18972,56223,1408,0,1408,0.0,1.0
18973,56224,333,0,333,0.0,1.0
18974,56225,834,0,834,0.0,1.0
18975,56226,254,0,254,0.0,1.0
18976,56227,223,0,223,0.0,1.0
18977,56228,882,0,882,0.0,1.0
18978,56229,1871,0,1871,0.0,1.0
18979,56230,854,0,854,0.0,1.0
18980,56231,390,0,390,0.0,1.0
18981,56232,2415,0,2415,0.0,1.0
18982,56235,579,0,579,0.0,1.0
18983,56236,359,0,359,0.0,1.0
18984,56237,600,0,600,0.0,1.0
18985,56239,596,0,596,0.0,1.0
18986,56240,1042,0,1042,0.0,1.0
18987,56241,4166,2842,1324,0.682,0.318
18988,56243,1725,0,1725,0.0,1.0
18989,56244,1496,0,1496,0.0,1.0
18990,56245,535,0,535,0.0,1.0
18991,56248,807,0,807,0.0,1.0
18992,56249,296,0,296,0.0,1.0
18993,56251,987,0,987,0.0,1.0
18994,56252,1238,0,1238,0.0,1.0
18995,56253,1015,0,1015,0.0,1.0
18996,56255,394,0,394,0.0,1.0
18997,56256,2581,0,2581,0.0,1.0
18998,56257,508,0,508,0.0,1.0
18999,56258,15617,13464,2153,0.862,0.138
19000,56260,929,0,929,0.0,1.0
19001,56262,724,0,724,0.0,1.0
19002,56263,541,0,541,0.0,1.0
19003,56264,2204,0,2204,0.0,1.0
19004,56265,7757,5338,2419,0.688,0.312
19005,56266,1628,0,1628,0.0,1.0
19006,56267,6807,5123,1684,0.753,0.247
19007,56270,1061,0,1061,0.0,1.0
19008,56271,1196,0,1196,0.0,1.0
19009,56273,4797,1389,3408,0.29,0.71
19010,56274,177,0,177,0.0,1.0
19011,56276,298,0,298,0.0,1.0
19012,56277,3191,0,3191,0.0,1.0
19013,56278,2601,0,2601,0.0,1.0
19014,56279,1271,0,1271,0.0,1.0
19015,56280,480,0,480,0.0,1.0
19016,56281,619,0,619,0.0,1.0
19017,56282,1510,0,1510,0.0,1.0
19018,56283,6636,4958,1678,0.747,0.253
19019,56284,2111,0,2111,0.0,1.0
19020,56285,1096,0,1096,0.0,1.0
19021,56287,81,0,81,0.0,1.0
19022,56288,4696,1799,2897,0.383,0.617
19023,56289,634,0,634,0.0,1.0
19024,56291,501,0,501,0.0,1.0
19025,56292,636,0,636,0.0,1.0
19026,56293,1223,0,1223,0.0,1.0
19027,56294,84,0,84,0.0,1.0
19028,56295,310,0,310,0.0,1.0
19029,56296,2029,0,2029,0.0,1.0
19030,56297,867,0,867,0.0,1.0
19031,56301,32434,27637,4797,0.852,0.148
19032,56303,25984,25968,16,0.999,0.001
19033,56304,16020,13201,2819,0.824,0.176
19034,56307,5157,2564,2593,0.497,0.503
19035,56308,23961,16305,7656,0.68,0.32
19036,56309,1185,0,1185,0.0,1.0
19037,56310,5120,0,5120,0.0,1.0
19038,56311,757,0,757,0.0,1.0
19039,56312,2365,0,2365,0.0,1.0
19040,56313,106,0,106,0.0,1.0
19041,56314,1258,0,1258,0.0,1.0
19042,56315,1591,0,1591,0.0,1.0
19043,56316,1580,0,1580,0.0,1.0
19044,56318,1238,0,1238,0.0,1.0
19045,56319,1321,678,643,0.513,0.487
19046,56320,8080,4324,3756,0.535,0.465
19047,56321,1536,0,1536,0.0,1.0
19048,56323,496,0,496,0.0,1.0
19049,56324,1115,0,1115,0.0,1.0
19050,56325,211,0,211,0.0,1.0
19051,56326,1526,0,1526,0.0,1.0
19052,56327,803,0,803,0.0,1.0
19053,56328,128,0,128,0.0,1.0
19054,56329,7367,0,7367,0.0,1.0
19055,56330,1691,0,1691,0.0,1.0
19056,56331,2019,0,2019,0.0,1.0
19057,56332,1407,0,1407,0.0,1.0
19058,56334,5497,0,5497,0.0,1.0
19059,56335,199,0,199,0.0,1.0
19060,56336,1514,0,1514,0.0,1.0
19061,56338,1691,0,1691,0.0,1.0
19062,56339,1129,0,1129,0.0,1.0
19063,56340,2288,0,2288,0.0,1.0
19064,56342,2739,0,2739,0.0,1.0
19065,56343,926,0,926,0.0,1.0
19066,56345,14786,9024,5762,0.61,0.39
19067,56347,7062,3356,3706,0.475,0.525
19068,56349,733,0,733,0.0,1.0
19069,56350,570,0,570,0.0,1.0
19070,56352,5868,3121,2747,0.532,0.468
19071,56353,8996,2831,6165,0.315,0.685
19072,56354,1367,0,1367,0.0,1.0
19073,56355,579,0,579,0.0,1.0
19074,56356,300,0,300,0.0,1.0
19075,56357,1029,0,1029,0.0,1.0
19076,56358,3256,0,3256,0.0,1.0
19077,56359,3878,0,3878,0.0,1.0
19078,56360,3917,0,3917,0.0,1.0
19079,56361,2403,0,2403,0.0,1.0
19080,56362,5844,0,5844,0.0,1.0
19081,56363,155,0,155,0.0,1.0
19082,56364,5416,0,5416,0.0,1.0
19083,56367,6263,1153,5110,0.184,0.816
19084,56368,4239,0,4239,0.0,1.0
19085,56369,528,0,528,0.0,1.0
19086,56371,99,0,99,0.0,1.0
19087,56373,3051,0,3051,0.0,1.0
19088,56374,9868,6556,3312,0.664,0.336
19089,56375,852,0,852,0.0,1.0
19090,56376,358,0,358,0.0,1.0
19091,56377,17648,16429,1219,0.931,0.069
19092,56378,7778,4253,3525,0.547,0.453
19093,56379,16163,13284,2879,0.822,0.178
19094,56381,2458,0,2458,0.0,1.0
19095,56382,1540,0,1540,0.0,1.0
19096,56384,328,0,328,0.0,1.0
19097,56385,928,0,928,0.0,1.0
19098,56386,652,0,652,0.0,1.0
19099,56387,6734,6393,341,0.949,0.051
19100,56389,111,0,111,0.0,1.0
19101,56401,29439,13949,15490,0.474,0.526
19102,56425,7655,5863,1792,0.766,0.234
19103,56431,8931,0,8931,0.0,1.0
19104,56433,1840,0,1840,0.0,1.0
19105,56434,235,0,235,0.0,1.0
19106,56435,2372,0,2372,0.0,1.0
19107,56436,67,0,67,0.0,1.0
19108,56437,1380,0,1380,0.0,1.0
19109,56438,2949,0,2949,0.0,1.0
19110,56440,1409,0,1409,0.0,1.0
19111,56441,3596,2210,1386,0.615,0.385
19112,56442,2381,0,2381,0.0,1.0
19113,56443,1417,0,1417,0.0,1.0
19114,56444,3087,756,2331,0.245,0.755
19115,56446,1597,0,1597,0.0,1.0
19116,56447,1150,0,1150,0.0,1.0
19117,56448,332,0,332,0.0,1.0
19118,56449,1769,0,1769,0.0,1.0
19119,56450,1017,0,1017,0.0,1.0
19120,56452,1755,0,1755,0.0,1.0
19121,56453,871,0,871,0.0,1.0
19122,56455,1488,512,976,0.344,0.656
19123,56456,50,0,50,0.0,1.0
19124,56458,357,0,357,0.0,1.0
19125,56461,3241,0,3241,0.0,1.0
19126,56464,4336,0,4336,0.0,1.0
19127,56465,2062,0,2062,0.0,1.0
19128,56466,3116,0,3116,0.0,1.0
19129,56467,2412,0,2412,0.0,1.0
19130,56468,4589,0,4589,0.0,1.0
19131,56469,998,0,998,0.0,1.0
19132,56470,10334,3398,6936,0.329,0.671
19133,56472,7459,0,7459,0.0,1.0
19134,56473,3380,0,3380,0.0,1.0
19135,56474,4244,0,4244,0.0,1.0
19136,56475,1655,0,1655,0.0,1.0
19137,56477,2758,0,2758,0.0,1.0
19138,56479,5384,2791,2593,0.518,0.482
19139,56481,2031,0,2031,0.0,1.0
19140,56482,6666,3927,2739,0.589,0.411
19141,56484,3205,0,3205,0.0,1.0
19142,56501,16290,7973,8317,0.489,0.511
19143,56510,2333,0,2333,0.0,1.0
19144,56511,1878,0,1878,0.0,1.0
19145,56514,3696,0,3696,0.0,1.0
19146,56515,2892,0,2892,0.0,1.0
19147,56516,294,0,294,0.0,1.0
19148,56517,279,0,279,0.0,1.0
19149,56518,388,0,388,0.0,1.0
19150,56519,300,0,300,0.0,1.0
19151,56520,3983,3279,704,0.823,0.177
19152,56521,757,0,757,0.0,1.0
19153,56522,538,0,538,0.0,1.0
19154,56523,539,0,539,0.0,1.0
19155,56524,661,0,661,0.0,1.0
19156,56525,106,0,106,0.0,1.0
19157,56527,840,0,840,0.0,1.0
19158,56528,1673,0,1673,0.0,1.0
19159,56529,4026,3777,249,0.938,0.062
19160,56531,1994,0,1994,0.0,1.0
19161,56533,291,0,291,0.0,1.0
19162,56534,1164,0,1164,0.0,1.0
19163,56535,1363,0,1363,0.0,1.0
19164,56536,482,0,482,0.0,1.0
19165,56537,18548,12081,6467,0.651,0.349
19166,56540,1962,0,1962,0.0,1.0
19167,56541,24,0,24,0.0,1.0
19168,56542,2829,0,2829,0.0,1.0
19169,56543,276,0,276,0.0,1.0
19170,56544,5294,0,5294,0.0,1.0
19171,56545,682,0,682,0.0,1.0
19172,56546,346,0,346,0.0,1.0
19173,56547,2700,0,2700,0.0,1.0
19174,56548,771,0,771,0.0,1.0
19175,56549,4508,0,4508,0.0,1.0
19176,56550,414,0,414,0.0,1.0
19177,56551,2237,0,2237,0.0,1.0
19178,56552,429,0,429,0.0,1.0
19179,56553,293,0,293,0.0,1.0
19180,56554,2709,0,2709,0.0,1.0
19181,56556,1160,0,1160,0.0,1.0
19182,56557,2811,0,2811,0.0,1.0
19183,56560,40766,38750,2016,0.951,0.049
19184,56565,107,0,107,0.0,1.0
19185,56566,668,0,668,0.0,1.0
19186,56567,3169,0,3169,0.0,1.0
19187,56568,142,0,142,0.0,1.0
19188,56569,1357,0,1357,0.0,1.0
19189,56570,1238,0,1238,0.0,1.0
19190,56571,1800,0,1800,0.0,1.0
19191,56572,5454,0,5454,0.0,1.0
19192,56573,5993,2929,3064,0.489,0.511
19193,56574,266,0,266,0.0,1.0
19194,56575,763,0,763,0.0,1.0
19195,56576,799,0,799,0.0,1.0
19196,56577,21,0,21,0.0,1.0
19197,56578,747,0,747,0.0,1.0
19198,56579,1136,0,1136,0.0,1.0
19199,56580,1171,0,1171,0.0,1.0
19200,56581,287,0,287,0.0,1.0
19201,56583,168,0,168,0.0,1.0
19202,56584,1553,0,1553,0.0,1.0
19203,56585,1049,0,1049,0.0,1.0
19204,56586,1839,0,1839,0.0,1.0
19205,56587,1404,0,1404,0.0,1.0
19206,56588,568,0,568,0.0,1.0
19207,56589,1975,0,1975,0.0,1.0
19208,56590,373,0,373,0.0,1.0
19209,56591,170,0,170,0.0,1.0
19210,56592,516,0,516,0.0,1.0
19211,56593,14,0,14,0.0,1.0
19212,56594,440,0,440,0.0,1.0
19213,56601,32225,14626,17599,0.454,0.546
19214,56621,4639,0,4639,0.0,1.0
19215,56623,2749,0,2749,0.0,1.0
19216,56626,356,0,356,0.0,1.0
19217,56627,309,0,309,0.0,1.0
19218,56628,1681,0,1681,0.0,1.0
19219,56629,197,0,197,0.0,1.0
19220,56630,2117,0,2117,0.0,1.0
19221,56633,4541,0,4541,0.0,1.0
19222,56634,1639,0,1639,0.0,1.0
19223,56636,5137,0,5137,0.0,1.0
19224,56637,227,0,227,0.0,1.0
19225,56639,459,0,459,0.0,1.0
19226,56641,324,0,324,0.0,1.0
19227,56644,787,0,787,0.0,1.0
19228,56646,355,0,355,0.0,1.0
19229,56647,839,0,839,0.0,1.0
19230,56649,9932,6919,3013,0.697,0.303
19231,56650,722,0,722,0.0,1.0
19232,56651,538,0,538,0.0,1.0
19233,56652,539,0,539,0.0,1.0
19234,56653,1336,0,1336,0.0,1.0
19235,56654,153,0,153,0.0,1.0
19236,56655,1303,0,1303,0.0,1.0
19237,56657,304,0,304,0.0,1.0
19238,56658,6,0,6,0.0,1.0
19239,56659,54,0,54,0.0,1.0
19240,56660,240,0,240,0.0,1.0
19241,56661,942,0,942,0.0,1.0
19242,56662,511,0,511,0.0,1.0
19243,56663,220,0,220,0.0,1.0
19244,56666,1066,0,1066,0.0,1.0
19245,56667,662,0,662,0.0,1.0
19246,56668,136,136,0,1.0,0.0
19247,56669,375,0,375,0.0,1.0
19248,56670,1440,0,1440,0.0,1.0
19249,56671,3371,0,3371,0.0,1.0
19250,56672,2097,0,2097,0.0,1.0
19251,56673,795,0,795,0.0,1.0
19252,56676,1663,0,1663,0.0,1.0
19253,56678,1321,0,1321,0.0,1.0
19254,56680,117,0,117,0.0,1.0
19255,56681,318,0,318,0.0,1.0
19256,56683,772,0,772,0.0,1.0
19257,56684,282,0,282,0.0,1.0
19258,56685,117,0,117,0.0,1.0
19259,56686,984,0,984,0.0,1.0
19260,56687,73,0,73,0.0,1.0
19261,56688,157,0,157,0.0,1.0
19262,56701,12690,8883,3807,0.7,0.3
19263,56710,490,0,490,0.0,1.0
19264,56711,96,0,96,0.0,1.0
19265,56713,1022,0,1022,0.0,1.0
19266,56714,1157,0,1157,0.0,1.0
19267,56715,350,0,350,0.0,1.0
19268,56716,9416,7964,1452,0.846,0.154
19269,56720,57,0,57,0.0,1.0
19270,56721,10096,8318,1778,0.824,0.176
19271,56722,386,0,386,0.0,1.0
19272,56723,970,0,970,0.0,1.0
19273,56724,159,0,159,0.0,1.0
19274,56725,978,0,978,0.0,1.0
19275,56726,1631,0,1631,0.0,1.0
19276,56727,769,0,769,0.0,1.0
19277,56728,1364,0,1364,0.0,1.0
19278,56729,140,0,140,0.0,1.0
19279,56731,93,0,93,0.0,1.0
19280,56732,1136,0,1136,0.0,1.0
19281,56733,390,0,390,0.0,1.0
19282,56734,467,0,467,0.0,1.0
19283,56735,816,0,816,0.0,1.0
19284,56736,903,0,903,0.0,1.0
19285,56737,871,0,871,0.0,1.0
19286,56738,1368,0,1368,0.0,1.0
19287,56741,23,0,23,0.0,1.0
19288,56742,918,0,918,0.0,1.0
19289,56744,621,0,621,0.0,1.0
19290,56748,600,0,600,0.0,1.0
19291,56750,2539,0,2539,0.0,1.0
19292,56751,5575,2763,2812,0.496,0.504
19293,56754,546,0,546,0.0,1.0
19294,56755,102,0,102,0.0,1.0
19295,56756,799,0,799,0.0,1.0
19296,56757,932,0,932,0.0,1.0
19297,56758,418,0,418,0.0,1.0
19298,56759,364,0,364,0.0,1.0
19299,56760,358,0,358,0.0,1.0
19300,56761,488,0,488,0.0,1.0
19301,56762,2494,0,2494,0.0,1.0
19302,56763,5180,0,5180,0.0,1.0
19303,57001,1672,0,1672,0.0,1.0
19304,57002,863,0,863,0.0,1.0
19305,57003,1879,0,1879,0.0,1.0
19306,57004,3356,0,3356,0.0,1.0
19307,57005,10473,8563,1910,0.818,0.182
19308,57006,24530,22482,2048,0.917,0.083
19309,57010,493,0,493,0.0,1.0
19310,57012,1160,0,1160,0.0,1.0
19311,57013,4440,2679,1761,0.603,0.397
19312,57014,1471,0,1471,0.0,1.0
19313,57015,787,0,787,0.0,1.0
19314,57016,693,0,693,0.0,1.0
19315,57017,1340,0,1340,0.0,1.0
19316,57018,1372,0,1372,0.0,1.0
19317,57020,1502,0,1502,0.0,1.0
19318,57021,276,0,276,0.0,1.0
19319,57022,4996,3584,1412,0.717,0.283
19320,57024,428,0,428,0.0,1.0
19321,57025,2795,0,2795,0.0,1.0
19322,57026,1458,0,1458,0.0,1.0
19323,57027,109,0,109,0.0,1.0
19324,57028,3448,0,3448,0.0,1.0
19325,57029,2023,0,2023,0.0,1.0
19326,57030,2959,0,2959,0.0,1.0
19327,57031,741,0,741,0.0,1.0
19328,57032,5906,4190,1716,0.709,0.291
19329,57033,4713,0,4713,0.0,1.0
19330,57034,712,0,712,0.0,1.0
19331,57035,1200,0,1200,0.0,1.0
19332,57036,811,0,811,0.0,1.0
19333,57037,819,0,819,0.0,1.0
19334,57038,1667,518,1149,0.311,0.689
19335,57039,3265,0,3265,0.0,1.0
19336,57040,389,0,389,0.0,1.0
19337,57041,97,0,97,0.0,1.0
19338,57042,8415,6174,2241,0.734,0.266
19339,57043,1378,0,1378,0.0,1.0
19340,57045,996,0,996,0.0,1.0
19341,57046,626,0,626,0.0,1.0
19342,57047,256,0,256,0.0,1.0
19343,57048,1170,0,1170,0.0,1.0
19344,57049,5789,5041,748,0.871,0.129
19345,57050,191,0,191,0.0,1.0
19346,57051,263,0,263,0.0,1.0
19347,57052,452,0,452,0.0,1.0
19348,57053,1893,0,1893,0.0,1.0
19349,57054,502,0,502,0.0,1.0
19350,57055,1090,0,1090,0.0,1.0
19351,57057,152,0,152,0.0,1.0
19352,57058,1973,0,1973,0.0,1.0
19353,57059,1522,0,1522,0.0,1.0
19354,57061,102,0,102,0.0,1.0
19355,57062,2410,0,2410,0.0,1.0
19356,57063,1006,0,1006,0.0,1.0
19357,57064,5072,3784,1288,0.746,0.254
19358,57065,397,0,397,0.0,1.0
19359,57066,1508,0,1508,0.0,1.0
19360,57067,537,0,537,0.0,1.0
19361,57068,1512,0,1512,0.0,1.0
19362,57069,11988,10492,1496,0.875,0.125
19363,57070,1387,0,1387,0.0,1.0
19364,57071,2758,0,2758,0.0,1.0
19365,57072,584,0,584,0.0,1.0
19366,57073,711,0,711,0.0,1.0
19367,57075,893,0,893,0.0,1.0
19368,57076,521,0,521,0.0,1.0
19369,57077,1324,0,1324,0.0,1.0
19370,57078,19121,14637,4484,0.765,0.235
19371,57103,34480,34477,3,1.0,0.0
19372,57104,25901,24875,1026,0.96,0.04
19373,57105,22268,22268,0,1.0,0.0
19374,57106,39852,38939,913,0.977,0.023
19375,57107,8044,6627,1417,0.824,0.176
19376,57108,17267,15709,1558,0.91,0.09
19377,57110,12309,11353,956,0.922,0.078
19378,57117,61,61,0,1.0,0.0
19379,57197,959,959,0,1.0,0.0
19380,57201,24983,21111,3872,0.845,0.155
19381,57212,2062,0,2062,0.0,1.0
19382,57213,485,0,485,0.0,1.0
19383,57214,75,0,75,0.0,1.0
19384,57216,1044,0,1044,0.0,1.0
19385,57217,244,0,244,0.0,1.0
19386,57218,327,0,327,0.0,1.0
19387,57219,567,0,567,0.0,1.0
19388,57220,767,0,767,0.0,1.0
19389,57221,808,0,808,0.0,1.0
19390,57223,1356,0,1356,0.0,1.0
19391,57224,195,0,195,0.0,1.0
19392,57225,1873,0,1873,0.0,1.0
19393,57226,2072,0,2072,0.0,1.0
19394,57227,434,0,434,0.0,1.0
19395,57231,1695,0,1695,0.0,1.0
19396,57232,299,0,299,0.0,1.0
19397,57233,118,0,118,0.0,1.0
19398,57234,1274,0,1274,0.0,1.0
19399,57235,844,0,844,0.0,1.0
19400,57236,118,0,118,0.0,1.0
19401,57237,665,0,665,0.0,1.0
19402,57238,483,0,483,0.0,1.0
19403,57239,223,0,223,0.0,1.0
19404,57241,1048,0,1048,0.0,1.0
19405,57242,432,0,432,0.0,1.0
19406,57243,604,0,604,0.0,1.0
19407,57245,126,0,126,0.0,1.0
19408,57246,161,0,161,0.0,1.0
19409,57247,320,0,320,0.0,1.0
19410,57248,1057,0,1057,0.0,1.0
19411,57249,994,0,994,0.0,1.0
19412,57251,127,0,127,0.0,1.0
19413,57252,4800,3283,1517,0.684,0.316
19414,57255,538,0,538,0.0,1.0
19415,57256,127,0,127,0.0,1.0
19416,57257,810,0,810,0.0,1.0
19417,57258,385,0,385,0.0,1.0
19418,57259,505,0,505,0.0,1.0
19419,57260,1093,0,1093,0.0,1.0
19420,57261,321,0,321,0.0,1.0
19421,57262,4963,0,4963,0.0,1.0
19422,57263,450,0,450,0.0,1.0
19423,57264,219,0,219,0.0,1.0
19424,57265,225,0,225,0.0,1.0
19425,57266,607,0,607,0.0,1.0
19426,57268,443,0,443,0.0,1.0
19427,57269,413,0,413,0.0,1.0
19428,57270,904,0,904,0.0,1.0
19429,57271,247,0,247,0.0,1.0
19430,57272,173,0,173,0.0,1.0
19431,57273,1316,0,1316,0.0,1.0
19432,57274,2813,0,2813,0.0,1.0
19433,57276,1178,0,1178,0.0,1.0
19434,57278,748,0,748,0.0,1.0
19435,57279,1058,0,1058,0.0,1.0
19436,57301,18375,14955,3420,0.814,0.186
19437,57311,1616,0,1616,0.0,1.0
19438,57312,516,0,516,0.0,1.0
19439,57313,1128,0,1128,0.0,1.0
19440,57314,734,0,734,0.0,1.0
19441,57315,987,0,987,0.0,1.0
19442,57317,526,0,526,0.0,1.0
19443,57319,1003,0,1003,0.0,1.0
19444,57321,388,0,388,0.0,1.0
19445,57322,296,0,296,0.0,1.0
19446,57323,215,0,215,0.0,1.0
19447,57324,383,0,383,0.0,1.0
19448,57325,3054,0,3054,0.0,1.0
19449,57328,1134,0,1134,0.0,1.0
19450,57329,258,0,258,0.0,1.0
19451,57330,625,0,625,0.0,1.0
19452,57331,459,0,459,0.0,1.0
19453,57332,730,0,730,0.0,1.0
19454,57334,895,0,895,0.0,1.0
19455,57335,244,0,244,0.0,1.0
19456,57337,140,0,140,0.0,1.0
19457,57339,1525,0,1525,0.0,1.0
19458,57340,355,0,355,0.0,1.0
19459,57341,151,0,151,0.0,1.0
19460,57342,558,0,558,0.0,1.0
19461,57344,155,0,155,0.0,1.0
19462,57345,1238,0,1238,0.0,1.0
19463,57346,68,0,68,0.0,1.0
19464,57348,527,0,527,0.0,1.0
19465,57349,1493,0,1493,0.0,1.0
19466,57350,14534,12637,1897,0.869,0.131
19467,57353,829,0,829,0.0,1.0
19468,57355,1352,0,1352,0.0,1.0
19469,57356,1993,0,1993,0.0,1.0
19470,57358,34,0,34,0.0,1.0
19471,57359,649,0,649,0.0,1.0
19472,57361,198,0,198,0.0,1.0
19473,57362,2149,0,2149,0.0,1.0
19474,57363,1003,0,1003,0.0,1.0
19475,57364,56,0,56,0.0,1.0
19476,57365,522,0,522,0.0,1.0
19477,57366,2228,0,2228,0.0,1.0
19478,57367,210,0,210,0.0,1.0
19479,57368,1226,0,1226,0.0,1.0
19480,57369,2495,0,2495,0.0,1.0
19481,57370,814,0,814,0.0,1.0
19482,57371,234,0,234,0.0,1.0
19483,57373,437,0,437,0.0,1.0
19484,57374,343,0,343,0.0,1.0
19485,57375,647,0,647,0.0,1.0
19486,57376,1010,0,1010,0.0,1.0
19487,57379,84,0,84,0.0,1.0
19488,57380,3470,0,3470,0.0,1.0
19489,57381,490,0,490,0.0,1.0
19490,57382,1591,0,1591,0.0,1.0
19491,57383,732,0,732,0.0,1.0
19492,57384,839,0,839,0.0,1.0
19493,57385,1221,0,1221,0.0,1.0
19494,57386,209,0,209,0.0,1.0
19495,57401,30061,25977,4084,0.864,0.136
19496,57420,75,0,75,0.0,1.0
19497,57421,88,0,88,0.0,1.0
19498,57422,235,0,235,0.0,1.0
19499,57424,291,0,291,0.0,1.0
19500,57426,63,0,63,0.0,1.0
19501,57427,620,0,620,0.0,1.0
19502,57428,710,0,710,0.0,1.0
19503,57429,94,0,94,0.0,1.0
19504,57430,2243,0,2243,0.0,1.0
19505,57432,465,0,465,0.0,1.0
19506,57433,383,0,383,0.0,1.0
19507,57434,566,0,566,0.0,1.0
19508,57435,247,0,247,0.0,1.0
19509,57436,384,0,384,0.0,1.0
19510,57437,1286,0,1286,0.0,1.0
19511,57438,1580,0,1580,0.0,1.0
19512,57439,52,0,52,0.0,1.0
19513,57440,612,0,612,0.0,1.0
19514,57441,607,0,607,0.0,1.0
19515,57442,1664,0,1664,0.0,1.0
19516,57445,2068,0,2068,0.0,1.0
19517,57446,472,0,472,0.0,1.0
19518,57448,348,0,348,0.0,1.0
19519,57449,146,0,146,0.0,1.0
19520,57450,672,0,672,0.0,1.0
19521,57451,2293,0,2293,0.0,1.0
19522,57452,278,0,278,0.0,1.0
19523,57454,558,0,558,0.0,1.0
19524,57455,96,0,96,0.0,1.0
19525,57456,862,0,862,0.0,1.0
19526,57457,90,0,90,0.0,1.0
19527,57460,365,0,365,0.0,1.0
19528,57461,392,0,392,0.0,1.0
19529,57465,371,0,371,0.0,1.0
19530,57466,124,0,124,0.0,1.0
19531,57467,293,0,293,0.0,1.0
19532,57468,247,0,247,0.0,1.0
19533,57469,3305,0,3305,0.0,1.0
19534,57470,143,0,143,0.0,1.0
19535,57471,674,0,674,0.0,1.0
19536,57472,953,0,953,0.0,1.0
19537,57473,161,0,161,0.0,1.0
19538,57474,197,0,197,0.0,1.0
19539,57475,160,0,160,0.0,1.0
19540,57476,463,0,463,0.0,1.0
19541,57477,117,0,117,0.0,1.0
19542,57479,666,0,666,0.0,1.0
19543,57481,598,0,598,0.0,1.0
19544,57501,16309,12720,3589,0.78,0.22
19545,57520,153,0,153,0.0,1.0
19546,57521,167,0,167,0.0,1.0
19547,57522,463,0,463,0.0,1.0
19548,57523,1094,0,1094,0.0,1.0
19549,57528,748,0,748,0.0,1.0
19550,57529,395,0,395,0.0,1.0
19551,57531,228,0,228,0.0,1.0
19552,57532,2835,1705,1130,0.601,0.399
19553,57533,1900,0,1900,0.0,1.0
19554,57534,183,0,183,0.0,1.0
19555,57536,469,0,469,0.0,1.0
19556,57537,83,0,83,0.0,1.0
19557,57538,322,0,322,0.0,1.0
19558,57540,106,0,106,0.0,1.0
19559,57541,167,0,167,0.0,1.0
19560,57543,870,0,870,0.0,1.0
19561,57544,419,0,419,0.0,1.0
19562,57547,139,0,139,0.0,1.0
19563,57548,1380,0,1380,0.0,1.0
19564,57551,2279,0,2279,0.0,1.0
19565,57552,554,0,554,0.0,1.0
19566,57553,153,0,153,0.0,1.0
19567,57555,3834,0,3834,0.0,1.0
19568,57559,638,0,638,0.0,1.0
19569,57560,436,0,436,0.0,1.0
19570,57562,98,0,98,0.0,1.0
19571,57563,240,0,240,0.0,1.0
19572,57564,995,0,995,0.0,1.0
19573,57566,1060,0,1060,0.0,1.0
19574,57567,1406,0,1406,0.0,1.0
19575,57568,689,0,689,0.0,1.0
19576,57569,445,0,445,0.0,1.0
19577,57570,2064,0,2064,0.0,1.0
19578,57571,14,0,14,0.0,1.0
19579,57572,1847,0,1847,0.0,1.0
19580,57574,104,0,104,0.0,1.0
19581,57576,204,0,204,0.0,1.0
19582,57577,1211,0,1211,0.0,1.0
19583,57579,1330,0,1330,0.0,1.0
19584,57580,4449,2907,1542,0.653,0.347
19585,57584,125,0,125,0.0,1.0
19586,57585,226,0,226,0.0,1.0
19587,57601,4003,3457,546,0.864,0.136
19588,57620,515,0,515,0.0,1.0
19589,57621,378,0,378,0.0,1.0
19590,57622,318,0,318,0.0,1.0
19591,57623,1042,0,1042,0.0,1.0
19592,57625,4230,2645,1585,0.625,0.375
19593,57626,971,0,971,0.0,1.0
19594,57630,32,0,32,0.0,1.0
19595,57631,361,0,361,0.0,1.0
19596,57632,634,0,634,0.0,1.0
19597,57633,414,0,414,0.0,1.0
19598,57634,115,0,115,0.0,1.0
19599,57636,164,0,164,0.0,1.0
19600,57638,1921,0,1921,0.0,1.0
19601,57639,371,0,371,0.0,1.0
19602,57640,176,0,176,0.0,1.0
19603,57641,295,0,295,0.0,1.0
19604,57642,1917,0,1917,0.0,1.0
19605,57644,335,0,335,0.0,1.0
19606,57645,217,0,217,0.0,1.0
19607,57646,199,0,199,0.0,1.0
19608,57648,335,0,335,0.0,1.0
19609,57649,217,0,217,0.0,1.0
19610,57650,29,0,29,0.0,1.0
19611,57651,115,0,115,0.0,1.0
19612,57652,402,0,402,0.0,1.0
19613,57656,723,0,723,0.0,1.0
19614,57657,203,0,203,0.0,1.0
19615,57658,446,0,446,0.0,1.0
19616,57660,99,0,99,0.0,1.0
19617,57661,88,0,88,0.0,1.0
19618,57701,43462,40505,2957,0.932,0.068
19619,57702,32980,23615,9365,0.716,0.284
19620,57703,14205,10822,3383,0.762,0.238
19621,57706,2903,2903,0,1.0,0.0
19622,57714,872,0,872,0.0,1.0
19623,57716,486,0,486,0.0,1.0
19624,57717,8007,5240,2767,0.654,0.346
19625,57718,6307,5274,1033,0.836,0.164
19626,57719,6217,4982,1235,0.801,0.199
19627,57720,651,0,651,0.0,1.0
19628,57722,283,0,283,0.0,1.0
19629,57724,210,0,210,0.0,1.0
19630,57725,162,0,162,0.0,1.0
19631,57730,5315,0,5315,0.0,1.0
19632,57732,1979,944,1035,0.477,0.523
19633,57735,1327,0,1327,0.0,1.0
19634,57738,170,0,170,0.0,1.0
19635,57741,63,0,63,0.0,1.0
19636,57744,2238,0,2238,0.0,1.0
19637,57745,2109,0,2109,0.0,1.0
19638,57747,5870,3550,2320,0.605,0.395
19639,57748,318,0,318,0.0,1.0
19640,57750,295,0,295,0.0,1.0
19641,57751,844,0,844,0.0,1.0
19642,57752,2245,0,2245,0.0,1.0
19643,57754,3793,2806,987,0.74,0.26
19644,57755,116,0,116,0.0,1.0
19645,57756,1126,0,1126,0.0,1.0
19646,57758,200,0,200,0.0,1.0
19647,57759,546,0,546,0.0,1.0
19648,57760,1353,0,1353,0.0,1.0
19649,57761,1210,0,1210,0.0,1.0
19650,57762,531,0,531,0.0,1.0
19651,57763,282,0,282,0.0,1.0
19652,57764,1923,0,1923,0.0,1.0
19653,57766,237,0,237,0.0,1.0
19654,57767,149,0,149,0.0,1.0
19655,57769,3515,1035,2480,0.294,0.706
19656,57770,5271,2720,2551,0.516,0.484
19657,57772,2048,0,2048,0.0,1.0
19658,57773,133,0,133,0.0,1.0
19659,57775,230,0,230,0.0,1.0
19660,57776,15,0,15,0.0,1.0
19661,57779,333,0,333,0.0,1.0
19662,57780,102,0,102,0.0,1.0
19663,57782,61,0,61,0.0,1.0
19664,57783,14290,10799,3491,0.756,0.244
19665,57785,9377,6583,2794,0.702,0.298
19666,57787,365,0,365,0.0,1.0
19667,57788,485,0,485,0.0,1.0
19668,57790,1111,0,1111,0.0,1.0
19669,57791,190,0,190,0.0,1.0
19670,57792,129,0,129,0.0,1.0
19671,57793,1913,0,1913,0.0,1.0
19672,57794,644,0,644,0.0,1.0
19673,57799,660,660,0,1.0,0.0
19674,58001,55,0,55,0.0,1.0
19675,58002,23,0,23,0.0,1.0
19676,58004,266,0,266,0.0,1.0
19677,58005,854,0,854,0.0,1.0
19678,58006,427,0,427,0.0,1.0
19679,58007,119,0,119,0.0,1.0
19680,58008,229,0,229,0.0,1.0
19681,58009,102,0,102,0.0,1.0
19682,58011,391,0,391,0.0,1.0
19683,58012,2474,0,2474,0.0,1.0
19684,58013,101,0,101,0.0,1.0
19685,58015,291,0,291,0.0,1.0
19686,58016,192,0,192,0.0,1.0
19687,58017,313,0,313,0.0,1.0
19688,58018,324,0,324,0.0,1.0
19689,58021,447,0,447,0.0,1.0
19690,58027,1391,0,1391,0.0,1.0
19691,58029,129,0,129,0.0,1.0
19692,58030,649,0,649,0.0,1.0
19693,58031,414,0,414,0.0,1.0
19694,58032,722,0,722,0.0,1.0
19695,58033,374,0,374,0.0,1.0
19696,58035,262,0,262,0.0,1.0
19697,58036,274,0,274,0.0,1.0
19698,58038,332,0,332,0.0,1.0
19699,58040,920,0,920,0.0,1.0
19700,58041,1545,0,1545,0.0,1.0
19701,58042,1386,0,1386,0.0,1.0
19702,58043,167,0,167,0.0,1.0
19703,58045,2230,0,2230,0.0,1.0
19704,58046,583,0,583,0.0,1.0
19705,58047,3560,1896,1664,0.533,0.467
19706,58048,418,0,418,0.0,1.0
19707,58049,289,0,289,0.0,1.0
19708,58051,1458,0,1458,0.0,1.0
19709,58052,581,0,581,0.0,1.0
19710,58053,1171,0,1171,0.0,1.0
19711,58054,3128,0,3128,0.0,1.0
19712,58056,191,0,191,0.0,1.0
19713,58057,147,0,147,0.0,1.0
19714,58058,123,0,123,0.0,1.0
19715,58059,1168,0,1168,0.0,1.0
19716,58060,1329,0,1329,0.0,1.0
19717,58061,413,0,413,0.0,1.0
19718,58062,174,0,174,0.0,1.0
19719,58063,340,0,340,0.0,1.0
19720,58064,450,0,450,0.0,1.0
19721,58065,22,0,22,0.0,1.0
19722,58067,243,0,243,0.0,1.0
19723,58068,321,0,321,0.0,1.0
19724,58069,176,0,176,0.0,1.0
19725,58071,409,0,409,0.0,1.0
19726,58072,7997,6689,1308,0.836,0.164
19727,58075,9276,7598,1678,0.819,0.181
19728,58076,236,236,0,1.0,0.0
19729,58077,787,0,787,0.0,1.0
19730,58078,26321,25743,578,0.978,0.022
19731,58079,530,0,530,0.0,1.0
19732,58081,845,0,845,0.0,1.0
19733,58102,29850,29011,839,0.972,0.028
19734,58103,47302,47302,0,1.0,0.0
19735,58104,28322,27714,608,0.979,0.021
19736,58105,2483,2483,0,1.0,0.0
19737,58201,34880,33684,1196,0.966,0.034
19738,58202,1839,1839,0,1.0,0.0
19739,58203,18229,17429,800,0.956,0.044
19740,58204,2107,2012,95,0.955,0.045
19741,58205,260,260,0,1.0,0.0
19742,58210,322,0,322,0.0,1.0
19743,58212,474,0,474,0.0,1.0
19744,58214,367,0,367,0.0,1.0
19745,58216,153,0,153,0.0,1.0
19746,58218,700,0,700,0.0,1.0
19747,58219,47,0,47,0.0,1.0
19748,58220,2360,0,2360,0.0,1.0
19749,58222,295,0,295,0.0,1.0
19750,58223,212,0,212,0.0,1.0
19751,58224,41,0,41,0.0,1.0
19752,58225,1125,0,1125,0.0,1.0
19753,58227,504,0,504,0.0,1.0
19754,58228,880,425,455,0.483,0.517
19755,58229,114,0,114,0.0,1.0
19756,58230,663,0,663,0.0,1.0
19757,58231,490,0,490,0.0,1.0
19758,58233,283,0,283,0.0,1.0
19759,58235,418,0,418,0.0,1.0
19760,58237,5499,4219,1280,0.767,0.233
19761,58238,167,0,167,0.0,1.0
19762,58239,71,0,71,0.0,1.0
19763,58240,1276,0,1276,0.0,1.0
19764,58241,126,0,126,0.0,1.0
19765,58243,539,0,539,0.0,1.0
19766,58244,194,0,194,0.0,1.0
19767,58249,2574,0,2574,0.0,1.0
19768,58250,241,0,241,0.0,1.0
19769,58251,2049,0,2049,0.0,1.0
19770,58254,513,0,513,0.0,1.0
19771,58256,872,0,872,0.0,1.0
19772,58257,2239,0,2239,0.0,1.0
19773,58258,290,0,290,0.0,1.0
19774,58259,454,0,454,0.0,1.0
19775,58260,173,0,173,0.0,1.0
19776,58261,1112,0,1112,0.0,1.0
19777,58262,134,0,134,0.0,1.0
19778,58265,519,0,519,0.0,1.0
19779,58266,203,0,203,0.0,1.0
19780,58267,1520,0,1520,0.0,1.0
19781,58269,207,0,207,0.0,1.0
19782,58270,1950,0,1950,0.0,1.0
19783,58271,708,0,708,0.0,1.0
19784,58272,312,0,312,0.0,1.0
19785,58273,264,0,264,0.0,1.0
19786,58274,953,0,953,0.0,1.0
19787,58275,733,0,733,0.0,1.0
19788,58276,503,0,503,0.0,1.0
19789,58277,225,0,225,0.0,1.0
19790,58278,1988,0,1988,0.0,1.0
19791,58281,124,0,124,0.0,1.0
19792,58282,1441,0,1441,0.0,1.0
19793,58301,9864,7444,2420,0.755,0.245
19794,58311,60,0,60,0.0,1.0
19795,58316,6486,0,6486,0.0,1.0
19796,58317,226,0,226,0.0,1.0
19797,58318,3684,0,3684,0.0,1.0
19798,58321,161,0,161,0.0,1.0
19799,58323,47,0,47,0.0,1.0
19800,58324,1345,0,1345,0.0,1.0
19801,58325,92,0,92,0.0,1.0
19802,58327,390,0,390,0.0,1.0
19803,58329,3313,0,3313,0.0,1.0
19804,58330,341,0,341,0.0,1.0
19805,58331,122,0,122,0.0,1.0
19806,58332,320,0,320,0.0,1.0
19807,58335,1694,0,1694,0.0,1.0
19808,58338,105,0,105,0.0,1.0
19809,58339,47,0,47,0.0,1.0
19810,58341,2597,0,2597,0.0,1.0
19811,58343,81,0,81,0.0,1.0
19812,58344,958,0,958,0.0,1.0
19813,58345,158,0,158,0.0,1.0
19814,58346,650,0,650,0.0,1.0
19815,58348,727,0,727,0.0,1.0
19816,58351,478,0,478,0.0,1.0
19817,58352,435,0,435,0.0,1.0
19818,58353,140,0,140,0.0,1.0
19819,58355,84,0,84,0.0,1.0
19820,58356,1751,0,1751,0.0,1.0
19821,58357,364,0,364,0.0,1.0
19822,58361,190,0,190,0.0,1.0
19823,58362,82,0,82,0.0,1.0
19824,58363,83,0,83,0.0,1.0
19825,58365,304,0,304,0.0,1.0
19826,58366,1080,0,1080,0.0,1.0
19827,58367,1707,0,1707,0.0,1.0
19828,58368,3801,2824,977,0.743,0.257
19829,58369,1231,0,1231,0.0,1.0
19830,58370,1280,0,1280,0.0,1.0
19831,58372,106,0,106,0.0,1.0
19832,58374,640,0,640,0.0,1.0
19833,58377,334,0,334,0.0,1.0
19834,58379,360,0,360,0.0,1.0
19835,58380,442,0,442,0.0,1.0
19836,58381,317,0,317,0.0,1.0
19837,58382,163,0,163,0.0,1.0
19838,58384,549,0,549,0.0,1.0
19839,58385,225,0,225,0.0,1.0
19840,58386,134,0,134,0.0,1.0
19841,58401,17142,14597,2545,0.852,0.148
19842,58402,260,260,0,1.0,0.0
19843,58405,427,427,0,1.0,0.0
19844,58413,1150,0,1150,0.0,1.0
19845,58415,145,0,145,0.0,1.0
19846,58416,440,0,440,0.0,1.0
19847,58418,353,0,353,0.0,1.0
19848,58420,314,0,314,0.0,1.0
19849,58421,2850,0,2850,0.0,1.0
19850,58422,195,0,195,0.0,1.0
19851,58423,78,0,78,0.0,1.0
19852,58424,301,0,301,0.0,1.0
19853,58425,1379,0,1379,0.0,1.0
19854,58426,200,0,200,0.0,1.0
19855,58428,271,0,271,0.0,1.0
19856,58429,357,0,357,0.0,1.0
19857,58430,112,0,112,0.0,1.0
19858,58431,132,0,132,0.0,1.0
19859,58433,1092,0,1092,0.0,1.0
19860,58436,1965,0,1965,0.0,1.0
19861,58438,625,0,625,0.0,1.0
19862,58439,310,0,310,0.0,1.0
19863,58440,181,0,181,0.0,1.0
19864,58441,389,0,389,0.0,1.0
19865,58442,478,0,478,0.0,1.0
19866,58443,200,0,200,0.0,1.0
19867,58444,192,0,192,0.0,1.0
19868,58445,160,0,160,0.0,1.0
19869,58448,347,0,347,0.0,1.0
19870,58451,185,0,185,0.0,1.0
19871,58452,27,0,27,0.0,1.0
19872,58454,360,0,360,0.0,1.0
19873,58455,303,0,303,0.0,1.0
19874,58456,523,0,523,0.0,1.0
19875,58458,1397,0,1397,0.0,1.0
19876,58460,230,0,230,0.0,1.0
19877,58461,413,0,413,0.0,1.0
19878,58463,651,0,651,0.0,1.0
19879,58464,242,0,242,0.0,1.0
19880,58466,355,0,355,0.0,1.0
19881,58467,606,0,606,0.0,1.0
19882,58472,419,0,419,0.0,1.0
19883,58474,2681,0,2681,0.0,1.0
19884,58475,150,0,150,0.0,1.0
19885,58476,271,0,271,0.0,1.0
19886,58477,148,0,148,0.0,1.0
19887,58478,135,0,135,0.0,1.0
19888,58479,192,0,192,0.0,1.0
19889,58480,340,0,340,0.0,1.0
19890,58481,272,0,272,0.0,1.0
19891,58482,1003,0,1003,0.0,1.0
19892,58483,340,0,340,0.0,1.0
19893,58484,65,0,65,0.0,1.0
19894,58486,262,0,262,0.0,1.0
19895,58487,444,0,444,0.0,1.0
19896,58488,258,0,258,0.0,1.0
19897,58490,240,0,240,0.0,1.0
19898,58492,481,0,481,0.0,1.0
19899,58494,350,0,350,0.0,1.0
19900,58495,1332,0,1332,0.0,1.0
19901,58496,182,0,182,0.0,1.0
19902,58497,326,0,326,0.0,1.0
19903,58501,28055,26790,1265,0.955,0.045
19904,58503,25734,19444,6290,0.756,0.244
19905,58504,24342,19991,4351,0.821,0.179
19906,58505,2,2,0,1.0,0.0
19907,58520,264,0,264,0.0,1.0
19908,58521,658,0,658,0.0,1.0
19909,58523,3619,2949,670,0.815,0.185
19910,58524,100,0,100,0.0,1.0
19911,58528,798,0,798,0.0,1.0
19912,58529,660,0,660,0.0,1.0
19913,58530,1193,0,1193,0.0,1.0
19914,58531,307,0,307,0.0,1.0
19915,58532,297,0,297,0.0,1.0
19916,58533,945,0,945,0.0,1.0
19917,58535,571,0,571,0.0,1.0
19918,58538,2489,0,2489,0.0,1.0
19919,58540,2449,0,2449,0.0,1.0
19920,58541,364,0,364,0.0,1.0
19921,58542,324,0,324,0.0,1.0
19922,58544,551,0,551,0.0,1.0
19923,58545,3461,0,3461,0.0,1.0
19924,58549,214,0,214,0.0,1.0
19925,58552,1797,0,1797,0.0,1.0
19926,58554,22884,18720,4164,0.818,0.182
19927,58558,812,0,812,0.0,1.0
19928,58559,218,0,218,0.0,1.0
19929,58560,161,0,161,0.0,1.0
19930,58561,1085,0,1085,0.0,1.0
19931,58562,415,0,415,0.0,1.0
19932,58563,1977,0,1977,0.0,1.0
19933,58564,92,0,92,0.0,1.0
19934,58565,209,0,209,0.0,1.0
19935,58566,180,0,180,0.0,1.0
19936,58568,535,0,535,0.0,1.0
19937,58569,77,0,77,0.0,1.0
19938,58570,397,0,397,0.0,1.0
19939,58571,603,0,603,0.0,1.0
19940,58572,319,0,319,0.0,1.0
19941,58573,674,0,674,0.0,1.0
19942,58575,920,0,920,0.0,1.0
19943,58576,953,0,953,0.0,1.0
19944,58577,1671,0,1671,0.0,1.0
19945,58579,1190,0,1190,0.0,1.0
19946,58580,455,0,455,0.0,1.0
19947,58581,258,0,258,0.0,1.0
19948,58601,21078,17586,3492,0.834,0.166
19949,58620,132,0,132,0.0,1.0
19950,58621,1231,0,1231,0.0,1.0
19951,58622,1489,0,1489,0.0,1.0
19952,58623,2370,0,2370,0.0,1.0
19953,58625,185,0,185,0.0,1.0
19954,58626,262,0,262,0.0,1.0
19955,58627,154,0,154,0.0,1.0
19956,58630,502,0,502,0.0,1.0
19957,58631,1150,0,1150,0.0,1.0
19958,58632,149,0,149,0.0,1.0
19959,58634,251,0,251,0.0,1.0
19960,58636,706,0,706,0.0,1.0
19961,58638,992,0,992,0.0,1.0
19962,58639,1816,0,1816,0.0,1.0
19963,58640,1344,0,1344,0.0,1.0
19964,58641,79,0,79,0.0,1.0
19965,58642,334,0,334,0.0,1.0
19966,58643,191,0,191,0.0,1.0
19967,58645,238,0,238,0.0,1.0
19968,58646,1138,0,1138,0.0,1.0
19969,58647,1142,0,1142,0.0,1.0
19970,58649,321,0,321,0.0,1.0
19971,58650,393,0,393,0.0,1.0
19972,58651,475,0,475,0.0,1.0
19973,58652,987,0,987,0.0,1.0
19974,58653,601,0,601,0.0,1.0
19975,58654,289,0,289,0.0,1.0
19976,58655,484,0,484,0.0,1.0
19977,58656,366,0,366,0.0,1.0
19978,58701,28368,25154,3214,0.887,0.113
19979,58702,0,0,0,,
19980,58703,19396,16987,2409,0.876,0.124
19981,58704,4770,4770,0,1.0,0.0
19982,58705,751,751,0,1.0,0.0
19983,58707,509,509,0,1.0,0.0
19984,58710,469,0,469,0.0,1.0
19985,58711,211,0,211,0.0,1.0
19986,58712,155,0,155,0.0,1.0
19987,58713,35,0,35,0.0,1.0
19988,58716,147,0,147,0.0,1.0
19989,58718,1040,0,1040,0.0,1.0
19990,58721,529,0,529,0.0,1.0
19991,58722,1516,0,1516,0.0,1.0
19992,58723,236,0,236,0.0,1.0
19993,58725,341,0,341,0.0,1.0
19994,58727,279,0,279,0.0,1.0
19995,58730,1295,0,1295,0.0,1.0
19996,58731,300,0,300,0.0,1.0
19997,58733,402,0,402,0.0,1.0
19998,58734,241,0,241,0.0,1.0
19999,58735,314,0,314,0.0,1.0
20000,58736,452,0,452,0.0,1.0
20001,58737,140,0,140,0.0,1.0
20002,58740,755,0,755,0.0,1.0
20003,58741,554,0,554,0.0,1.0
20004,58744,143,0,143,0.0,1.0
20005,58746,1620,0,1620,0.0,1.0
20006,58748,148,0,148,0.0,1.0
20007,58750,528,0,528,0.0,1.0
20008,58752,223,0,223,0.0,1.0
20009,58755,129,0,129,0.0,1.0
20010,58756,250,0,250,0.0,1.0
20011,58757,909,0,909,0.0,1.0
20012,58758,222,0,222,0.0,1.0
20013,58759,821,0,821,0.0,1.0
20014,58760,254,0,254,0.0,1.0
20015,58761,1104,0,1104,0.0,1.0
20016,58762,246,0,246,0.0,1.0
20017,58763,3502,0,3502,0.0,1.0
20018,58765,248,0,248,0.0,1.0
20019,58768,282,0,282,0.0,1.0
20020,58769,229,0,229,0.0,1.0
20021,58770,1240,0,1240,0.0,1.0
20022,58771,453,0,453,0.0,1.0
20023,58772,137,0,137,0.0,1.0
20024,58773,687,0,687,0.0,1.0
20025,58775,290,0,290,0.0,1.0
20026,58776,298,0,298,0.0,1.0
20027,58778,133,0,133,0.0,1.0
20028,58779,367,0,367,0.0,1.0
20029,58781,695,0,695,0.0,1.0
20030,58782,436,0,436,0.0,1.0
20031,58783,346,0,346,0.0,1.0
20032,58784,2330,0,2330,0.0,1.0
20033,58785,1091,0,1091,0.0,1.0
20034,58787,136,0,136,0.0,1.0
20035,58788,1124,0,1124,0.0,1.0
20036,58789,321,0,321,0.0,1.0
20037,58790,1585,0,1585,0.0,1.0
20038,58792,227,0,227,0.0,1.0
20039,58793,609,0,609,0.0,1.0
20040,58794,159,0,159,0.0,1.0
20041,58795,198,0,198,0.0,1.0
20042,58801,18371,15127,3244,0.823,0.177
20043,58830,213,0,213,0.0,1.0
20044,58831,472,0,472,0.0,1.0
20045,58833,80,0,80,0.0,1.0
20046,58835,313,0,313,0.0,1.0
20047,58838,199,0,199,0.0,1.0
20048,58843,466,0,466,0.0,1.0
20049,58844,142,0,142,0.0,1.0
20050,58845,371,0,371,0.0,1.0
20051,58847,283,0,283,0.0,1.0
20052,58849,883,0,883,0.0,1.0
20053,58852,1750,0,1750,0.0,1.0
20054,58853,292,0,292,0.0,1.0
20055,58854,2804,0,2804,0.0,1.0
20056,58856,131,0,131,0.0,1.0
20057,59001,1643,0,1643,0.0,1.0
20058,59002,165,0,165,0.0,1.0
20059,59003,1160,0,1160,0.0,1.0
20060,59006,926,0,926,0.0,1.0
20061,59007,113,0,113,0.0,1.0
20062,59008,410,0,410,0.0,1.0
20063,59010,102,0,102,0.0,1.0
20064,59011,3027,0,3027,0.0,1.0
20065,59012,249,0,249,0.0,1.0
20066,59013,127,0,127,0.0,1.0
20067,59014,1446,0,1446,0.0,1.0
20068,59015,576,0,576,0.0,1.0
20069,59016,1089,0,1089,0.0,1.0
20070,59018,602,0,602,0.0,1.0
20071,59019,3972,0,3972,0.0,1.0
20072,59020,77,0,77,0.0,1.0
20073,59022,1945,0,1945,0.0,1.0
20074,59024,390,0,390,0.0,1.0
20075,59025,56,0,56,0.0,1.0
20076,59026,194,0,194,0.0,1.0
20077,59027,836,0,836,0.0,1.0
20078,59028,434,0,434,0.0,1.0
20079,59029,733,0,733,0.0,1.0
20080,59030,1263,0,1263,0.0,1.0
20081,59031,339,0,339,0.0,1.0
20082,59032,408,0,408,0.0,1.0
20083,59033,334,0,334,0.0,1.0
20084,59034,5189,3614,1575,0.696,0.304
20085,59035,227,0,227,0.0,1.0
20086,59036,1505,0,1505,0.0,1.0
20087,59037,1672,0,1672,0.0,1.0
20088,59038,656,0,656,0.0,1.0
20089,59039,28,0,28,0.0,1.0
20090,59041,1950,0,1950,0.0,1.0
20091,59043,2950,0,2950,0.0,1.0
20092,59044,10971,8309,2662,0.757,0.243
20093,59046,390,0,390,0.0,1.0
20094,59047,11880,8172,3708,0.688,0.312
20095,59050,1715,0,1715,0.0,1.0
20096,59052,139,0,139,0.0,1.0
20097,59053,354,0,354,0.0,1.0
20098,59054,315,0,315,0.0,1.0
20099,59055,59,0,59,0.0,1.0
20100,59057,692,0,692,0.0,1.0
20101,59058,50,0,50,0.0,1.0
20102,59059,146,0,146,0.0,1.0
20103,59061,272,0,272,0.0,1.0
20104,59062,35,0,35,0.0,1.0
20105,59063,2058,0,2058,0.0,1.0
20106,59064,284,0,284,0.0,1.0
20107,59065,197,0,197,0.0,1.0
20108,59066,701,0,701,0.0,1.0
20109,59067,221,0,221,0.0,1.0
20110,59068,3580,0,3580,0.0,1.0
20111,59069,461,0,461,0.0,1.0
20112,59070,1047,0,1047,0.0,1.0
20113,59071,104,0,104,0.0,1.0
20114,59072,4140,0,4140,0.0,1.0
20115,59074,490,0,490,0.0,1.0
20116,59075,289,0,289,0.0,1.0
20117,59076,33,0,33,0.0,1.0
20118,59077,79,0,79,0.0,1.0
20119,59078,145,0,145,0.0,1.0
20120,59079,3481,0,3481,0.0,1.0
20121,59081,9,0,9,0.0,1.0
20122,59082,39,0,39,0.0,1.0
20123,59085,88,0,88,0.0,1.0
20124,59086,727,0,727,0.0,1.0
20125,59087,436,0,436,0.0,1.0
20126,59088,1373,0,1373,0.0,1.0
20127,59089,467,0,467,0.0,1.0
20128,59101,39562,34601,4961,0.875,0.125
20129,59102,46564,46495,69,0.999,0.001
20130,59105,29624,26506,3118,0.895,0.105
20131,59106,12375,7367,5008,0.595,0.405
20132,59201,5100,3540,1560,0.694,0.306
20133,59211,125,0,125,0.0,1.0
20134,59212,373,0,373,0.0,1.0
20135,59213,772,0,772,0.0,1.0
20136,59214,120,0,120,0.0,1.0
20137,59215,1135,0,1135,0.0,1.0
20138,59217,100,0,100,0.0,1.0
20139,59218,927,0,927,0.0,1.0
20140,59219,199,0,199,0.0,1.0
20141,59221,1658,0,1658,0.0,1.0
20142,59222,221,0,221,0.0,1.0
20143,59223,364,0,364,0.0,1.0
20144,59225,560,0,560,0.0,1.0
20145,59226,410,0,410,0.0,1.0
20146,59230,4490,3301,1189,0.735,0.265
20147,59231,264,0,264,0.0,1.0
20148,59240,21,0,21,0.0,1.0
20149,59241,413,0,413,0.0,1.0
20150,59242,79,0,79,0.0,1.0
20151,59243,345,0,345,0.0,1.0
20152,59244,65,0,65,0.0,1.0
20153,59247,314,0,314,0.0,1.0
20154,59248,762,0,762,0.0,1.0
20155,59250,198,0,198,0.0,1.0
20156,59252,115,0,115,0.0,1.0
20157,59253,112,0,112,0.0,1.0
20158,59254,2026,0,2026,0.0,1.0
20159,59255,3429,2743,686,0.8,0.2
20160,59256,59,0,59,0.0,1.0
20161,59257,61,0,61,0.0,1.0
20162,59258,110,0,110,0.0,1.0
20163,59259,348,0,348,0.0,1.0
20164,59260,110,0,110,0.0,1.0
20165,59261,520,0,520,0.0,1.0
20166,59262,655,0,655,0.0,1.0
20167,59263,1349,0,1349,0.0,1.0
20168,59270,7339,5438,1901,0.741,0.259
20169,59274,206,0,206,0.0,1.0
20170,59275,376,0,376,0.0,1.0
20171,59276,40,0,40,0.0,1.0
20172,59301,11404,9604,1800,0.842,0.158
20173,59311,159,0,159,0.0,1.0
20174,59312,31,0,31,0.0,1.0
20175,59313,2498,0,2498,0.0,1.0
20176,59314,112,0,112,0.0,1.0
20177,59315,150,0,150,0.0,1.0
20178,59317,1164,0,1164,0.0,1.0
20179,59318,136,0,136,0.0,1.0
20180,59322,85,0,85,0.0,1.0
20181,59323,2294,0,2294,0.0,1.0
20182,59324,821,0,821,0.0,1.0
20183,59326,265,0,265,0.0,1.0
20184,59327,2945,0,2945,0.0,1.0
20185,59330,8307,6494,1813,0.782,0.218
20186,59332,146,0,146,0.0,1.0
20187,59333,21,0,21,0.0,1.0
20188,59336,192,0,192,0.0,1.0
20189,59337,812,0,812,0.0,1.0
20190,59338,142,0,142,0.0,1.0
20191,59339,149,0,149,0.0,1.0
20192,59343,82,0,82,0.0,1.0
20193,59344,300,0,300,0.0,1.0
20194,59347,321,0,321,0.0,1.0
20195,59349,913,0,913,0.0,1.0
20196,59351,200,0,200,0.0,1.0
20197,59353,1017,0,1017,0.0,1.0
20198,59354,41,0,41,0.0,1.0
20199,59401,13774,13774,0,1.0,0.0
20200,59404,26867,20950,5917,0.78,0.22
20201,59405,31438,29701,1737,0.945,0.055
20202,59410,666,0,666,0.0,1.0
20203,59411,460,0,460,0.0,1.0
20204,59412,1747,0,1747,0.0,1.0
20205,59414,904,782,122,0.865,0.135
20206,59416,337,0,337,0.0,1.0
20207,59417,7719,4624,3095,0.599,0.401
20208,59418,95,0,95,0.0,1.0
20209,59419,96,0,96,0.0,1.0
20210,59420,243,0,243,0.0,1.0
20211,59421,1831,0,1831,0.0,1.0
20212,59422,2643,0,2643,0.0,1.0
20213,59424,87,0,87,0.0,1.0
20214,59425,3751,2578,1173,0.687,0.313
20215,59427,4757,2878,1879,0.605,0.395
20216,59430,454,0,454,0.0,1.0
20217,59432,104,0,104,0.0,1.0
20218,59433,594,0,594,0.0,1.0
20219,59434,463,0,463,0.0,1.0
20220,59436,1827,0,1827,0.0,1.0
20221,59440,175,0,175,0.0,1.0
20222,59441,82,0,82,0.0,1.0
20223,59442,1789,0,1789,0.0,1.0
20224,59443,612,0,612,0.0,1.0
20225,59444,355,0,355,0.0,1.0
20226,59446,564,0,564,0.0,1.0
20227,59447,250,0,250,0.0,1.0
20228,59448,743,0,743,0.0,1.0
20229,59450,467,0,467,0.0,1.0
20230,59451,241,0,241,0.0,1.0
20231,59452,525,0,525,0.0,1.0
20232,59453,362,0,362,0.0,1.0
20233,59454,201,0,201,0.0,1.0
20234,59456,233,0,233,0.0,1.0
20235,59457,9105,6090,3015,0.669,0.331
20236,59460,233,0,233,0.0,1.0
20237,59461,33,0,33,0.0,1.0
20238,59462,168,0,168,0.0,1.0
20239,59463,169,0,169,0.0,1.0
20240,59464,500,0,500,0.0,1.0
20241,59465,52,0,52,0.0,1.0
20242,59466,97,0,97,0.0,1.0
20243,59467,259,0,259,0.0,1.0
20244,59468,571,0,571,0.0,1.0
20245,59469,157,0,157,0.0,1.0
20246,59471,295,0,295,0.0,1.0
20247,59472,657,0,657,0.0,1.0
20248,59474,3820,3037,783,0.795,0.205
20249,59477,521,0,521,0.0,1.0
20250,59479,826,0,826,0.0,1.0
20251,59480,383,0,383,0.0,1.0
20252,59482,802,0,802,0.0,1.0
20253,59483,530,0,530,0.0,1.0
20254,59484,111,0,111,0.0,1.0
20255,59485,705,0,705,0.0,1.0
20256,59486,1328,0,1328,0.0,1.0
20257,59487,1240,0,1240,0.0,1.0
20258,59489,396,0,396,0.0,1.0
20259,59501,12638,9657,2981,0.764,0.236
20260,59520,1030,0,1030,0.0,1.0
20261,59521,3475,0,3475,0.0,1.0
20262,59522,1755,0,1755,0.0,1.0
20263,59523,2287,0,2287,0.0,1.0
20264,59524,663,0,663,0.0,1.0
20265,59525,384,0,384,0.0,1.0
20266,59526,2435,0,2435,0.0,1.0
20267,59527,974,0,974,0.0,1.0
20268,59528,208,0,208,0.0,1.0
20269,59529,163,0,163,0.0,1.0
20270,59530,99,0,99,0.0,1.0
20271,59531,241,0,241,0.0,1.0
20272,59532,180,0,180,0.0,1.0
20273,59535,74,0,74,0.0,1.0
20274,59537,96,0,96,0.0,1.0
20275,59538,3037,0,3037,0.0,1.0
20276,59540,371,0,371,0.0,1.0
20277,59542,192,0,192,0.0,1.0
20278,59544,175,0,175,0.0,1.0
20279,59545,39,0,39,0.0,1.0
20280,59546,129,0,129,0.0,1.0
20281,59547,38,0,38,0.0,1.0
20282,59601,29283,27509,1774,0.939,0.061
20283,59602,24285,11628,12657,0.479,0.521
20284,59631,237,0,237,0.0,1.0
20285,59632,1939,0,1939,0.0,1.0
20286,59633,206,0,206,0.0,1.0
20287,59634,4819,0,4819,0.0,1.0
20288,59635,7282,5909,1373,0.811,0.189
20289,59636,12,9,3,0.75,0.25
20290,59638,617,0,617,0.0,1.0
20291,59639,1286,0,1286,0.0,1.0
20292,59640,89,0,89,0.0,1.0
20293,59642,62,0,62,0.0,1.0
20294,59643,437,0,437,0.0,1.0
20295,59644,4036,0,4036,0.0,1.0
20296,59645,1635,0,1635,0.0,1.0
20297,59647,334,0,334,0.0,1.0
20298,59648,635,0,635,0.0,1.0
20299,59701,33147,30287,2860,0.914,0.086
20300,59703,43,0,43,0.0,1.0
20301,59710,286,0,286,0.0,1.0
20302,59711,8933,6170,2763,0.691,0.309
20303,59713,213,0,213,0.0,1.0
20304,59714,18182,13797,4385,0.759,0.241
20305,59715,31567,25071,6496,0.794,0.206
20306,59716,1798,0,1798,0.0,1.0
20307,59718,27367,20620,6747,0.753,0.247
20308,59720,191,0,191,0.0,1.0
20309,59721,433,0,433,0.0,1.0
20310,59722,5781,3217,2564,0.556,0.444
20311,59724,128,0,128,0.0,1.0
20312,59725,7963,4609,3354,0.579,0.421
20313,59727,221,0,221,0.0,1.0
20314,59728,343,0,343,0.0,1.0
20315,59729,2141,0,2141,0.0,1.0
20316,59730,1790,0,1790,0.0,1.0
20317,59731,209,0,209,0.0,1.0
20318,59732,128,0,128,0.0,1.0
20319,59733,198,0,198,0.0,1.0
20320,59735,331,0,331,0.0,1.0
20321,59736,127,0,127,0.0,1.0
20322,59739,340,0,340,0.0,1.0
20323,59740,495,0,495,0.0,1.0
20324,59741,4352,0,4352,0.0,1.0
20325,59743,134,0,134,0.0,1.0
20326,59745,134,0,134,0.0,1.0
20327,59746,92,0,92,0.0,1.0
20328,59747,159,0,159,0.0,1.0
20329,59748,254,0,254,0.0,1.0
20330,59749,1513,0,1513,0.0,1.0
20331,59750,309,0,309,0.0,1.0
20332,59751,208,0,208,0.0,1.0
20333,59752,3431,0,3431,0.0,1.0
20334,59754,964,0,964,0.0,1.0
20335,59755,210,0,210,0.0,1.0
20336,59756,463,0,463,0.0,1.0
20337,59758,1769,0,1769,0.0,1.0
20338,59759,3643,0,3643,0.0,1.0
20339,59760,260,0,260,0.0,1.0
20340,59761,265,0,265,0.0,1.0
20341,59762,258,0,258,0.0,1.0
20342,59801,30940,30940,0,1.0,0.0
20343,59802,18407,17358,1049,0.943,0.057
20344,59803,16203,14856,1347,0.917,0.083
20345,59804,7533,5986,1547,0.795,0.205
20346,59808,17904,12768,5136,0.713,0.287
20347,59820,1361,0,1361,0.0,1.0
20348,59821,2377,0,2377,0.0,1.0
20349,59823,1561,74,1487,0.047,0.953
20350,59824,1792,0,1792,0.0,1.0
20351,59825,2412,2,2410,0.001,0.999
20352,59826,521,0,521,0.0,1.0
20353,59827,300,0,300,0.0,1.0
20354,59828,5543,0,5543,0.0,1.0
20355,59829,2679,0,2679,0.0,1.0
20356,59830,146,0,146,0.0,1.0
20357,59831,454,0,454,0.0,1.0
20358,59832,765,0,765,0.0,1.0
20359,59833,5448,0,5448,0.0,1.0
20360,59834,2240,0,2240,0.0,1.0
20361,59837,407,0,407,0.0,1.0
20362,59840,13052,6182,6870,0.474,0.526
20363,59841,917,0,917,0.0,1.0
20364,59842,90,0,90,0.0,1.0
20365,59843,260,0,260,0.0,1.0
20366,59844,736,0,736,0.0,1.0
20367,59845,1186,0,1186,0.0,1.0
20368,59846,1617,0,1617,0.0,1.0
20369,59847,5658,2739,2919,0.484,0.516
20370,59848,106,0,106,0.0,1.0
20371,59851,173,173,0,1.0,0.0
20372,59853,699,0,699,0.0,1.0
20373,59854,239,0,239,0.0,1.0
20374,59855,957,0,957,0.0,1.0
20375,59856,347,0,347,0.0,1.0
20376,59858,1538,0,1538,0.0,1.0
20377,59859,3270,0,3270,0.0,1.0
20378,59860,9913,4763,5150,0.48,0.52
20379,59863,76,0,76,0.0,1.0
20380,59864,6752,0,6752,0.0,1.0
20381,59865,3185,0,3185,0.0,1.0
20382,59866,943,0,943,0.0,1.0
20383,59867,28,0,28,0.0,1.0
20384,59868,2054,0,2054,0.0,1.0
20385,59870,9617,0,9617,0.0,1.0
20386,59871,218,0,218,0.0,1.0
20387,59872,2309,0,2309,0.0,1.0
20388,59873,3085,0,3085,0.0,1.0
20389,59874,1568,0,1568,0.0,1.0
20390,59875,3537,0,3537,0.0,1.0
20391,59901,49693,31785,17908,0.64,0.36
20392,59910,356,0,356,0.0,1.0
20393,59911,7678,0,7678,0.0,1.0
20394,59912,13499,6029,7470,0.447,0.553
20395,59913,675,0,675,0.0,1.0
20396,59914,234,0,234,0.0,1.0
20397,59915,403,0,403,0.0,1.0
20398,59916,130,0,130,0.0,1.0
20399,59917,4225,0,4225,0.0,1.0
20400,59918,592,0,592,0.0,1.0
20401,59919,839,0,839,0.0,1.0
20402,59920,1680,0,1680,0.0,1.0
20403,59922,2408,0,2408,0.0,1.0
20404,59923,9856,3978,5878,0.404,0.596
20405,59925,1435,0,1435,0.0,1.0
20406,59926,513,0,513,0.0,1.0
20407,59927,368,0,368,0.0,1.0
20408,59928,88,0,88,0.0,1.0
20409,59929,237,0,237,0.0,1.0
20410,59930,867,0,867,0.0,1.0
20411,59931,328,0,328,0.0,1.0
20412,59932,1648,0,1648,0.0,1.0
20413,59933,43,0,43,0.0,1.0
20414,59934,528,0,528,0.0,1.0
20415,59935,3576,0,3576,0.0,1.0
20416,59936,367,0,367,0.0,1.0
20417,59937,12588,6300,6288,0.5,0.5
20418,60002,24299,22839,1460,0.94,0.06
20419,60004,50582,50582,0,1.0,0.0
20420,60005,29308,29308,0,1.0,0.0
20421,60007,33820,33820,0,1.0,0.0
20422,60008,22717,22717,0,1.0,0.0
20423,60010,44095,40424,3671,0.917,0.083
20424,60012,11120,9936,1184,0.894,0.106
20425,60013,26872,26858,14,0.999,0.001
20426,60014,48550,48085,465,0.99,0.01
20427,60015,26800,26800,0,1.0,0.0
20428,60016,59690,59690,0,1.0,0.0
20429,60018,30099,30099,0,1.0,0.0
20430,60020,9825,9823,2,1.0,0.0
20431,60021,5545,5543,2,1.0,0.0
20432,60022,8153,8153,0,1.0,0.0
20433,60025,39105,39105,0,1.0,0.0
20434,60026,13335,13335,0,1.0,0.0
20435,60029,482,482,0,1.0,0.0
20436,60030,36056,35547,509,0.986,0.014
20437,60031,37947,37913,34,0.999,0.001
20438,60033,13922,9940,3982,0.714,0.286
20439,60034,2040,0,2040,0.0,1.0
20440,60035,29763,29763,0,1.0,0.0
20441,60040,5431,5431,0,1.0,0.0
20442,60041,9250,9024,226,0.976,0.024
20443,60042,8547,8515,32,0.996,0.004
20444,60043,2513,2513,0,1.0,0.0
20445,60044,9792,9792,0,1.0,0.0
20446,60045,20925,20789,136,0.994,0.006
20447,60046,35111,33904,1207,0.966,0.034
20448,60047,41669,41667,2,1.0,0.0
20449,60048,29095,29038,57,0.998,0.002
20450,60050,31620,30020,1600,0.949,0.051
20451,60051,25192,23317,1875,0.926,0.074
20452,60053,23260,23260,0,1.0,0.0
20453,60056,55219,55219,0,1.0,0.0
20454,60060,37189,36106,1083,0.971,0.029
20455,60061,25748,25748,0,1.0,0.0
20456,60062,39936,39936,0,1.0,0.0
20457,60064,15407,15407,0,1.0,0.0
20458,60067,38585,38585,0,1.0,0.0
20459,60068,37475,37475,0,1.0,0.0
20460,60069,8384,8039,345,0.959,0.041
20461,60070,16001,16001,0,1.0,0.0
20462,60071,3598,2023,1575,0.562,0.438
20463,60072,928,612,316,0.659,0.341
20464,60073,60002,59579,423,0.993,0.007
20465,60074,38985,38985,0,1.0,0.0
20466,60076,33415,33415,0,1.0,0.0
20467,60077,26825,26825,0,1.0,0.0
20468,60081,10079,9427,652,0.935,0.065
20469,60083,9838,8686,1152,0.883,0.117
20470,60084,16771,16072,699,0.958,0.042
20471,60085,71714,71714,0,1.0,0.0
20472,60087,26978,26946,32,0.999,0.001
20473,60088,15761,15761,0,1.0,0.0
20474,60089,41533,41533,0,1.0,0.0
20475,60090,37633,37633,0,1.0,0.0
20476,60091,27020,27020,0,1.0,0.0
20477,60093,19570,19570,0,1.0,0.0
20478,60096,6897,6897,0,1.0,0.0
20479,60097,11250,10302,948,0.916,0.084
20480,60098,32228,25588,6640,0.794,0.206
20481,60099,31104,30555,549,0.982,0.018
20482,60101,39119,39119,0,1.0,0.0
20483,60102,32193,32077,116,0.996,0.004
20484,60103,41928,41918,10,1.0,0.0
20485,60104,19038,19038,0,1.0,0.0
20486,60106,20309,20309,0,1.0,0.0
20487,60107,39927,39927,0,1.0,0.0
20488,60108,22735,22735,0,1.0,0.0
20489,60109,560,0,560,0.0,1.0
20490,60110,38557,38557,0,1.0,0.0
20491,60111,258,0,258,0.0,1.0
20492,60112,4560,4324,236,0.948,0.052
20493,60113,337,0,337,0.0,1.0
20494,60115,46272,45069,1203,0.974,0.026
20495,60118,15851,15700,151,0.99,0.01
20496,60119,10371,7865,2506,0.758,0.242
20497,60120,50955,50900,55,0.999,0.001
20498,60123,47405,47405,0,1.0,0.0
20499,60124,18935,15935,3000,0.842,0.158
20500,60126,46371,46371,0,1.0,0.0
20501,60129,242,0,242,0.0,1.0
20502,60130,14167,14167,0,1.0,0.0
20503,60131,18097,18097,0,1.0,0.0
20504,60133,38103,38103,0,1.0,0.0
20505,60134,28565,27974,591,0.979,0.021
20506,60135,7248,5185,2063,0.715,0.285
20507,60136,7013,6816,197,0.972,0.028
20508,60137,37805,37805,0,1.0,0.0
20509,60139,34381,34381,0,1.0,0.0
20510,60140,14341,10275,4066,0.716,0.284
20511,60141,224,224,0,1.0,0.0
20512,60142,26447,24224,2223,0.916,0.084
20513,60143,10360,10360,0,1.0,0.0
20514,60144,58,0,58,0.0,1.0
20515,60145,2627,1228,1399,0.467,0.533
20516,60146,2713,0,2713,0.0,1.0
20517,60148,51468,51468,0,1.0,0.0
20518,60150,1794,0,1794,0.0,1.0
20519,60151,4061,208,3853,0.051,0.949
20520,60152,12533,7731,4802,0.617,0.383
20521,60153,24106,24106,0,1.0,0.0
20522,60154,16773,16773,0,1.0,0.0
20523,60155,7927,7927,0,1.0,0.0
20524,60156,28987,28987,0,1.0,0.0
20525,60157,2380,2380,0,1.0,0.0
20526,60160,25432,25432,0,1.0,0.0
20527,60162,8111,8111,0,1.0,0.0
20528,60163,5209,5209,0,1.0,0.0
20529,60164,22048,22048,0,1.0,0.0
20530,60165,4946,4946,0,1.0,0.0
20531,60169,33847,33847,0,1.0,0.0
20532,60171,10246,10246,0,1.0,0.0
20533,60172,24537,24537,0,1.0,0.0
20534,60173,12217,12217,0,1.0,0.0
20535,60174,30752,30752,0,1.0,0.0
20536,60175,25564,25140,424,0.983,0.017
20537,60176,11795,11795,0,1.0,0.0
20538,60177,22659,22659,0,1.0,0.0
20539,60178,21840,19152,2688,0.877,0.123
20540,60180,1694,0,1694,0.0,1.0
20541,60181,28836,28836,0,1.0,0.0
20542,60184,2448,2387,61,0.975,0.025
20543,60185,36527,36509,18,1.0,0.0
20544,60187,29016,29016,0,1.0,0.0
20545,60188,42656,42656,0,1.0,0.0
20546,60189,30472,30472,0,1.0,0.0
20547,60190,10663,10663,0,1.0,0.0
20548,60191,14310,14310,0,1.0,0.0
20549,60192,16343,16343,0,1.0,0.0
20550,60193,39188,39188,0,1.0,0.0
20551,60194,19777,19777,0,1.0,0.0
20552,60195,4769,4769,0,1.0,0.0
20553,60201,43125,43125,0,1.0,0.0
20554,60202,31361,31361,0,1.0,0.0
20555,60203,4523,4523,0,1.0,0.0
20556,60301,2539,2539,0,1.0,0.0
20557,60302,32108,32108,0,1.0,0.0
20558,60304,17231,17231,0,1.0,0.0
20559,60305,11172,11172,0,1.0,0.0
20560,60401,7797,5192,2605,0.666,0.334
20561,60402,63448,63448,0,1.0,0.0
20562,60403,17529,17062,467,0.973,0.027
20563,60404,17395,16861,534,0.969,0.031
20564,60406,25460,25460,0,1.0,0.0
20565,60407,1684,1119,565,0.664,0.336
20566,60408,5696,5585,111,0.981,0.019
20567,60409,37186,37186,0,1.0,0.0
20568,60410,12687,12412,275,0.978,0.022
20569,60411,58136,57945,191,0.997,0.003
20570,60415,14139,14139,0,1.0,0.0
20571,60416,9397,8667,730,0.922,0.078
20572,60417,15547,12589,2958,0.81,0.19
20573,60419,22788,22788,0,1.0,0.0
20574,60420,6102,5353,749,0.877,0.123
20575,60421,3968,2313,1655,0.583,0.417
20576,60422,9403,9403,0,1.0,0.0
20577,60423,30423,28736,1687,0.945,0.055
20578,60424,2440,0,2440,0.0,1.0
20579,60425,9117,9117,0,1.0,0.0
20580,60426,29594,29594,0,1.0,0.0
20581,60428,12203,12203,0,1.0,0.0
20582,60429,15630,15630,0,1.0,0.0
20583,60430,20094,20094,0,1.0,0.0
20584,60431,22577,22117,460,0.98,0.02
20585,60432,21403,21390,13,0.999,0.001
20586,60433,17160,16893,267,0.984,0.016
20587,60435,48899,48899,0,1.0,0.0
20588,60436,18315,18204,111,0.994,0.006
20589,60437,187,0,187,0.0,1.0
20590,60438,28884,28884,0,1.0,0.0
20591,60439,22919,22751,168,0.993,0.007
20592,60440,52911,52911,0,1.0,0.0
20593,60441,36869,36777,92,0.998,0.002
20594,60442,9924,7537,2387,0.759,0.241
20595,60443,21145,21129,16,0.999,0.001
20596,60444,1761,0,1761,0.0,1.0
20597,60445,26057,26057,0,1.0,0.0
20598,60446,39807,39197,610,0.985,0.015
20599,60447,13709,12313,1396,0.898,0.102
20600,60448,24423,24280,143,0.994,0.006
20601,60449,9217,5270,3947,0.572,0.428
20602,60450,20332,16304,4028,0.802,0.198
20603,60451,34063,33717,346,0.99,0.01
20604,60452,27969,27969,0,1.0,0.0
20605,60453,56855,56855,0,1.0,0.0
20606,60455,16446,16446,0,1.0,0.0
20607,60456,4349,4349,0,1.0,0.0
20608,60457,14049,14049,0,1.0,0.0
20609,60458,14428,14428,0,1.0,0.0
20610,60459,28929,28929,0,1.0,0.0
20611,60460,1522,0,1522,0.0,1.0
20612,60461,4836,4836,0,1.0,0.0
20613,60462,38723,38723,0,1.0,0.0
20614,60463,14671,14671,0,1.0,0.0
20615,60464,9620,9525,95,0.99,0.01
20616,60465,17495,17484,11,0.999,0.001
20617,60466,22115,22115,0,1.0,0.0
20618,60467,26046,26045,1,1.0,0.0
20619,60468,6116,4172,1944,0.682,0.318
20620,60469,5930,5930,0,1.0,0.0
20621,60470,616,0,616,0.0,1.0
20622,60471,14101,14003,98,0.993,0.007
20623,60472,5390,5390,0,1.0,0.0
20624,60473,22439,22439,0,1.0,0.0
20625,60474,760,0,760,0.0,1.0
20626,60475,9870,9870,0,1.0,0.0
20627,60476,2391,2391,0,1.0,0.0
20628,60477,38161,38161,0,1.0,0.0
20629,60478,16833,16833,0,1.0,0.0
20630,60479,760,0,760,0.0,1.0
20631,60480,5246,5171,75,0.986,0.014
20632,60481,11851,6678,5173,0.563,0.437
20633,60482,11063,11063,0,1.0,0.0
20634,60484,6829,6826,3,1.0,0.0
20635,60487,26928,26928,0,1.0,0.0
20636,60490,20463,20463,0,1.0,0.0
20637,60491,22743,21573,1170,0.949,0.051
20638,60501,11626,11626,0,1.0,0.0
20639,60502,21873,21775,98,0.996,0.004
20640,60503,16717,16717,0,1.0,0.0
20641,60504,37919,37919,0,1.0,0.0
20642,60505,76573,76573,0,1.0,0.0
20643,60506,53013,52873,140,0.997,0.003
20644,60510,28897,28714,183,0.994,0.006
20645,60511,1793,0,1793,0.0,1.0
20646,60512,1111,809,302,0.728,0.272
20647,60513,19047,19047,0,1.0,0.0
20648,60514,9708,9708,0,1.0,0.0
20649,60515,27503,27503,0,1.0,0.0
20650,60516,29084,29084,0,1.0,0.0
20651,60517,32038,32019,19,0.999,0.001
20652,60518,3580,0,3580,0.0,1.0
20653,60519,88,88,0,1.0,0.0
20654,60520,2886,0,2886,0.0,1.0
20655,60521,17597,17597,0,1.0,0.0
20656,60523,9890,9890,0,1.0,0.0
20657,60525,31168,31168,0,1.0,0.0
20658,60526,13576,13576,0,1.0,0.0
20659,60527,27486,27440,46,0.998,0.002
20660,60530,649,0,649,0.0,1.0
20661,60531,1902,0,1902,0.0,1.0
20662,60532,27066,27066,0,1.0,0.0
20663,60534,10649,10649,0,1.0,0.0
20664,60536,126,0,126,0.0,1.0
20665,60537,665,0,665,0.0,1.0
20666,60538,26619,26582,37,0.999,0.001
20667,60539,341,341,0,1.0,0.0
20668,60540,42910,42910,0,1.0,0.0
20669,60541,3148,0,3148,0.0,1.0
20670,60542,17099,17013,86,0.995,0.005
20671,60543,36156,33691,2465,0.932,0.068
20672,60544,25959,25635,324,0.988,0.012
20673,60545,12940,11149,1791,0.862,0.138
20674,60546,15668,15668,0,1.0,0.0
20675,60548,12218,10475,1743,0.857,0.143
20676,60549,643,0,643,0.0,1.0
20677,60550,1440,0,1440,0.0,1.0
20678,60551,5062,0,5062,0.0,1.0
20679,60552,4448,3919,529,0.881,0.119
20680,60553,782,0,782,0.0,1.0
20681,60554,11796,10684,1112,0.906,0.094
20682,60555,13538,13538,0,1.0,0.0
20683,60556,2007,0,2007,0.0,1.0
20684,60557,155,0,155,0.0,1.0
20685,60558,12960,12960,0,1.0,0.0
20686,60559,24852,24852,0,1.0,0.0
20687,60560,22415,20307,2108,0.906,0.094
20688,60561,23115,23115,0,1.0,0.0
20689,60563,35922,35922,0,1.0,0.0
20690,60564,41312,41240,72,0.998,0.002
20691,60565,40524,40524,0,1.0,0.0
20692,60585,22311,22223,88,0.996,0.004
20693,60586,46251,46138,113,0.998,0.002
20694,60601,11110,11110,0,1.0,0.0
20695,60602,1204,1204,0,1.0,0.0
20696,60603,493,493,0,1.0,0.0
20697,60604,570,570,0,1.0,0.0
20698,60605,24668,24668,0,1.0,0.0
20699,60606,2308,2308,0,1.0,0.0
20700,60607,23897,23897,0,1.0,0.0
20701,60608,82739,82739,0,1.0,0.0
20702,60609,64906,64906,0,1.0,0.0
20703,60610,37726,37726,0,1.0,0.0
20704,60611,28718,28718,0,1.0,0.0
20705,60612,33472,33472,0,1.0,0.0
20706,60613,48281,48281,0,1.0,0.0
20707,60614,66617,66617,0,1.0,0.0
20708,60615,40603,40603,0,1.0,0.0
20709,60616,48433,48433,0,1.0,0.0
20710,60617,84155,84155,0,1.0,0.0
20711,60618,92084,92084,0,1.0,0.0
20712,60619,63825,63825,0,1.0,0.0
20713,60620,72216,72216,0,1.0,0.0
20714,60621,35912,35912,0,1.0,0.0
20715,60622,52548,52548,0,1.0,0.0
20716,60623,92108,92108,0,1.0,0.0
20717,60624,38105,38105,0,1.0,0.0
20718,60625,78651,78651,0,1.0,0.0
20719,60626,50139,50139,0,1.0,0.0
20720,60628,72202,72202,0,1.0,0.0
20721,60629,113916,113916,0,1.0,0.0
20722,60630,54093,54093,0,1.0,0.0
20723,60631,28641,28641,0,1.0,0.0
20724,60632,91326,91326,0,1.0,0.0
20725,60633,12927,12927,0,1.0,0.0
20726,60634,74298,74298,0,1.0,0.0
20727,60636,40916,40916,0,1.0,0.0
20728,60637,49503,49503,0,1.0,0.0
20729,60638,55026,55026,0,1.0,0.0
20730,60639,90407,90407,0,1.0,0.0
20731,60640,65790,65790,0,1.0,0.0
20732,60641,71663,71663,0,1.0,0.0
20733,60642,18480,18480,0,1.0,0.0
20734,60643,49952,49952,0,1.0,0.0
20735,60644,48648,48648,0,1.0,0.0
20736,60645,45274,45274,0,1.0,0.0
20737,60646,27177,27177,0,1.0,0.0
20738,60647,87291,87291,0,1.0,0.0
20739,60649,46650,46650,0,1.0,0.0
20740,60651,64267,64267,0,1.0,0.0
20741,60652,40959,40959,0,1.0,0.0
20742,60653,29908,29908,0,1.0,0.0
20743,60654,14875,14875,0,1.0,0.0
20744,60655,28550,28550,0,1.0,0.0
20745,60656,27613,27613,0,1.0,0.0
20746,60657,65996,65996,0,1.0,0.0
20747,60659,38104,38104,0,1.0,0.0
20748,60660,42752,42752,0,1.0,0.0
20749,60661,7792,7792,0,1.0,0.0
20750,60706,23134,23134,0,1.0,0.0
20751,60707,42920,42920,0,1.0,0.0
20752,60712,12590,12590,0,1.0,0.0
20753,60714,29931,29931,0,1.0,0.0
20754,60803,22285,22285,0,1.0,0.0
20755,60804,84573,84573,0,1.0,0.0
20756,60805,19852,19852,0,1.0,0.0
20757,60827,27946,27946,0,1.0,0.0
20758,60901,37157,32559,4598,0.876,0.124
20759,60910,538,495,43,0.92,0.08
20760,60911,1372,0,1372,0.0,1.0
20761,60912,599,0,599,0.0,1.0
20762,60913,1617,0,1617,0.0,1.0
20763,60914,29107,27016,2091,0.928,0.072
20764,60915,10774,10774,0,1.0,0.0
20765,60917,574,0,574,0.0,1.0
20766,60918,898,0,898,0.0,1.0
20767,60919,558,0,558,0.0,1.0
20768,60920,178,0,178,0.0,1.0
20769,60921,1519,0,1519,0.0,1.0
20770,60922,2459,46,2413,0.019,0.981
20771,60924,1635,0,1635,0.0,1.0
20772,60926,67,0,67,0.0,1.0
20773,60927,2404,0,2404,0.0,1.0
20774,60928,709,0,709,0.0,1.0
20775,60929,730,0,730,0.0,1.0
20776,60930,918,0,918,0.0,1.0
20777,60931,615,0,615,0.0,1.0
20778,60932,78,0,78,0.0,1.0
20779,60933,302,0,302,0.0,1.0
20780,60934,273,0,273,0.0,1.0
20781,60935,1064,0,1064,0.0,1.0
20782,60936,4321,3615,706,0.837,0.163
20783,60938,2131,1725,406,0.809,0.191
20784,60940,3369,0,3369,0.0,1.0
20785,60941,2039,0,2039,0.0,1.0
20786,60942,6181,5116,1065,0.828,0.172
20787,60945,153,0,153,0.0,1.0
20788,60946,426,0,426,0.0,1.0
20789,60948,1533,333,1200,0.217,0.783
20790,60949,636,0,636,0.0,1.0
20791,60950,12168,10496,1672,0.863,0.137
20792,60951,961,0,961,0.0,1.0
20793,60952,684,0,684,0.0,1.0
20794,60953,2469,0,2469,0.0,1.0
20795,60954,6104,3777,2327,0.619,0.381
20796,60955,1901,1285,616,0.676,0.324
20797,60957,5615,4583,1032,0.816,0.184
20798,60958,2135,0,2135,0.0,1.0
20799,60959,1082,0,1082,0.0,1.0
20800,60960,1064,0,1064,0.0,1.0
20801,60961,700,0,700,0.0,1.0
20802,60962,524,0,524,0.0,1.0
20803,60963,1807,0,1807,0.0,1.0
20804,60964,4968,540,4428,0.109,0.891
20805,60966,1526,0,1526,0.0,1.0
20806,60968,433,0,433,0.0,1.0
20807,60969,65,0,65,0.0,1.0
20808,60970,7190,5055,2135,0.703,0.297
20809,60973,385,0,385,0.0,1.0
20810,60974,283,0,283,0.0,1.0
20811,61001,1179,0,1179,0.0,1.0
20812,61006,1759,0,1759,0.0,1.0
20813,61007,534,0,534,0.0,1.0
20814,61008,34311,30705,3606,0.895,0.105
20815,61010,8032,5798,2234,0.722,0.278
20816,61011,2945,1107,1838,0.376,0.624
20817,61012,2175,0,2175,0.0,1.0
20818,61013,528,0,528,0.0,1.0
20819,61014,1173,0,1173,0.0,1.0
20820,61015,946,0,946,0.0,1.0
20821,61016,4837,4022,815,0.832,0.168
20822,61018,1080,0,1080,0.0,1.0
20823,61019,3550,0,3550,0.0,1.0
20824,61020,3108,2570,538,0.827,0.173
20825,61021,23745,16858,6887,0.71,0.29
20826,61024,2620,0,2620,0.0,1.0
20827,61025,4867,3051,1816,0.627,0.373
20828,61027,52,0,52,0.0,1.0
20829,61028,1989,0,1989,0.0,1.0
20830,61030,2205,0,2205,0.0,1.0
20831,61031,1656,0,1656,0.0,1.0
20832,61032,31651,25980,5671,0.821,0.179
20833,61036,6821,3165,3656,0.464,0.536
20834,61037,140,100,40,0.714,0.286
20835,61038,1354,0,1354,0.0,1.0
20836,61039,802,0,802,0.0,1.0
20837,61041,1327,0,1327,0.0,1.0
20838,61042,527,0,527,0.0,1.0
20839,61043,131,61,70,0.466,0.534
20840,61044,232,0,232,0.0,1.0
20841,61046,2831,0,2831,0.0,1.0
20842,61047,1711,0,1711,0.0,1.0
20843,61048,4360,2602,1758,0.597,0.403
20844,61049,585,0,585,0.0,1.0
20845,61050,376,0,376,0.0,1.0
20846,61051,1574,0,1574,0.0,1.0
20847,61052,1148,0,1148,0.0,1.0
20848,61053,2852,0,2852,0.0,1.0
20849,61054,3973,3457,516,0.87,0.13
20850,61057,168,0,168,0.0,1.0
20851,61059,141,0,141,0.0,1.0
20852,61060,1432,0,1432,0.0,1.0
20853,61061,7009,3813,3196,0.544,0.456
20854,61062,1983,0,1983,0.0,1.0
20855,61063,4132,0,4132,0.0,1.0
20856,61064,3868,0,3868,0.0,1.0
20857,61065,11156,9954,1202,0.892,0.108
20858,61067,811,0,811,0.0,1.0
20859,61068,14858,11342,3516,0.763,0.237
20860,61070,1130,0,1130,0.0,1.0
20861,61071,14381,11326,3055,0.788,0.212
20862,61072,11797,9453,2344,0.801,0.199
20863,61073,20052,18630,1422,0.929,0.071
20864,61074,4431,2789,1642,0.629,0.371
20865,61075,958,0,958,0.0,1.0
20866,61077,73,0,73,0.0,1.0
20867,61078,1374,0,1374,0.0,1.0
20868,61079,188,0,188,0.0,1.0
20869,61080,10599,9671,928,0.912,0.088
20870,61081,21934,17401,4533,0.793,0.207
20871,61084,3175,1259,1916,0.397,0.603
20872,61085,3443,0,3443,0.0,1.0
20873,61087,1670,0,1670,0.0,1.0
20874,61088,6020,3163,2857,0.525,0.475
20875,61089,867,0,867,0.0,1.0
20876,61091,63,0,63,0.0,1.0
20877,61101,21593,19500,2093,0.903,0.097
20878,61102,20538,17704,2834,0.862,0.138
20879,61103,24578,23742,836,0.966,0.034
20880,61104,19269,19269,0,1.0,0.0
20881,61107,30439,30439,0,1.0,0.0
20882,61108,28550,28550,0,1.0,0.0
20883,61109,28333,27552,781,0.972,0.028
20884,61111,23492,23444,48,0.998,0.002
20885,61112,86,86,0,1.0,0.0
20886,61114,15776,15776,0,1.0,0.0
20887,61115,23180,22808,372,0.984,0.016
20888,61201,39116,39098,18,1.0,0.0
20889,61230,1232,0,1232,0.0,1.0
20890,61231,5627,3655,1972,0.65,0.35
20891,61232,1284,0,1284,0.0,1.0
20892,61234,1258,0,1258,0.0,1.0
20893,61235,1391,0,1391,0.0,1.0
20894,61236,193,0,193,0.0,1.0
20895,61238,3247,0,3247,0.0,1.0
20896,61239,1219,1185,34,0.972,0.028
20897,61240,5870,4242,1628,0.723,0.277
20898,61241,7124,5410,1714,0.759,0.241
20899,61242,1145,0,1145,0.0,1.0
20900,61243,264,0,264,0.0,1.0
20901,61244,24053,23352,701,0.971,0.029
20902,61250,2737,0,2737,0.0,1.0
20903,61251,347,0,347,0.0,1.0
20904,61252,5436,3687,1749,0.678,0.322
20905,61254,11414,6531,4883,0.572,0.428
20906,61256,1822,1769,53,0.971,0.029
20907,61257,1210,0,1210,0.0,1.0
20908,61258,204,0,204,0.0,1.0
20909,61259,1276,0,1276,0.0,1.0
20910,61260,856,0,856,0.0,1.0
20911,61261,975,0,975,0.0,1.0
20912,61262,1188,0,1188,0.0,1.0
20913,61263,530,0,530,0.0,1.0
20914,61264,10548,7109,3439,0.674,0.326
20915,61265,45099,45099,0,1.0,0.0
20916,61270,7306,4139,3167,0.567,0.433
20917,61272,1504,0,1504,0.0,1.0
20918,61273,3316,0,3316,0.0,1.0
20919,61274,351,0,351,0.0,1.0
20920,61275,4347,1732,2615,0.398,0.602
20921,61276,138,0,138,0.0,1.0
20922,61277,3355,0,3355,0.0,1.0
20923,61278,412,345,67,0.837,0.163
20924,61279,1061,0,1061,0.0,1.0
20925,61281,2597,0,2597,0.0,1.0
20926,61282,7809,7809,0,1.0,0.0
20927,61283,1640,0,1640,0.0,1.0
20928,61284,2292,0,2292,0.0,1.0
20929,61285,1631,0,1631,0.0,1.0
20930,61301,10588,9627,961,0.909,0.091
20931,61310,3970,0,3970,0.0,1.0
20932,61311,232,0,232,0.0,1.0
20933,61312,474,0,474,0.0,1.0
20934,61313,282,0,282,0.0,1.0
20935,61314,807,0,807,0.0,1.0
20936,61315,322,0,322,0.0,1.0
20937,61316,282,0,282,0.0,1.0
20938,61317,513,0,513,0.0,1.0
20939,61318,700,0,700,0.0,1.0
20940,61319,1293,0,1293,0.0,1.0
20941,61320,710,549,161,0.773,0.227
20942,61321,282,0,282,0.0,1.0
20943,61322,1647,0,1647,0.0,1.0
20944,61323,111,0,111,0.0,1.0
20945,61324,109,0,109,0.0,1.0
20946,61325,1073,0,1073,0.0,1.0
20947,61326,2452,0,2452,0.0,1.0
20948,61327,1235,0,1235,0.0,1.0
20949,61328,42,0,42,0.0,1.0
20950,61329,1303,1167,136,0.896,0.104
20951,61330,1483,0,1483,0.0,1.0
20952,61331,55,0,55,0.0,1.0
20953,61332,134,0,134,0.0,1.0
20954,61333,381,0,381,0.0,1.0
20955,61334,741,0,741,0.0,1.0
20956,61335,532,0,532,0.0,1.0
20957,61336,628,0,628,0.0,1.0
20958,61337,478,0,478,0.0,1.0
20959,61338,284,0,284,0.0,1.0
20960,61340,292,0,292,0.0,1.0
20961,61341,8234,4877,3357,0.592,0.408
20962,61342,9216,7195,2021,0.781,0.219
20963,61344,374,0,374,0.0,1.0
20964,61345,846,0,846,0.0,1.0
20965,61346,75,0,75,0.0,1.0
20966,61348,4696,4001,695,0.852,0.148
20967,61349,977,0,977,0.0,1.0
20968,61350,24246,20612,3634,0.85,0.15
20969,61353,1333,0,1333,0.0,1.0
20970,61354,10870,10428,442,0.959,0.041
20971,61356,11281,8043,3238,0.713,0.287
20972,61358,478,0,478,0.0,1.0
20973,61359,312,0,312,0.0,1.0
20974,61360,3393,0,3393,0.0,1.0
20975,61361,1409,0,1409,0.0,1.0
20976,61362,5911,5114,797,0.865,0.135
20977,61363,220,0,220,0.0,1.0
20978,61364,20133,17797,2336,0.884,0.116
20979,61367,864,0,864,0.0,1.0
20980,61368,1489,0,1489,0.0,1.0
20981,61369,1711,0,1711,0.0,1.0
20982,61370,1460,0,1460,0.0,1.0
20983,61372,145,0,145,0.0,1.0
20984,61373,2031,1162,869,0.572,0.428
20985,61374,119,0,119,0.0,1.0
20986,61375,1156,0,1156,0.0,1.0
20987,61376,2280,0,2280,0.0,1.0
20988,61377,1457,0,1457,0.0,1.0
20989,61378,512,0,512,0.0,1.0
20990,61379,1359,0,1359,0.0,1.0
20991,61401,34788,32360,2428,0.93,0.07
20992,61410,3912,3389,523,0.866,0.134
20993,61411,378,0,378,0.0,1.0
20994,61412,1321,0,1321,0.0,1.0
20995,61413,1075,0,1075,0.0,1.0
20996,61414,854,0,854,0.0,1.0
20997,61415,1747,0,1747,0.0,1.0
20998,61416,235,0,235,0.0,1.0
20999,61417,259,0,259,0.0,1.0
21000,61418,673,0,673,0.0,1.0
21001,61419,128,0,128,0.0,1.0
21002,61420,1067,0,1067,0.0,1.0
21003,61421,1392,0,1392,0.0,1.0
21004,61422,3416,3045,371,0.891,0.109
21005,61423,682,0,682,0.0,1.0
21006,61424,100,0,100,0.0,1.0
21007,61425,483,25,458,0.052,0.948
21008,61426,107,0,107,0.0,1.0
21009,61427,2329,0,2329,0.0,1.0
21010,61428,986,0,986,0.0,1.0
21011,61430,828,607,221,0.733,0.267
21012,61431,371,0,371,0.0,1.0
21013,61432,676,0,676,0.0,1.0
21014,61433,74,0,74,0.0,1.0
21015,61434,3312,0,3312,0.0,1.0
21016,61435,116,0,116,0.0,1.0
21017,61436,951,0,951,0.0,1.0
21018,61437,818,0,818,0.0,1.0
21019,61438,760,0,760,0.0,1.0
21020,61439,269,0,269,0.0,1.0
21021,61440,766,0,766,0.0,1.0
21022,61441,897,0,897,0.0,1.0
21023,61442,762,0,762,0.0,1.0
21024,61443,14214,12857,1357,0.905,0.095
21025,61447,924,0,924,0.0,1.0
21026,61448,3823,3034,789,0.794,0.206
21027,61449,512,0,512,0.0,1.0
21028,61450,1742,0,1742,0.0,1.0
21029,61451,393,0,393,0.0,1.0
21030,61452,293,0,293,0.0,1.0
21031,61453,781,0,781,0.0,1.0
21032,61454,725,0,725,0.0,1.0
21033,61455,22086,19945,2141,0.903,0.097
21034,61458,822,0,822,0.0,1.0
21035,61459,433,0,433,0.0,1.0
21036,61460,291,0,291,0.0,1.0
21037,61462,11643,9654,1989,0.829,0.171
21038,61465,1213,0,1213,0.0,1.0
21039,61466,342,0,342,0.0,1.0
21040,61467,1048,0,1048,0.0,1.0
21041,61468,104,0,104,0.0,1.0
21042,61469,2184,0,2184,0.0,1.0
21043,61470,547,0,547,0.0,1.0
21044,61471,140,0,140,0.0,1.0
21045,61472,648,0,648,0.0,1.0
21046,61473,1667,0,1667,0.0,1.0
21047,61474,292,0,292,0.0,1.0
21048,61475,205,0,205,0.0,1.0
21049,61476,407,0,407,0.0,1.0
21050,61477,631,0,631,0.0,1.0
21051,61478,290,0,290,0.0,1.0
21052,61479,165,0,165,0.0,1.0
21053,61480,1324,0,1324,0.0,1.0
21054,61482,650,0,650,0.0,1.0
21055,61483,1961,0,1961,0.0,1.0
21056,61484,825,0,825,0.0,1.0
21057,61485,560,0,560,0.0,1.0
21058,61486,1552,0,1552,0.0,1.0
21059,61488,1120,0,1120,0.0,1.0
21060,61489,900,0,900,0.0,1.0
21061,61490,1091,0,1091,0.0,1.0
21062,61491,2197,0,2197,0.0,1.0
21063,61501,1921,0,1921,0.0,1.0
21064,61516,720,0,720,0.0,1.0
21065,61517,3259,0,3259,0.0,1.0
21066,61519,233,0,233,0.0,1.0
21067,61520,17839,14818,3021,0.831,0.169
21068,61523,11204,8538,2666,0.762,0.238
21069,61524,262,0,262,0.0,1.0
21070,61525,9021,7439,1582,0.825,0.175
21071,61526,1088,0,1088,0.0,1.0
21072,61528,2668,1000,1668,0.375,0.625
21073,61529,2880,2001,879,0.695,0.305
21074,61530,6713,5573,1140,0.83,0.17
21075,61531,3379,0,3379,0.0,1.0
21076,61532,534,0,534,0.0,1.0
21077,61533,2427,0,2427,0.0,1.0
21078,61534,1737,0,1737,0.0,1.0
21079,61535,1629,812,817,0.498,0.502
21080,61536,2919,23,2896,0.008,0.992
21081,61537,2974,0,2974,0.0,1.0
21082,61539,205,0,205,0.0,1.0
21083,61540,2916,0,2916,0.0,1.0
21084,61541,136,0,136,0.0,1.0
21085,61542,3794,0,3794,0.0,1.0
21086,61543,151,0,151,0.0,1.0
21087,61544,713,0,713,0.0,1.0
21088,61545,646,0,646,0.0,1.0
21089,61546,4276,0,4276,0.0,1.0
21090,61547,3779,447,3332,0.118,0.882
21091,61548,12085,7793,4292,0.645,0.355
21092,61550,17721,16239,1482,0.916,0.084
21093,61552,239,205,34,0.858,0.142
21094,61553,213,0,213,0.0,1.0
21095,61554,43810,40479,3331,0.924,0.076
21096,61559,3332,0,3332,0.0,1.0
21097,61560,754,0,754,0.0,1.0
21098,61561,2788,0,2788,0.0,1.0
21099,61562,46,46,0,1.0,0.0
21100,61563,526,0,526,0.0,1.0
21101,61564,1077,0,1077,0.0,1.0
21102,61565,1504,0,1504,0.0,1.0
21103,61567,624,0,624,0.0,1.0
21104,61568,4459,0,4459,0.0,1.0
21105,61569,1220,0,1220,0.0,1.0
21106,61570,1879,0,1879,0.0,1.0
21107,61571,23744,20823,2921,0.877,0.123
21108,61572,1068,659,409,0.617,0.383
21109,61602,1055,1055,0,1.0,0.0
21110,61603,17600,17600,0,1.0,0.0
21111,61604,31647,31554,93,0.997,0.003
21112,61605,16303,16303,0,1.0,0.0
21113,61606,8051,8051,0,1.0,0.0
21114,61607,10941,8894,2047,0.813,0.187
21115,61610,5476,5295,181,0.967,0.033
21116,61611,25268,21950,3318,0.869,0.131
21117,61614,27628,27628,0,1.0,0.0
21118,61615,22432,21896,536,0.976,0.024
21119,61616,6116,6116,0,1.0,0.0
21120,61625,385,385,0,1.0,0.0
21121,61701,36105,36105,0,1.0,0.0
21122,61704,35981,35651,330,0.991,0.009
21123,61705,12263,9033,3230,0.737,0.263
21124,61720,236,0,236,0.0,1.0
21125,61721,613,0,613,0.0,1.0
21126,61722,549,0,549,0.0,1.0
21127,61723,2321,0,2321,0.0,1.0
21128,61724,536,0,536,0.0,1.0
21129,61725,1547,0,1547,0.0,1.0
21130,61726,2544,0,2544,0.0,1.0
21131,61727,10015,7948,2067,0.794,0.206
21132,61728,1410,0,1410,0.0,1.0
21133,61729,1073,0,1073,0.0,1.0
21134,61730,379,0,379,0.0,1.0
21135,61731,280,0,280,0.0,1.0
21136,61732,2096,0,2096,0.0,1.0
21137,61733,1124,0,1124,0.0,1.0
21138,61734,2867,0,2867,0.0,1.0
21139,61735,420,0,420,0.0,1.0
21140,61736,1808,1188,620,0.657,0.343
21141,61737,516,0,516,0.0,1.0
21142,61738,4212,2776,1436,0.659,0.341
21143,61739,4897,3784,1113,0.773,0.227
21144,61740,1634,0,1634,0.0,1.0
21145,61741,1746,0,1746,0.0,1.0
21146,61742,1144,0,1144,0.0,1.0
21147,61743,212,0,212,0.0,1.0
21148,61744,2031,0,2031,0.0,1.0
21149,61745,4408,3016,1392,0.684,0.316
21150,61747,1560,0,1560,0.0,1.0
21151,61748,2782,0,2782,0.0,1.0
21152,61749,556,0,556,0.0,1.0
21153,61750,133,0,133,0.0,1.0
21154,61751,124,0,124,0.0,1.0
21155,61752,4339,3316,1023,0.764,0.236
21156,61753,3012,0,3012,0.0,1.0
21157,61754,1261,0,1261,0.0,1.0
21158,61755,4669,3452,1217,0.739,0.261
21159,61756,2337,0,2337,0.0,1.0
21160,61759,1534,0,1534,0.0,1.0
21161,61760,2544,0,2544,0.0,1.0
21162,61761,52879,52521,358,0.993,0.007
21163,61764,14460,12323,2137,0.852,0.148
21164,61769,619,0,619,0.0,1.0
21165,61770,1108,0,1108,0.0,1.0
21166,61771,860,0,860,0.0,1.0
21167,61772,351,94,257,0.268,0.732
21168,61773,477,0,477,0.0,1.0
21169,61774,962,0,962,0.0,1.0
21170,61775,307,0,307,0.0,1.0
21171,61776,1409,674,735,0.478,0.522
21172,61777,952,539,413,0.566,0.434
21173,61778,683,0,683,0.0,1.0
21174,61801,30937,30937,0,1.0,0.0
21175,61802,19052,17155,1897,0.9,0.1
21176,61810,361,0,361,0.0,1.0
21177,61811,703,0,703,0.0,1.0
21178,61812,375,0,375,0.0,1.0
21179,61813,1971,0,1971,0.0,1.0
21180,61814,1157,0,1157,0.0,1.0
21181,61815,228,211,17,0.925,0.075
21182,61816,509,0,509,0.0,1.0
21183,61817,2583,2030,553,0.786,0.214
21184,61818,1665,0,1665,0.0,1.0
21185,61820,36964,36964,0,1.0,0.0
21186,61821,30174,30174,0,1.0,0.0
21187,61822,21608,19419,2189,0.899,0.101
21188,61830,478,0,478,0.0,1.0
21189,61831,157,0,157,0.0,1.0
21190,61832,37290,36309,981,0.974,0.026
21191,61833,2124,2124,0,1.0,0.0
21192,61834,8454,2949,5505,0.349,0.651
21193,61839,586,0,586,0.0,1.0
21194,61840,709,43,666,0.061,0.939
21195,61841,1386,0,1386,0.0,1.0
21196,61842,2984,0,2984,0.0,1.0
21197,61843,2363,0,2363,0.0,1.0
21198,61844,970,0,970,0.0,1.0
21199,61845,364,0,364,0.0,1.0
21200,61846,5101,3656,1445,0.717,0.283
21201,61847,1256,0,1256,0.0,1.0
21202,61848,227,0,227,0.0,1.0
21203,61849,1842,0,1842,0.0,1.0
21204,61850,671,0,671,0.0,1.0
21205,61851,436,0,436,0.0,1.0
21206,61852,261,0,261,0.0,1.0
21207,61853,13206,11001,2205,0.833,0.167
21208,61854,1438,0,1438,0.0,1.0
21209,61855,96,0,96,0.0,1.0
21210,61856,7433,5410,2023,0.728,0.272
21211,61857,153,0,153,0.0,1.0
21212,61858,3124,302,2822,0.097,0.903
21213,61859,1297,0,1297,0.0,1.0
21214,61862,510,0,510,0.0,1.0
21215,61863,814,0,814,0.0,1.0
21216,61864,1715,0,1715,0.0,1.0
21217,61865,1391,0,1391,0.0,1.0
21218,61866,14048,12945,1103,0.921,0.079
21219,61870,1327,0,1327,0.0,1.0
21220,61871,284,0,284,0.0,1.0
21221,61872,760,0,760,0.0,1.0
21222,61873,6250,5047,1203,0.808,0.192
21223,61874,7114,7062,52,0.993,0.007
21224,61875,761,0,761,0.0,1.0
21225,61876,800,0,800,0.0,1.0
21226,61877,1627,0,1627,0.0,1.0
21227,61878,1433,1126,307,0.786,0.214
21228,61880,4183,3439,744,0.822,0.178
21229,61882,713,0,713,0.0,1.0
21230,61883,4438,3626,812,0.817,0.183
21231,61884,1244,0,1244,0.0,1.0
21232,61910,4463,2874,1589,0.644,0.356
21233,61911,4860,0,4860,0.0,1.0
21234,61912,1344,0,1344,0.0,1.0
21235,61913,1684,0,1684,0.0,1.0
21236,61914,1920,0,1920,0.0,1.0
21237,61917,591,0,591,0.0,1.0
21238,61919,813,0,813,0.0,1.0
21239,61920,25594,21810,3784,0.852,0.148
21240,61924,2449,0,2449,0.0,1.0
21241,61925,912,0,912,0.0,1.0
21242,61928,757,0,757,0.0,1.0
21243,61929,769,0,769,0.0,1.0
21244,61930,515,0,515,0.0,1.0
21245,61931,1255,0,1255,0.0,1.0
21246,61932,456,0,456,0.0,1.0
21247,61933,1141,0,1141,0.0,1.0
21248,61936,243,0,243,0.0,1.0
21249,61937,2022,0,2022,0.0,1.0
21250,61938,22409,18978,3431,0.847,0.153
21251,61940,258,0,258,0.0,1.0
21252,61941,57,0,57,0.0,1.0
21253,61942,1202,0,1202,0.0,1.0
21254,61943,1637,0,1637,0.0,1.0
21255,61944,12908,8953,3955,0.694,0.306
21256,61949,179,0,179,0.0,1.0
21257,61951,8017,4567,3450,0.57,0.43
21258,61953,6216,4791,1425,0.771,0.229
21259,61955,157,0,157,0.0,1.0
21260,61956,2909,0,2909,0.0,1.0
21261,61957,1869,0,1869,0.0,1.0
21262,62001,1752,0,1752,0.0,1.0
21263,62002,32704,29888,2816,0.914,0.086
21264,62006,648,0,648,0.0,1.0
21265,62009,1810,1545,265,0.854,0.146
21266,62010,11186,9781,1405,0.874,0.126
21267,62011,284,0,284,0.0,1.0
21268,62012,6654,87,6567,0.013,0.987
21269,62013,552,0,552,0.0,1.0
21270,62014,4122,0,4122,0.0,1.0
21271,62015,487,0,487,0.0,1.0
21272,62016,3816,0,3816,0.0,1.0
21273,62017,1185,0,1185,0.0,1.0
21274,62018,3604,3604,0,1.0,0.0
21275,62019,490,0,490,0.0,1.0
21276,62021,936,0,936,0.0,1.0
21277,62022,1138,0,1138,0.0,1.0
21278,62023,91,0,91,0.0,1.0
21279,62024,9775,9775,0,1.0,0.0
21280,62025,33748,27933,5815,0.828,0.172
21281,62027,536,0,536,0.0,1.0
21282,62028,1276,0,1276,0.0,1.0
21283,62030,114,0,114,0.0,1.0
21284,62031,970,0,970,0.0,1.0
21285,62032,749,0,749,0.0,1.0
21286,62033,4894,3688,1206,0.754,0.246
21287,62034,13819,13742,77,0.994,0.006
21288,62035,16494,13299,3195,0.806,0.194
21289,62036,704,0,704,0.0,1.0
21290,62037,1993,0,1993,0.0,1.0
21291,62040,43735,43307,428,0.99,0.01
21292,62044,2009,0,2009,0.0,1.0
21293,62045,647,0,647,0.0,1.0
21294,62046,713,0,713,0.0,1.0
21295,62047,1555,0,1555,0.0,1.0
21296,62048,1459,1429,30,0.979,0.021
21297,62049,8470,6800,1670,0.803,0.197
21298,62050,473,0,473,0.0,1.0
21299,62051,950,1,949,0.001,0.999
21300,62052,13002,8989,4013,0.691,0.309
21301,62053,650,0,650,0.0,1.0
21302,62054,872,0,872,0.0,1.0
21303,62056,8930,6956,1974,0.779,0.221
21304,62058,843,761,82,0.903,0.097
21305,62059,746,746,0,1.0,0.0
21306,62060,4847,4606,241,0.95,0.05
21307,62061,1718,0,1718,0.0,1.0
21308,62062,7658,7658,0,1.0,0.0
21309,62063,1214,0,1214,0.0,1.0
21310,62065,97,0,97,0.0,1.0
21311,62067,2401,1037,1364,0.432,0.568
21312,62069,3313,0,3313,0.0,1.0
21313,62070,37,0,37,0.0,1.0
21314,62074,1087,0,1087,0.0,1.0
21315,62075,3458,2541,917,0.735,0.265
21316,62076,135,0,135,0.0,1.0
21317,62077,347,0,347,0.0,1.0
21318,62078,119,0,119,0.0,1.0
21319,62079,256,0,256,0.0,1.0
21320,62080,2508,0,2508,0.0,1.0
21321,62081,298,0,298,0.0,1.0
21322,62082,3109,1743,1366,0.561,0.439
21323,62083,295,0,295,0.0,1.0
21324,62084,1606,1545,61,0.962,0.038
21325,62085,209,100,109,0.478,0.522
21326,62086,1437,0,1437,0.0,1.0
21327,62087,2087,2066,21,0.99,0.01
21328,62088,6960,5417,1543,0.778,0.222
21329,62089,489,460,29,0.941,0.059
21330,62090,1189,1189,0,1.0,0.0
21331,62091,337,0,337,0.0,1.0
21332,62092,2979,2305,674,0.774,0.226
21333,62093,435,0,435,0.0,1.0
21334,62094,1152,816,336,0.708,0.292
21335,62095,11237,11170,67,0.994,0.006
21336,62097,2828,525,2303,0.186,0.814
21337,62098,91,0,91,0.0,1.0
21338,62201,7547,7540,7,0.999,0.001
21339,62203,8209,8209,0,1.0,0.0
21340,62204,7960,7945,15,0.998,0.002
21341,62205,9329,9329,0,1.0,0.0
21342,62206,16509,16509,0,1.0,0.0
21343,62207,8750,8750,0,1.0,0.0
21344,62208,17376,17376,0,1.0,0.0
21345,62214,1229,0,1229,0.0,1.0
21346,62215,1872,0,1872,0.0,1.0
21347,62216,2526,0,2526,0.0,1.0
21348,62217,807,0,807,0.0,1.0
21349,62218,1481,0,1481,0.0,1.0
21350,62219,1009,1009,0,1.0,0.0
21351,62220,20504,19869,635,0.969,0.031
21352,62221,27858,26794,1064,0.962,0.038
21353,62223,17560,16691,869,0.951,0.049
21354,62225,5381,5381,0,1.0,0.0
21355,62226,29744,29610,134,0.995,0.005
21356,62230,6194,4475,1719,0.722,0.278
21357,62231,7589,3292,4297,0.434,0.566
21358,62232,7260,6308,952,0.869,0.131
21359,62233,10037,8450,1587,0.842,0.158
21360,62234,33430,30959,2471,0.926,0.074
21361,62236,12562,9733,2829,0.775,0.225
21362,62237,2659,0,2659,0.0,1.0
21363,62238,696,459,237,0.659,0.341
21364,62239,4954,4352,602,0.878,0.122
21365,62240,1966,523,1443,0.266,0.734
21366,62241,1061,0,1061,0.0,1.0
21367,62242,1526,0,1526,0.0,1.0
21368,62243,5910,3870,2040,0.655,0.345
21369,62244,1156,0,1156,0.0,1.0
21370,62245,1794,1325,469,0.739,0.261
21371,62246,10355,6876,3479,0.664,0.336
21372,62248,320,0,320,0.0,1.0
21373,62249,15971,11525,4446,0.722,0.278
21374,62250,504,0,504,0.0,1.0
21375,62253,696,0,696,0.0,1.0
21376,62254,6089,4321,1768,0.71,0.29
21377,62255,1001,0,1001,0.0,1.0
21378,62257,3214,0,3214,0.0,1.0
21379,62258,9199,7368,1831,0.801,0.199
21380,62260,7290,3622,3668,0.497,0.503
21381,62261,152,0,152,0.0,1.0
21382,62262,1810,0,1810,0.0,1.0
21383,62263,5387,3238,2149,0.601,0.399
21384,62264,3338,0,3338,0.0,1.0
21385,62265,4353,3424,929,0.787,0.213
21386,62266,254,0,254,0.0,1.0
21387,62268,738,0,738,0.0,1.0
21388,62269,31348,30578,770,0.975,0.025
21389,62271,2077,0,2077,0.0,1.0
21390,62272,1674,964,710,0.576,0.424
21391,62273,426,0,426,0.0,1.0
21392,62274,8410,5670,2740,0.674,0.326
21393,62275,3621,0,3621,0.0,1.0
21394,62277,1314,0,1314,0.0,1.0
21395,62278,6690,3695,2995,0.552,0.448
21396,62279,69,0,69,0.0,1.0
21397,62280,444,0,444,0.0,1.0
21398,62281,2155,76,2079,0.035,0.965
21399,62282,471,0,471,0.0,1.0
21400,62284,636,100,536,0.157,0.843
21401,62285,4484,3720,764,0.83,0.17
21402,62286,6008,4046,1962,0.673,0.327
21403,62288,2918,2046,872,0.701,0.299
21404,62289,350,0,350,0.0,1.0
21405,62292,947,0,947,0.0,1.0
21406,62293,4748,2736,2012,0.576,0.424
21407,62294,14367,11361,3006,0.791,0.209
21408,62295,1599,0,1599,0.0,1.0
21409,62297,452,0,452,0.0,1.0
21410,62298,16609,9604,7005,0.578,0.422
21411,62301,33758,33756,2,1.0,0.0
21412,62305,18052,11472,6580,0.635,0.365
21413,62311,860,0,860,0.0,1.0
21414,62312,2162,0,2162,0.0,1.0
21415,62313,389,0,389,0.0,1.0
21416,62314,611,0,611,0.0,1.0
21417,62316,660,0,660,0.0,1.0
21418,62319,264,0,264,0.0,1.0
21419,62320,2185,0,2185,0.0,1.0
21420,62321,4091,2582,1509,0.631,0.369
21421,62323,290,0,290,0.0,1.0
21422,62324,1361,0,1361,0.0,1.0
21423,62325,403,0,403,0.0,1.0
21424,62326,2478,0,2478,0.0,1.0
21425,62330,1769,0,1769,0.0,1.0
21426,62334,172,0,172,0.0,1.0
21427,62336,47,0,47,0.0,1.0
21428,62338,1473,0,1473,0.0,1.0
21429,62339,874,0,874,0.0,1.0
21430,62340,1715,0,1715,0.0,1.0
21431,62341,3610,2909,701,0.806,0.194
21432,62343,712,0,712,0.0,1.0
21433,62344,138,0,138,0.0,1.0
21434,62345,357,0,357,0.0,1.0
21435,62346,178,0,178,0.0,1.0
21436,62347,2282,0,2282,0.0,1.0
21437,62348,170,0,170,0.0,1.0
21438,62349,636,0,636,0.0,1.0
21439,62351,1856,0,1856,0.0,1.0
21440,62352,271,0,271,0.0,1.0
21441,62353,5637,4088,1549,0.725,0.275
21442,62354,1684,0,1684,0.0,1.0
21443,62355,820,0,820,0.0,1.0
21444,62356,571,0,571,0.0,1.0
21445,62357,245,0,245,0.0,1.0
21446,62358,752,54,698,0.072,0.928
21447,62359,166,0,166,0.0,1.0
21448,62360,1656,0,1656,0.0,1.0
21449,62361,539,0,539,0.0,1.0
21450,62362,399,0,399,0.0,1.0
21451,62363,6353,4550,1803,0.716,0.284
21452,62365,647,0,647,0.0,1.0
21453,62366,1408,0,1408,0.0,1.0
21454,62367,1345,0,1345,0.0,1.0
21455,62370,520,0,520,0.0,1.0
21456,62373,300,0,300,0.0,1.0
21457,62374,298,0,298,0.0,1.0
21458,62375,369,0,369,0.0,1.0
21459,62376,1198,0,1198,0.0,1.0
21460,62378,896,0,896,0.0,1.0
21461,62379,2049,0,2049,0.0,1.0
21462,62380,401,0,401,0.0,1.0
21463,62401,19096,12164,6932,0.637,0.363
21464,62410,985,0,985,0.0,1.0
21465,62411,4430,0,4430,0.0,1.0
21466,62413,421,0,421,0.0,1.0
21467,62414,1886,0,1886,0.0,1.0
21468,62417,3064,2007,1057,0.655,0.345
21469,62418,2133,0,2133,0.0,1.0
21470,62419,410,0,410,0.0,1.0
21471,62420,4759,2834,1925,0.596,0.404
21472,62421,778,0,778,0.0,1.0
21473,62422,1156,0,1156,0.0,1.0
21474,62423,724,0,724,0.0,1.0
21475,62424,2092,0,2092,0.0,1.0
21476,62425,649,0,649,0.0,1.0
21477,62426,1085,0,1085,0.0,1.0
21478,62427,1702,0,1702,0.0,1.0
21479,62428,3104,0,3104,0.0,1.0
21480,62431,1232,0,1232,0.0,1.0
21481,62432,571,0,571,0.0,1.0
21482,62433,998,0,998,0.0,1.0
21483,62434,330,0,330,0.0,1.0
21484,62436,562,0,562,0.0,1.0
21485,62438,433,0,433,0.0,1.0
21486,62439,7536,5060,2476,0.671,0.329
21487,62440,1316,0,1316,0.0,1.0
21488,62441,7395,3775,3620,0.51,0.49
21489,62442,2421,0,2421,0.0,1.0
21490,62443,1623,0,1623,0.0,1.0
21491,62444,387,0,387,0.0,1.0
21492,62445,907,0,907,0.0,1.0
21493,62446,414,0,414,0.0,1.0
21494,62447,3404,0,3404,0.0,1.0
21495,62448,5834,2923,2911,0.501,0.499
21496,62449,3175,0,3175,0.0,1.0
21497,62450,12218,9177,3041,0.751,0.249
21498,62451,2156,0,2156,0.0,1.0
21499,62452,400,0,400,0.0,1.0
21500,62454,11467,7894,3573,0.688,0.312
21501,62458,2228,0,2228,0.0,1.0
21502,62459,243,0,243,0.0,1.0
21503,62460,1231,0,1231,0.0,1.0
21504,62461,854,0,854,0.0,1.0
21505,62462,1149,0,1149,0.0,1.0
21506,62463,1294,0,1294,0.0,1.0
21507,62465,858,0,858,0.0,1.0
21508,62466,4848,0,4848,0.0,1.0
21509,62467,3741,1636,2105,0.437,0.563
21510,62468,2564,0,2564,0.0,1.0
21511,62469,419,0,419,0.0,1.0
21512,62471,10233,7309,2924,0.714,0.286
21513,62473,1422,0,1422,0.0,1.0
21514,62474,848,0,848,0.0,1.0
21515,62475,387,0,387,0.0,1.0
21516,62476,1734,0,1734,0.0,1.0
21517,62477,946,0,946,0.0,1.0
21518,62478,398,0,398,0.0,1.0
21519,62479,820,0,820,0.0,1.0
21520,62480,787,0,787,0.0,1.0
21521,62481,386,0,386,0.0,1.0
21522,62501,2661,0,2661,0.0,1.0
21523,62510,1669,0,1669,0.0,1.0
21524,62512,500,0,500,0.0,1.0
21525,62513,1766,0,1766,0.0,1.0
21526,62514,252,0,252,0.0,1.0
21527,62515,961,0,961,0.0,1.0
21528,62517,226,0,226,0.0,1.0
21529,62518,457,0,457,0.0,1.0
21530,62519,94,0,94,0.0,1.0
21531,62520,1529,0,1529,0.0,1.0
21532,62521,35851,32719,3132,0.913,0.087
21533,62522,16630,15791,839,0.95,0.05
21534,62523,1237,1237,0,1.0,0.0
21535,62526,34075,33424,651,0.981,0.019
21536,62530,1532,100,1432,0.065,0.935
21537,62531,1792,0,1792,0.0,1.0
21538,62532,105,64,41,0.61,0.39
21539,62533,973,0,973,0.0,1.0
21540,62534,1130,0,1130,0.0,1.0
21541,62535,3534,3532,2,0.999,0.001
21542,62536,912,523,389,0.573,0.427
21543,62537,92,89,3,0.967,0.033
21544,62538,378,0,378,0.0,1.0
21545,62539,1358,0,1358,0.0,1.0
21546,62540,1492,0,1492,0.0,1.0
21547,62541,57,0,57,0.0,1.0
21548,62543,540,0,540,0.0,1.0
21549,62544,1776,0,1776,0.0,1.0
21550,62545,1246,0,1246,0.0,1.0
21551,62546,1630,0,1630,0.0,1.0
21552,62547,804,0,804,0.0,1.0
21553,62548,2258,0,2258,0.0,1.0
21554,62549,6269,6116,153,0.976,0.024
21555,62550,2869,0,2869,0.0,1.0
21556,62551,837,16,821,0.019,0.981
21557,62553,437,0,437,0.0,1.0
21558,62554,1563,875,688,0.56,0.44
21559,62555,540,0,540,0.0,1.0
21560,62556,422,0,422,0.0,1.0
21561,62557,7607,5943,1664,0.781,0.219
21562,62558,3590,2769,821,0.771,0.229
21563,62560,1508,0,1508,0.0,1.0
21564,62561,5315,4529,786,0.852,0.148
21565,62563,5686,3625,2061,0.638,0.362
21566,62565,7538,4974,2564,0.66,0.34
21567,62567,1154,0,1154,0.0,1.0
21568,62568,16355,13742,2613,0.84,0.16
21569,62570,512,0,512,0.0,1.0
21570,62571,1532,0,1532,0.0,1.0
21571,62572,666,0,666,0.0,1.0
21572,62573,1513,0,1513,0.0,1.0
21573,62601,434,0,434,0.0,1.0
21574,62610,199,0,199,0.0,1.0
21575,62611,1067,0,1067,0.0,1.0
21576,62612,1915,0,1915,0.0,1.0
21577,62613,3872,0,3872,0.0,1.0
21578,62615,5748,4609,1139,0.802,0.198
21579,62617,762,0,762,0.0,1.0
21580,62618,7955,6530,1425,0.821,0.179
21581,62621,1171,0,1171,0.0,1.0
21582,62622,49,0,49,0.0,1.0
21583,62624,546,0,546,0.0,1.0
21584,62625,855,0,855,0.0,1.0
21585,62626,8354,5953,2401,0.713,0.287
21586,62627,992,0,992,0.0,1.0
21587,62628,896,0,896,0.0,1.0
21588,62629,12949,11964,985,0.924,0.076
21589,62630,532,0,532,0.0,1.0
21590,62631,262,0,262,0.0,1.0
21591,62633,647,0,647,0.0,1.0
21592,62634,821,0,821,0.0,1.0
21593,62635,738,0,738,0.0,1.0
21594,62638,1337,0,1337,0.0,1.0
21595,62639,316,0,316,0.0,1.0
21596,62640,3756,0,3756,0.0,1.0
21597,62642,1440,0,1440,0.0,1.0
21598,62643,526,0,526,0.0,1.0
21599,62644,5385,3302,2083,0.613,0.387
21600,62649,488,0,488,0.0,1.0
21601,62650,26992,22669,4323,0.84,0.16
21602,62655,568,0,568,0.0,1.0
21603,62656,20405,18224,2181,0.893,0.107
21604,62661,1213,0,1213,0.0,1.0
21605,62663,292,0,292,0.0,1.0
21606,62664,3042,0,3042,0.0,1.0
21607,62665,1629,0,1629,0.0,1.0
21608,62666,616,0,616,0.0,1.0
21609,62667,464,0,464,0.0,1.0
21610,62668,1512,0,1512,0.0,1.0
21611,62670,2997,176,2821,0.059,0.941
21612,62671,572,0,572,0.0,1.0
21613,62672,244,0,244,0.0,1.0
21614,62673,530,0,530,0.0,1.0
21615,62674,1454,0,1454,0.0,1.0
21616,62675,6154,3088,3066,0.502,0.498
21617,62677,2562,0,2562,0.0,1.0
21618,62681,5602,3196,2406,0.571,0.429
21619,62682,907,0,907,0.0,1.0
21620,62684,5111,4297,814,0.841,0.159
21621,62685,2097,0,2097,0.0,1.0
21622,62688,761,0,761,0.0,1.0
21623,62689,518,518,0,1.0,0.0
21624,62690,4120,3572,548,0.867,0.133
21625,62691,2426,0,2426,0.0,1.0
21626,62692,2093,0,2093,0.0,1.0
21627,62693,1638,0,1638,0.0,1.0
21628,62694,3192,0,3192,0.0,1.0
21629,62695,296,0,296,0.0,1.0
21630,62701,1152,1152,0,1.0,0.0
21631,62702,37281,37281,0,1.0,0.0
21632,62703,30333,30308,25,0.999,0.001
21633,62704,39831,39831,0,1.0,0.0
21634,62707,7648,5305,2343,0.694,0.306
21635,62711,15347,13723,1624,0.894,0.106
21636,62712,10302,8602,1700,0.835,0.165
21637,62801,22415,16304,6111,0.727,0.273
21638,62803,1014,0,1014,0.0,1.0
21639,62806,3412,0,3412,0.0,1.0
21640,62807,961,0,961,0.0,1.0
21641,62808,1457,0,1457,0.0,1.0
21642,62809,142,0,142,0.0,1.0
21643,62810,1089,0,1089,0.0,1.0
21644,62811,310,0,310,0.0,1.0
21645,62812,11265,7820,3445,0.694,0.306
21646,62814,2124,0,2124,0.0,1.0
21647,62815,416,0,416,0.0,1.0
21648,62816,1306,0,1306,0.0,1.0
21649,62817,557,0,557,0.0,1.0
21650,62818,330,0,330,0.0,1.0
21651,62819,448,345,103,0.77,0.23
21652,62820,162,0,162,0.0,1.0
21653,62821,7657,5568,2089,0.727,0.273
21654,62822,2574,2380,194,0.925,0.075
21655,62823,1691,0,1691,0.0,1.0
21656,62824,1761,0,1761,0.0,1.0
21657,62825,203,189,14,0.931,0.069
21658,62827,1245,0,1245,0.0,1.0
21659,62828,1426,0,1426,0.0,1.0
21660,62829,72,0,72,0.0,1.0
21661,62830,1392,0,1392,0.0,1.0
21662,62831,573,0,573,0.0,1.0
21663,62832,9208,6467,2741,0.702,0.298
21664,62833,383,0,383,0.0,1.0
21665,62835,1152,0,1152,0.0,1.0
21666,62836,801,0,801,0.0,1.0
21667,62837,8867,5039,3828,0.568,0.432
21668,62838,1497,0,1497,0.0,1.0
21669,62839,6718,4872,1846,0.725,0.275
21670,62841,98,0,98,0.0,1.0
21671,62842,835,0,835,0.0,1.0
21672,62843,100,0,100,0.0,1.0
21673,62844,2083,0,2083,0.0,1.0
21674,62846,2631,0,2631,0.0,1.0
21675,62848,636,509,127,0.8,0.2
21676,62849,2205,0,2205,0.0,1.0
21677,62850,381,0,381,0.0,1.0
21678,62851,329,0,329,0.0,1.0
21679,62852,160,0,160,0.0,1.0
21680,62853,1034,0,1034,0.0,1.0
21681,62854,1776,0,1776,0.0,1.0
21682,62856,324,0,324,0.0,1.0
21683,62858,2981,0,2981,0.0,1.0
21684,62859,5748,2698,3050,0.469,0.531
21685,62860,524,0,524,0.0,1.0
21686,62861,128,0,128,0.0,1.0
21687,62862,364,0,364,0.0,1.0
21688,62863,10183,7300,2883,0.717,0.283
21689,62864,24108,16008,8100,0.664,0.336
21690,62865,2018,99,1919,0.049,0.951
21691,62867,521,0,521,0.0,1.0
21692,62868,1872,0,1872,0.0,1.0
21693,62869,2682,0,2682,0.0,1.0
21694,62870,2080,1038,1042,0.499,0.501
21695,62871,686,0,686,0.0,1.0
21696,62872,1178,0,1178,0.0,1.0
21697,62874,372,269,103,0.723,0.277
21698,62875,1167,0,1167,0.0,1.0
21699,62876,247,0,247,0.0,1.0
21700,62877,514,0,514,0.0,1.0
21701,62878,410,0,410,0.0,1.0
21702,62879,85,0,85,0.0,1.0
21703,62880,717,0,717,0.0,1.0
21704,62881,11385,7262,4123,0.638,0.362
21705,62882,2331,483,1848,0.207,0.793
21706,62883,591,0,591,0.0,1.0
21707,62884,2940,0,2940,0.0,1.0
21708,62885,839,0,839,0.0,1.0
21709,62886,440,0,440,0.0,1.0
21710,62887,295,0,295,0.0,1.0
21711,62888,2135,0,2135,0.0,1.0
21712,62889,851,0,851,0.0,1.0
21713,62890,2882,0,2882,0.0,1.0
21714,62891,652,555,97,0.851,0.149
21715,62892,317,0,317,0.0,1.0
21716,62893,977,0,977,0.0,1.0
21717,62894,1006,0,1006,0.0,1.0
21718,62895,2022,0,2022,0.0,1.0
21719,62896,12626,8685,3941,0.688,0.312
21720,62897,398,0,398,0.0,1.0
21721,62898,2097,0,2097,0.0,1.0
21722,62899,1612,0,1612,0.0,1.0
21723,62901,27182,25157,2025,0.926,0.074
21724,62902,4531,1075,3456,0.237,0.763
21725,62903,2962,1711,1251,0.578,0.422
21726,62905,677,0,677,0.0,1.0
21727,62906,7276,4552,2724,0.626,0.374
21728,62907,2164,0,2164,0.0,1.0
21729,62908,467,0,467,0.0,1.0
21730,62910,2865,1029,1836,0.359,0.641
21731,62912,1179,0,1179,0.0,1.0
21732,62914,3147,2833,314,0.9,0.1
21733,62915,321,321,0,1.0,0.0
21734,62916,995,0,995,0.0,1.0
21735,62917,2305,0,2305,0.0,1.0
21736,62918,9793,7984,1809,0.815,0.185
21737,62919,1003,0,1003,0.0,1.0
21738,62920,3265,0,3265,0.0,1.0
21739,62921,375,245,130,0.653,0.347
21740,62922,3119,0,3119,0.0,1.0
21741,62923,518,0,518,0.0,1.0
21742,62924,2809,0,2809,0.0,1.0
21743,62926,2263,0,2263,0.0,1.0
21744,62927,367,0,367,0.0,1.0
21745,62928,293,0,293,0.0,1.0
21746,62930,6263,4585,1678,0.732,0.268
21747,62931,1571,0,1571,0.0,1.0
21748,62932,1592,0,1592,0.0,1.0
21749,62933,1230,1124,106,0.914,0.086
21750,62934,927,0,927,0.0,1.0
21751,62935,1943,0,1943,0.0,1.0
21752,62938,3033,0,3033,0.0,1.0
21753,62939,3119,0,3119,0.0,1.0
21754,62940,445,0,445,0.0,1.0
21755,62941,808,0,808,0.0,1.0
21756,62942,707,0,707,0.0,1.0
21757,62943,715,0,715,0.0,1.0
21758,62946,12930,9345,3585,0.723,0.277
21759,62947,539,0,539,0.0,1.0
21760,62948,12865,12224,641,0.95,0.05
21761,62949,810,0,810,0.0,1.0
21762,62950,193,0,193,0.0,1.0
21763,62951,5352,3551,1801,0.663,0.337
21764,62952,3372,1526,1846,0.453,0.547
21765,62953,360,0,360,0.0,1.0
21766,62954,515,0,515,0.0,1.0
21767,62956,869,0,869,0.0,1.0
21768,62957,996,309,687,0.31,0.69
21769,62958,2262,0,2262,0.0,1.0
21770,62959,26948,17567,9381,0.652,0.348
21771,62960,11603,6607,4996,0.569,0.431
21772,62961,65,0,65,0.0,1.0
21773,62962,82,0,82,0.0,1.0
21774,62963,611,0,611,0.0,1.0
21775,62964,1456,0,1456,0.0,1.0
21776,62965,125,105,20,0.84,0.16
21777,62966,15607,10144,5463,0.65,0.35
21778,62967,326,0,326,0.0,1.0
21779,62969,731,0,731,0.0,1.0
21780,62970,639,0,639,0.0,1.0
21781,62972,1205,0,1205,0.0,1.0
21782,62974,1401,0,1401,0.0,1.0
21783,62975,279,0,279,0.0,1.0
21784,62976,469,0,469,0.0,1.0
21785,62977,700,0,700,0.0,1.0
21786,62979,1230,0,1230,0.0,1.0
21787,62982,1328,0,1328,0.0,1.0
21788,62983,1504,0,1504,0.0,1.0
21789,62984,1841,0,1841,0.0,1.0
21790,62985,845,0,845,0.0,1.0
21791,62987,1174,0,1174,0.0,1.0
21792,62988,2110,0,2110,0.0,1.0
21793,62990,1109,0,1109,0.0,1.0
21794,62992,1032,0,1032,0.0,1.0
21795,62994,755,0,755,0.0,1.0
21796,62995,5284,0,5284,0.0,1.0
21797,62996,535,0,535,0.0,1.0
21798,62997,599,0,599,0.0,1.0
21799,62998,419,0,419,0.0,1.0
21800,62999,1829,0,1829,0.0,1.0
21801,63005,17753,16605,1148,0.935,0.065
21802,63010,35439,35305,134,0.996,0.004
21803,63011,36347,36347,0,1.0,0.0
21804,63012,9973,6318,3655,0.634,0.366
21805,63013,1589,0,1589,0.0,1.0
21806,63014,779,0,779,0.0,1.0
21807,63015,2076,0,2076,0.0,1.0
21808,63016,7582,4147,3435,0.547,0.453
21809,63017,41470,41321,149,0.996,0.004
21810,63019,4449,4411,38,0.991,0.009
21811,63020,20714,8061,12653,0.389,0.611
21812,63021,56261,55537,724,0.987,0.013
21813,63023,5831,0,5831,0.0,1.0
21814,63025,13854,9927,3927,0.717,0.283
21815,63026,44124,44124,0,1.0,0.0
21816,63028,26413,14523,11890,0.55,0.45
21817,63030,407,0,407,0.0,1.0
21818,63031,48212,48132,80,0.998,0.002
21819,63033,43000,43000,0,1.0,0.0
21820,63034,17761,16721,1040,0.941,0.059
21821,63036,1064,0,1064,0.0,1.0
21822,63037,3241,0,3241,0.0,1.0
21823,63038,6914,3525,3389,0.51,0.49
21824,63039,726,212,514,0.292,0.708
21825,63040,8512,8419,93,0.989,0.011
21826,63041,534,0,534,0.0,1.0
21827,63042,19602,19119,483,0.975,0.025
21828,63043,22367,22354,13,0.999,0.001
21829,63044,10568,10555,13,0.999,0.001
21830,63045,3,3,0,1.0,0.0
21831,63047,31,0,31,0.0,1.0
21832,63048,3357,3351,6,0.998,0.002
21833,63049,15896,14047,1849,0.884,0.116
21834,63050,15716,3768,11948,0.24,0.76
21835,63051,14495,9190,5305,0.634,0.366
21836,63052,26431,22548,3883,0.853,0.147
21837,63053,62,62,0,1.0,0.0
21838,63055,2449,701,1748,0.286,0.714
21839,63056,2002,0,2002,0.0,1.0
21840,63057,56,56,0,1.0,0.0
21841,63060,2461,0,2461,0.0,1.0
21842,63061,95,0,95,0.0,1.0
21843,63068,4909,0,4909,0.0,1.0
21844,63069,15647,8301,7346,0.531,0.469
21845,63070,7438,6919,519,0.93,0.07
21846,63071,1103,0,1103,0.0,1.0
21847,63072,3194,0,3194,0.0,1.0
21848,63073,301,0,301,0.0,1.0
21849,63074,15164,15164,0,1.0,0.0
21850,63077,11798,5971,5827,0.506,0.494
21851,63079,58,0,58,0.0,1.0
21852,63080,13987,7116,6871,0.509,0.491
21853,63084,17414,8658,8756,0.497,0.503
21854,63087,769,0,769,0.0,1.0
21855,63088,8269,8267,2,1.0,0.0
21856,63089,5965,2446,3519,0.41,0.59
21857,63090,21524,14316,7208,0.665,0.335
21858,63091,1264,0,1264,0.0,1.0
21859,63101,2620,2620,0,1.0,0.0
21860,63102,2316,2316,0,1.0,0.0
21861,63103,6900,6900,0,1.0,0.0
21862,63104,18656,18656,0,1.0,0.0
21863,63105,17667,17667,0,1.0,0.0
21864,63106,11883,11883,0,1.0,0.0
21865,63107,11912,11912,0,1.0,0.0
21866,63108,21568,21568,0,1.0,0.0
21867,63109,26946,26946,0,1.0,0.0
21868,63110,17107,17107,0,1.0,0.0
21869,63111,20313,20313,0,1.0,0.0
21870,63112,20368,20368,0,1.0,0.0
21871,63113,13167,13167,0,1.0,0.0
21872,63114,36201,36201,0,1.0,0.0
21873,63115,20775,20775,0,1.0,0.0
21874,63116,43540,43540,0,1.0,0.0
21875,63117,9163,9163,0,1.0,0.0
21876,63118,26704,26704,0,1.0,0.0
21877,63119,33969,33969,0,1.0,0.0
21878,63120,10296,10296,0,1.0,0.0
21879,63121,26602,26602,0,1.0,0.0
21880,63122,38495,38495,0,1.0,0.0
21881,63123,49308,49308,0,1.0,0.0
21882,63124,10417,10417,0,1.0,0.0
21883,63125,32201,32201,0,1.0,0.0
21884,63126,15112,15112,0,1.0,0.0
21885,63127,4939,4939,0,1.0,0.0
21886,63128,29356,29356,0,1.0,0.0
21887,63129,52718,52468,250,0.995,0.005
21888,63130,30084,30084,0,1.0,0.0
21889,63131,16769,16769,0,1.0,0.0
21890,63132,13988,13988,0,1.0,0.0
21891,63133,8161,8161,0,1.0,0.0
21892,63134,13638,13638,0,1.0,0.0
21893,63135,21334,21334,0,1.0,0.0
21894,63136,48560,48560,0,1.0,0.0
21895,63137,20654,20653,1,1.0,0.0
21896,63138,20175,19433,742,0.963,0.037
21897,63139,22789,22789,0,1.0,0.0
21898,63140,294,294,0,1.0,0.0
21899,63141,20593,20593,0,1.0,0.0
21900,63143,9678,9678,0,1.0,0.0
21901,63144,8825,8825,0,1.0,0.0
21902,63146,29262,29260,2,1.0,0.0
21903,63147,11373,11373,0,1.0,0.0
21904,63155,0,0,0,,
21905,63301,48514,47221,1293,0.973,0.027
21906,63303,45834,45832,2,1.0,0.0
21907,63304,40336,39787,549,0.986,0.014
21908,63330,125,0,125,0.0,1.0
21909,63332,1292,0,1292,0.0,1.0
21910,63333,783,0,783,0.0,1.0
21911,63334,8569,5356,3213,0.625,0.375
21912,63336,1146,0,1146,0.0,1.0
21913,63339,1145,0,1145,0.0,1.0
21914,63341,3530,0,3530,0.0,1.0
21915,63343,4546,0,4546,0.0,1.0
21916,63344,1663,0,1663,0.0,1.0
21917,63345,393,0,393,0.0,1.0
21918,63347,3078,0,3078,0.0,1.0
21919,63348,6059,159,5900,0.026,0.974
21920,63349,1934,0,1934,0.0,1.0
21921,63350,562,0,562,0.0,1.0
21922,63351,1768,0,1768,0.0,1.0
21923,63352,1078,0,1078,0.0,1.0
21924,63353,4593,3091,1502,0.673,0.327
21925,63357,5534,0,5534,0.0,1.0
21926,63359,1296,0,1296,0.0,1.0
21927,63361,4525,2629,1896,0.581,0.419
21928,63362,6350,2876,3474,0.453,0.547
21929,63363,1719,0,1719,0.0,1.0
21930,63366,46175,43055,3120,0.932,0.068
21931,63367,19433,18725,708,0.964,0.036
21932,63368,43360,43328,32,0.999,0.001
21933,63369,2258,0,2258,0.0,1.0
21934,63370,33,0,33,0.0,1.0
21935,63373,603,0,603,0.0,1.0
21936,63376,70828,70684,144,0.998,0.002
21937,63377,2462,0,2462,0.0,1.0
21938,63379,23348,10355,12993,0.444,0.556
21939,63381,532,0,532,0.0,1.0
21940,63382,4897,3656,1241,0.747,0.253
21941,63383,15770,8525,7245,0.541,0.459
21942,63384,1955,0,1955,0.0,1.0
21943,63385,35750,30597,5153,0.856,0.144
21944,63386,538,79,459,0.147,0.853
21945,63387,73,0,73,0.0,1.0
21946,63388,710,0,710,0.0,1.0
21947,63389,6336,0,6336,0.0,1.0
21948,63390,9760,3492,6268,0.358,0.642
21949,63401,22067,18472,3595,0.837,0.163
21950,63430,639,0,639,0.0,1.0
21951,63431,334,0,334,0.0,1.0
21952,63432,513,0,513,0.0,1.0
21953,63433,68,0,68,0.0,1.0
21954,63434,687,0,687,0.0,1.0
21955,63435,4219,0,4219,0.0,1.0
21956,63436,1155,0,1155,0.0,1.0
21957,63437,1503,0,1503,0.0,1.0
21958,63438,466,0,466,0.0,1.0
21959,63439,127,0,127,0.0,1.0
21960,63440,1407,0,1407,0.0,1.0
21961,63441,1121,0,1121,0.0,1.0
21962,63443,440,0,440,0.0,1.0
21963,63445,3911,0,3911,0.0,1.0
21964,63446,691,0,691,0.0,1.0
21965,63447,1133,0,1133,0.0,1.0
21966,63448,1520,0,1520,0.0,1.0
21967,63450,132,0,132,0.0,1.0
21968,63451,244,0,244,0.0,1.0
21969,63452,1167,0,1167,0.0,1.0
21970,63453,519,0,519,0.0,1.0
21971,63454,946,0,946,0.0,1.0
21972,63456,4271,0,4271,0.0,1.0
21973,63457,337,0,337,0.0,1.0
21974,63458,197,0,197,0.0,1.0
21975,63459,4153,0,4153,0.0,1.0
21976,63460,328,0,328,0.0,1.0
21977,63461,5876,3577,2299,0.609,0.391
21978,63462,1458,0,1458,0.0,1.0
21979,63463,652,0,652,0.0,1.0
21980,63464,21,0,21,0.0,1.0
21981,63465,407,0,407,0.0,1.0
21982,63467,75,0,75,0.0,1.0
21983,63468,2644,0,2644,0.0,1.0
21984,63469,1194,0,1194,0.0,1.0
21985,63471,639,0,639,0.0,1.0
21986,63472,587,0,587,0.0,1.0
21987,63473,262,0,262,0.0,1.0
21988,63474,479,0,479,0.0,1.0
21989,63501,21532,15914,5618,0.739,0.261
21990,63530,868,0,868,0.0,1.0
21991,63531,532,0,532,0.0,1.0
21992,63532,1322,0,1322,0.0,1.0
21993,63533,805,0,805,0.0,1.0
21994,63534,804,0,804,0.0,1.0
21995,63535,114,0,114,0.0,1.0
21996,63536,851,0,851,0.0,1.0
21997,63537,1916,0,1916,0.0,1.0
21998,63538,283,0,283,0.0,1.0
21999,63539,206,0,206,0.0,1.0
22000,63540,150,0,150,0.0,1.0
22001,63541,409,0,409,0.0,1.0
22002,63543,352,0,352,0.0,1.0
22003,63544,818,0,818,0.0,1.0
22004,63545,1111,0,1111,0.0,1.0
22005,63546,1715,0,1715,0.0,1.0
22006,63547,459,0,459,0.0,1.0
22007,63548,1287,0,1287,0.0,1.0
22008,63549,2742,0,2742,0.0,1.0
22009,63551,338,0,338,0.0,1.0
22010,63552,7926,5014,2912,0.633,0.367
22011,63555,3201,0,3201,0.0,1.0
22012,63556,3779,0,3779,0.0,1.0
22013,63557,291,0,291,0.0,1.0
22014,63558,742,0,742,0.0,1.0
22015,63559,1420,0,1420,0.0,1.0
22016,63560,239,0,239,0.0,1.0
22017,63561,1206,0,1206,0.0,1.0
22018,63563,575,0,575,0.0,1.0
22019,63565,3805,0,3805,0.0,1.0
22020,63566,125,0,125,0.0,1.0
22021,63567,192,0,192,0.0,1.0
22022,63601,16656,13425,3231,0.806,0.194
22023,63620,1619,0,1619,0.0,1.0
22024,63621,1228,490,738,0.399,0.601
22025,63622,1011,0,1011,0.0,1.0
22026,63623,882,0,882,0.0,1.0
22027,63624,3757,0,3757,0.0,1.0
22028,63625,457,0,457,0.0,1.0
22029,63626,1037,0,1037,0.0,1.0
22030,63627,2937,0,2937,0.0,1.0
22031,63628,16014,7857,8157,0.491,0.509
22032,63629,1314,0,1314,0.0,1.0
22033,63630,4062,0,4062,0.0,1.0
22034,63631,849,0,849,0.0,1.0
22035,63633,645,0,645,0.0,1.0
22036,63636,608,0,608,0.0,1.0
22037,63637,1329,0,1329,0.0,1.0
22038,63638,2920,0,2920,0.0,1.0
22039,63640,26335,16970,9365,0.644,0.356
22040,63645,11420,4217,7203,0.369,0.631
22041,63648,1628,0,1628,0.0,1.0
22042,63650,4401,1543,2858,0.351,0.649
22043,63653,1206,1118,88,0.927,0.073
22044,63654,706,0,706,0.0,1.0
22045,63655,1523,0,1523,0.0,1.0
22046,63656,531,0,531,0.0,1.0
22047,63660,4276,1845,2431,0.431,0.569
22048,63662,1185,0,1185,0.0,1.0
22049,63663,723,640,83,0.885,0.115
22050,63664,8920,3074,5846,0.345,0.655
22051,63665,241,0,241,0.0,1.0
22052,63666,93,0,93,0.0,1.0
22053,63670,11295,4329,6966,0.383,0.617
22054,63673,2115,0,2115,0.0,1.0
22055,63674,132,0,132,0.0,1.0
22056,63675,144,0,144,0.0,1.0
22057,63701,36812,30741,6071,0.835,0.165
22058,63703,8182,8150,32,0.996,0.004
22059,63730,3430,0,3430,0.0,1.0
22060,63732,834,0,834,0.0,1.0
22061,63735,847,0,847,0.0,1.0
22062,63736,3310,0,3310,0.0,1.0
22063,63738,76,0,76,0.0,1.0
22064,63739,464,0,464,0.0,1.0
22065,63740,5339,2973,2366,0.557,0.443
22066,63742,64,0,64,0.0,1.0
22067,63743,122,0,122,0.0,1.0
22068,63744,111,0,111,0.0,1.0
22069,63745,66,0,66,0.0,1.0
22070,63746,65,0,65,0.0,1.0
22071,63747,469,0,469,0.0,1.0
22072,63748,1015,0,1015,0.0,1.0
22073,63750,43,0,43,0.0,1.0
22074,63751,1249,0,1249,0.0,1.0
22075,63755,24006,13700,10306,0.571,0.429
22076,63758,170,164,6,0.965,0.035
22077,63760,614,0,614,0.0,1.0
22078,63763,223,0,223,0.0,1.0
22079,63764,5984,0,5984,0.0,1.0
22080,63766,1288,0,1288,0.0,1.0
22081,63767,655,0,655,0.0,1.0
22082,63769,1389,0,1389,0.0,1.0
22083,63770,192,0,192,0.0,1.0
22084,63771,2862,0,2862,0.0,1.0
22085,63774,76,0,76,0.0,1.0
22086,63775,16710,8419,8291,0.504,0.496
22087,63780,6740,5052,1688,0.75,0.25
22088,63781,1272,0,1272,0.0,1.0
22089,63782,274,0,274,0.0,1.0
22090,63783,132,0,132,0.0,1.0
22091,63784,279,0,279,0.0,1.0
22092,63785,1000,0,1000,0.0,1.0
22093,63787,719,0,719,0.0,1.0
22094,63801,23123,16536,6587,0.715,0.285
22095,63820,226,0,226,0.0,1.0
22096,63821,970,0,970,0.0,1.0
22097,63822,2867,0,2867,0.0,1.0
22098,63823,1247,0,1247,0.0,1.0
22099,63824,164,0,164,0.0,1.0
22100,63825,4409,0,4409,0.0,1.0
22101,63826,84,0,84,0.0,1.0
22102,63827,829,0,829,0.0,1.0
22103,63828,345,0,345,0.0,1.0
22104,63829,1120,0,1120,0.0,1.0
22105,63830,7102,5786,1316,0.815,0.185
22106,63833,242,0,242,0.0,1.0
22107,63834,7135,5893,1242,0.826,0.174
22108,63837,1653,0,1653,0.0,1.0
22109,63839,485,0,485,0.0,1.0
22110,63841,13123,9053,4070,0.69,0.31
22111,63845,5814,3770,2044,0.648,0.352
22112,63846,1554,0,1554,0.0,1.0
22113,63847,64,0,64,0.0,1.0
22114,63848,1592,0,1592,0.0,1.0
22115,63849,186,0,186,0.0,1.0
22116,63851,4225,3489,736,0.826,0.174
22117,63852,1488,0,1488,0.0,1.0
22118,63853,244,0,244,0.0,1.0
22119,63855,1117,0,1117,0.0,1.0
22120,63857,12956,11241,1715,0.868,0.132
22121,63860,131,0,131,0.0,1.0
22122,63862,1705,140,1565,0.082,0.918
22123,63863,6359,4590,1769,0.722,0.278
22124,63866,488,0,488,0.0,1.0
22125,63867,1019,0,1019,0.0,1.0
22126,63868,838,0,838,0.0,1.0
22127,63869,3783,3074,709,0.813,0.187
22128,63870,1097,0,1097,0.0,1.0
22129,63873,4947,3151,1796,0.637,0.363
22130,63874,350,0,350,0.0,1.0
22131,63876,2374,0,2374,0.0,1.0
22132,63877,3931,0,3931,0.0,1.0
22133,63878,138,0,138,0.0,1.0
22134,63879,773,0,773,0.0,1.0
22135,63880,117,0,117,0.0,1.0
22136,63882,431,0,431,0.0,1.0
22137,63901,34665,20463,14202,0.59,0.41
22138,63902,0,0,0,,
22139,63932,1254,0,1254,0.0,1.0
22140,63933,3719,0,3719,0.0,1.0
22141,63934,201,0,201,0.0,1.0
22142,63935,10158,0,10158,0.0,1.0
22143,63936,754,0,754,0.0,1.0
22144,63937,2922,0,2922,0.0,1.0
22145,63939,1430,0,1430,0.0,1.0
22146,63940,1393,0,1393,0.0,1.0
22147,63941,371,0,371,0.0,1.0
22148,63942,652,0,652,0.0,1.0
22149,63943,915,0,915,0.0,1.0
22150,63944,1844,0,1844,0.0,1.0
22151,63945,1163,0,1163,0.0,1.0
22152,63951,331,0,331,0.0,1.0
22153,63952,408,0,408,0.0,1.0
22154,63953,1635,0,1635,0.0,1.0
22155,63954,1219,0,1219,0.0,1.0
22156,63955,288,0,288,0.0,1.0
22157,63956,1133,0,1133,0.0,1.0
22158,63957,5440,0,5440,0.0,1.0
22159,63960,3326,0,3326,0.0,1.0
22160,63961,1610,0,1610,0.0,1.0
22161,63962,41,0,41,0.0,1.0
22162,63964,784,0,784,0.0,1.0
22163,63965,2697,0,2697,0.0,1.0
22164,63966,2601,0,2601,0.0,1.0
22165,63967,1906,0,1906,0.0,1.0
22166,64001,656,0,656,0.0,1.0
22167,64011,3106,0,3106,0.0,1.0
22168,64012,27260,22936,4324,0.841,0.159
22169,64014,24797,24332,465,0.981,0.019
22170,64015,31217,31072,145,0.995,0.005
22171,64016,4713,3034,1679,0.644,0.356
22172,64017,464,0,464,0.0,1.0
22173,64018,890,0,890,0.0,1.0
22174,64019,2368,132,2236,0.056,0.944
22175,64020,3608,0,3608,0.0,1.0
22176,64021,633,0,633,0.0,1.0
22177,64022,183,0,183,0.0,1.0
22178,64024,16230,10943,5287,0.674,0.326
22179,64029,16574,13952,2622,0.842,0.158
22180,64030,24422,24403,19,0.999,0.001
22181,64034,7612,6058,1554,0.796,0.204
22182,64035,971,0,971,0.0,1.0
22183,64036,389,341,48,0.877,0.123
22184,64037,6150,4621,1529,0.751,0.249
22185,64040,6574,0,6574,0.0,1.0
22186,64048,4140,0,4140,0.0,1.0
22187,64050,22178,22132,46,0.998,0.002
22188,64052,20911,20911,0,1.0,0.0
22189,64053,5319,5319,0,1.0,0.0
22190,64054,3731,3731,0,1.0,0.0
22191,64055,33858,33858,0,1.0,0.0
22192,64056,16576,15789,787,0.953,0.047
22193,64057,14141,13399,742,0.948,0.052
22194,64058,6659,4880,1779,0.733,0.267
22195,64060,13042,7368,5674,0.565,0.435
22196,64061,3387,0,3387,0.0,1.0
22197,64062,6121,0,6121,0.0,1.0
22198,64063,20374,20374,0,1.0,0.0
22199,64064,16223,15085,1138,0.93,0.07
22200,64065,27,0,27,0.0,1.0
22201,64066,38,0,38,0.0,1.0
22202,64067,5789,4507,1282,0.779,0.221
22203,64068,36280,31469,4811,0.867,0.133
22204,64070,3309,0,3309,0.0,1.0
22205,64071,828,0,828,0.0,1.0
22206,64072,239,0,239,0.0,1.0
22207,64074,638,0,638,0.0,1.0
22208,64075,11810,7517,4293,0.636,0.364
22209,64076,9512,5199,4313,0.547,0.453
22210,64077,1940,0,1940,0.0,1.0
22211,64078,8902,4622,4280,0.519,0.481
22212,64079,12485,8951,3534,0.717,0.283
22213,64080,12866,8049,4817,0.626,0.374
22214,64081,23144,22505,639,0.972,0.028
22215,64082,14456,13604,852,0.941,0.059
22216,64083,20995,19246,1749,0.917,0.083
22217,64084,1556,0,1556,0.0,1.0
22218,64085,8803,4966,3837,0.564,0.436
22219,64086,21925,20020,1905,0.913,0.087
22220,64088,1378,0,1378,0.0,1.0
22221,64089,11470,7297,4173,0.636,0.364
22222,64090,116,0,116,0.0,1.0
22223,64092,44,0,44,0.0,1.0
22224,64093,27608,20545,7063,0.744,0.256
22225,64096,1171,0,1171,0.0,1.0
22226,64097,1410,0,1410,0.0,1.0
22227,64098,2892,0,2892,0.0,1.0
22228,64101,339,339,0,1.0,0.0
22229,64102,0,0,0,,
22230,64105,3505,3505,0,1.0,0.0
22231,64106,7701,7701,0,1.0,0.0
22232,64108,7584,7584,0,1.0,0.0
22233,64109,9931,9931,0,1.0,0.0
22234,64110,15318,15318,0,1.0,0.0
22235,64111,16318,16318,0,1.0,0.0
22236,64112,8147,8147,0,1.0,0.0
22237,64113,11328,11328,0,1.0,0.0
22238,64114,23158,23158,0,1.0,0.0
22239,64116,15318,15318,0,1.0,0.0
22240,64117,14017,14017,0,1.0,0.0
22241,64118,40191,40191,0,1.0,0.0
22242,64119,27341,27341,0,1.0,0.0
22243,64120,369,369,0,1.0,0.0
22244,64123,10387,10387,0,1.0,0.0
22245,64124,12639,12639,0,1.0,0.0
22246,64125,1953,1953,0,1.0,0.0
22247,64126,6514,6514,0,1.0,0.0
22248,64127,17332,17332,0,1.0,0.0
22249,64128,11613,11613,0,1.0,0.0
22250,64129,9486,9256,230,0.976,0.024
22251,64130,20492,20452,40,0.998,0.002
22252,64131,21465,21465,0,1.0,0.0
22253,64132,13810,13802,8,0.999,0.001
22254,64133,33780,33140,640,0.981,0.019
22255,64134,21973,21446,527,0.976,0.024
22256,64136,2153,1762,391,0.818,0.182
22257,64137,10554,10554,0,1.0,0.0
22258,64138,25294,24819,475,0.981,0.019
22259,64139,1762,1404,358,0.797,0.203
22260,64145,5389,5215,174,0.968,0.032
22261,64146,1376,1164,212,0.846,0.154
22262,64147,769,764,5,0.993,0.007
22263,64149,343,0,343,0.0,1.0
22264,64150,3048,3048,0,1.0,0.0
22265,64151,24134,24134,0,1.0,0.0
22266,64152,26024,25371,653,0.975,0.025
22267,64153,5358,4935,423,0.921,0.079
22268,64154,9257,8459,798,0.914,0.086
22269,64155,21901,21768,133,0.994,0.006
22270,64156,5404,4097,1307,0.758,0.242
22271,64157,16122,15753,369,0.977,0.023
22272,64158,5161,5161,0,1.0,0.0
22273,64161,388,224,164,0.577,0.423
22274,64163,689,0,689,0.0,1.0
22275,64164,302,0,302,0.0,1.0
22276,64165,112,2,110,0.018,0.982
22277,64166,278,24,254,0.086,0.914
22278,64167,353,0,353,0.0,1.0
22279,64192,15,15,0,1.0,0.0
22280,64401,1417,0,1417,0.0,1.0
22281,64402,2388,0,2388,0.0,1.0
22282,64420,53,0,53,0.0,1.0
22283,64421,952,0,952,0.0,1.0
22284,64422,337,0,337,0.0,1.0
22285,64423,761,0,761,0.0,1.0
22286,64424,4585,2652,1933,0.578,0.422
22287,64426,356,0,356,0.0,1.0
22288,64427,606,0,606,0.0,1.0
22289,64428,898,0,898,0.0,1.0
22290,64429,13158,9782,3376,0.743,0.257
22291,64430,764,0,764,0.0,1.0
22292,64431,382,0,382,0.0,1.0
22293,64432,141,0,141,0.0,1.0
22294,64433,210,0,210,0.0,1.0
22295,64434,518,0,518,0.0,1.0
22296,64436,781,0,781,0.0,1.0
22297,64437,792,0,792,0.0,1.0
22298,64438,270,0,270,0.0,1.0
22299,64439,1642,0,1642,0.0,1.0
22300,64440,737,0,737,0.0,1.0
22301,64441,178,0,178,0.0,1.0
22302,64442,882,0,882,0.0,1.0
22303,64443,1096,0,1096,0.0,1.0
22304,64444,1340,0,1340,0.0,1.0
22305,64445,312,0,312,0.0,1.0
22306,64446,1117,0,1117,0.0,1.0
22307,64448,1104,0,1104,0.0,1.0
22308,64449,451,0,451,0.0,1.0
22309,64451,446,0,446,0.0,1.0
22310,64453,217,0,217,0.0,1.0
22311,64454,2667,0,2667,0.0,1.0
22312,64455,368,0,368,0.0,1.0
22313,64456,1459,0,1459,0.0,1.0
22314,64457,329,0,329,0.0,1.0
22315,64458,145,0,145,0.0,1.0
22316,64459,472,0,472,0.0,1.0
22317,64461,897,0,897,0.0,1.0
22318,64463,1643,0,1643,0.0,1.0
22319,64465,4251,0,4251,0.0,1.0
22320,64466,541,0,541,0.0,1.0
22321,64467,186,0,186,0.0,1.0
22322,64468,16023,13220,2803,0.825,0.175
22323,64469,2339,0,2339,0.0,1.0
22324,64470,1631,0,1631,0.0,1.0
22325,64471,483,0,483,0.0,1.0
22326,64473,1457,0,1457,0.0,1.0
22327,64474,820,0,820,0.0,1.0
22328,64475,468,0,468,0.0,1.0
22329,64476,379,0,379,0.0,1.0
22330,64477,3404,0,3404,0.0,1.0
22331,64479,906,0,906,0.0,1.0
22332,64480,307,0,307,0.0,1.0
22333,64481,1088,0,1088,0.0,1.0
22334,64482,2101,0,2101,0.0,1.0
22335,64483,709,0,709,0.0,1.0
22336,64484,1229,22,1207,0.018,0.982
22337,64485,8124,5138,2986,0.632,0.368
22338,64486,455,0,455,0.0,1.0
22339,64487,757,0,757,0.0,1.0
22340,64489,2198,0,2198,0.0,1.0
22341,64490,2056,0,2056,0.0,1.0
22342,64491,1875,0,1875,0.0,1.0
22343,64492,1782,0,1782,0.0,1.0
22344,64493,460,0,460,0.0,1.0
22345,64494,1018,0,1018,0.0,1.0
22346,64496,154,0,154,0.0,1.0
22347,64497,598,0,598,0.0,1.0
22348,64498,375,0,375,0.0,1.0
22349,64499,119,0,119,0.0,1.0
22350,64501,12503,12503,0,1.0,0.0
22351,64503,12921,12660,261,0.98,0.02
22352,64504,10763,9169,1594,0.852,0.148
22353,64505,13161,9347,3814,0.71,0.29
22354,64506,24030,23977,53,0.998,0.002
22355,64507,13738,11152,2586,0.812,0.188
22356,64601,12438,9633,2805,0.774,0.226
22357,64620,466,0,466,0.0,1.0
22358,64622,600,0,600,0.0,1.0
22359,64623,609,0,609,0.0,1.0
22360,64624,1662,0,1662,0.0,1.0
22361,64625,644,0,644,0.0,1.0
22362,64628,6144,4281,1863,0.697,0.303
22363,64630,602,0,602,0.0,1.0
22364,64631,902,0,902,0.0,1.0
22365,64632,629,0,629,0.0,1.0
22366,64633,5216,3296,1920,0.632,0.368
22367,64635,515,0,515,0.0,1.0
22368,64636,299,0,299,0.0,1.0
22369,64637,667,0,667,0.0,1.0
22370,64638,521,0,521,0.0,1.0
22371,64639,240,0,240,0.0,1.0
22372,64640,3140,0,3140,0.0,1.0
22373,64641,666,0,666,0.0,1.0
22374,64642,855,0,855,0.0,1.0
22375,64643,1072,0,1072,0.0,1.0
22376,64644,3024,0,3024,0.0,1.0
22377,64645,195,0,195,0.0,1.0
22378,64646,297,0,297,0.0,1.0
22379,64647,379,0,379,0.0,1.0
22380,64648,2129,0,2129,0.0,1.0
22381,64649,864,0,864,0.0,1.0
22382,64650,727,0,727,0.0,1.0
22383,64651,570,0,570,0.0,1.0
22384,64652,441,0,441,0.0,1.0
22385,64653,687,0,687,0.0,1.0
22386,64654,52,0,52,0.0,1.0
22387,64655,264,0,264,0.0,1.0
22388,64656,240,0,240,0.0,1.0
22389,64657,323,0,323,0.0,1.0
22390,64658,3277,0,3277,0.0,1.0
22391,64659,964,0,964,0.0,1.0
22392,64660,513,0,513,0.0,1.0
22393,64661,916,0,916,0.0,1.0
22394,64664,350,0,350,0.0,1.0
22395,64667,395,0,395,0.0,1.0
22396,64668,1416,0,1416,0.0,1.0
22397,64670,1090,0,1090,0.0,1.0
22398,64671,2062,0,2062,0.0,1.0
22399,64672,251,0,251,0.0,1.0
22400,64673,2492,0,2492,0.0,1.0
22401,64674,428,0,428,0.0,1.0
22402,64676,215,0,215,0.0,1.0
22403,64679,805,0,805,0.0,1.0
22404,64681,192,0,192,0.0,1.0
22405,64682,378,0,378,0.0,1.0
22406,64683,8144,5596,2548,0.687,0.313
22407,64686,271,0,271,0.0,1.0
22408,64688,548,0,548,0.0,1.0
22409,64689,683,0,683,0.0,1.0
22410,64701,14385,9358,5027,0.651,0.349
22411,64720,3843,0,3843,0.0,1.0
22412,64722,525,0,525,0.0,1.0
22413,64723,665,0,665,0.0,1.0
22414,64724,1859,0,1859,0.0,1.0
22415,64725,2271,0,2271,0.0,1.0
22416,64726,467,0,467,0.0,1.0
22417,64728,594,0,594,0.0,1.0
22418,64730,7109,3875,3234,0.545,0.455
22419,64733,1159,0,1159,0.0,1.0
22420,64734,2004,0,2004,0.0,1.0
22421,64735,13258,8740,4518,0.659,0.341
22422,64738,1149,0,1149,0.0,1.0
22423,64739,997,0,997,0.0,1.0
22424,64740,1884,0,1884,0.0,1.0
22425,64741,351,0,351,0.0,1.0
22426,64742,2193,0,2193,0.0,1.0
22427,64743,292,0,292,0.0,1.0
22428,64744,7836,3454,4382,0.441,0.559
22429,64745,117,0,117,0.0,1.0
22430,64746,1428,0,1428,0.0,1.0
22431,64747,3910,0,3910,0.0,1.0
22432,64748,1493,0,1493,0.0,1.0
22433,64750,423,0,423,0.0,1.0
22434,64752,735,0,735,0.0,1.0
22435,64755,2596,0,2596,0.0,1.0
22436,64756,742,0,742,0.0,1.0
22437,64759,8244,4470,3774,0.542,0.458
22438,64761,1493,0,1493,0.0,1.0
22439,64762,1604,0,1604,0.0,1.0
22440,64763,1568,0,1568,0.0,1.0
22441,64765,44,0,44,0.0,1.0
22442,64767,821,0,821,0.0,1.0
22443,64769,611,0,611,0.0,1.0
22444,64770,1056,0,1056,0.0,1.0
22445,64771,610,0,610,0.0,1.0
22446,64772,13596,8832,4764,0.65,0.35
22447,64776,3942,0,3942,0.0,1.0
22448,64778,702,0,702,0.0,1.0
22449,64779,2693,0,2693,0.0,1.0
22450,64780,639,0,639,0.0,1.0
22451,64781,106,0,106,0.0,1.0
22452,64783,775,0,775,0.0,1.0
22453,64784,1500,0,1500,0.0,1.0
22454,64788,1415,0,1415,0.0,1.0
22455,64790,861,0,861,0.0,1.0
22456,64801,34753,30705,4048,0.884,0.116
22457,64804,37521,28741,8780,0.766,0.234
22458,64830,639,0,639,0.0,1.0
22459,64831,5879,0,5879,0.0,1.0
22460,64832,731,0,731,0.0,1.0
22461,64833,125,0,125,0.0,1.0
22462,64834,9556,7468,2088,0.781,0.219
22463,64835,1899,1752,147,0.923,0.077
22464,64836,23940,15496,8444,0.647,0.353
22465,64840,2813,0,2813,0.0,1.0
22466,64841,384,384,0,1.0,0.0
22467,64842,829,0,829,0.0,1.0
22468,64843,3259,0,3259,0.0,1.0
22469,64844,4680,0,4680,0.0,1.0
22470,64847,437,0,437,0.0,1.0
22471,64848,744,0,744,0.0,1.0
22472,64849,186,0,186,0.0,1.0
22473,64850,24063,11955,12108,0.497,0.503
22474,64854,4170,0,4170,0.0,1.0
22475,64855,2795,1392,1403,0.498,0.502
22476,64856,4251,2,4249,0.0,1.0
22477,64857,424,0,424,0.0,1.0
22478,64858,166,0,166,0.0,1.0
22479,64859,1358,0,1358,0.0,1.0
22480,64861,1179,0,1179,0.0,1.0
22481,64862,3337,0,3337,0.0,1.0
22482,64863,1828,0,1828,0.0,1.0
22483,64865,5997,0,5997,0.0,1.0
22484,64866,1484,0,1484,0.0,1.0
22485,64867,1440,0,1440,0.0,1.0
22486,64870,14325,12363,1962,0.863,0.137
22487,64873,1072,0,1072,0.0,1.0
22488,64874,760,0,760,0.0,1.0
22489,65001,414,0,414,0.0,1.0
22490,65010,5704,3527,2177,0.618,0.382
22491,65011,2374,0,2374,0.0,1.0
22492,65013,3515,0,3515,0.0,1.0
22493,65014,2252,0,2252,0.0,1.0
22494,65016,1376,0,1376,0.0,1.0
22495,65017,1549,0,1549,0.0,1.0
22496,65018,7714,4181,3533,0.542,0.458
22497,65020,14286,3632,10654,0.254,0.746
22498,65023,1730,38,1692,0.022,0.978
22499,65024,1086,0,1086,0.0,1.0
22500,65025,786,0,786,0.0,1.0
22501,65026,11551,4555,6996,0.394,0.606
22502,65032,1792,0,1792,0.0,1.0
22503,65034,679,0,679,0.0,1.0
22504,65035,1826,0,1826,0.0,1.0
22505,65037,4938,0,4938,0.0,1.0
22506,65039,2328,0,2328,0.0,1.0
22507,65040,1208,0,1208,0.0,1.0
22508,65041,5725,0,5725,0.0,1.0
22509,65043,9452,4637,4815,0.491,0.509
22510,65046,1194,0,1194,0.0,1.0
22511,65047,1351,0,1351,0.0,1.0
22512,65048,154,0,154,0.0,1.0
22513,65049,6618,4669,1949,0.706,0.294
22514,65050,755,0,755,0.0,1.0
22515,65051,4874,0,4874,0.0,1.0
22516,65052,3446,0,3446,0.0,1.0
22517,65053,1425,31,1394,0.022,0.978
22518,65054,835,0,835,0.0,1.0
22519,65058,1017,0,1017,0.0,1.0
22520,65059,867,0,867,0.0,1.0
22521,65061,746,0,746,0.0,1.0
22522,65062,49,0,49,0.0,1.0
22523,65063,3412,0,3412,0.0,1.0
22524,65064,578,0,578,0.0,1.0
22525,65065,6414,3488,2926,0.544,0.456
22526,65066,6703,2912,3791,0.434,0.566
22527,65067,379,0,379,0.0,1.0
22528,65068,827,0,827,0.0,1.0
22529,65069,645,0,645,0.0,1.0
22530,65072,1847,0,1847,0.0,1.0
22531,65074,3061,0,3061,0.0,1.0
22532,65075,784,0,784,0.0,1.0
22533,65076,829,0,829,0.0,1.0
22534,65077,561,0,561,0.0,1.0
22535,65078,3743,0,3743,0.0,1.0
22536,65079,4729,0,4729,0.0,1.0
22537,65080,1015,0,1015,0.0,1.0
22538,65081,3928,3201,727,0.815,0.185
22539,65082,1127,0,1127,0.0,1.0
22540,65083,375,0,375,0.0,1.0
22541,65084,6797,0,6797,0.0,1.0
22542,65085,1240,0,1240,0.0,1.0
22543,65101,30587,21193,9394,0.693,0.307
22544,65109,38090,32634,5456,0.857,0.143
22545,65201,39417,35594,3823,0.903,0.097
22546,65202,46547,38306,8241,0.823,0.177
22547,65203,53307,50645,2662,0.95,0.05
22548,65215,203,203,0,1.0,0.0
22549,65230,703,0,703,0.0,1.0
22550,65231,3334,0,3334,0.0,1.0
22551,65232,249,0,249,0.0,1.0
22552,65233,11703,8237,3466,0.704,0.296
22553,65236,1404,0,1404,0.0,1.0
22554,65237,907,0,907,0.0,1.0
22555,65239,1309,0,1309,0.0,1.0
22556,65240,7590,3813,3777,0.502,0.498
22557,65243,2806,0,2806,0.0,1.0
22558,65244,412,0,412,0.0,1.0
22559,65246,101,0,101,0.0,1.0
22560,65247,616,0,616,0.0,1.0
22561,65248,4619,2654,1965,0.575,0.425
22562,65250,617,25,592,0.041,0.959
22563,65251,22437,12197,10240,0.544,0.456
22564,65254,1810,0,1810,0.0,1.0
22565,65255,3731,0,3731,0.0,1.0
22566,65256,1787,0,1787,0.0,1.0
22567,65257,1564,0,1564,0.0,1.0
22568,65258,500,0,500,0.0,1.0
22569,65259,2858,0,2858,0.0,1.0
22570,65260,574,0,574,0.0,1.0
22571,65261,1094,0,1094,0.0,1.0
22572,65262,955,0,955,0.0,1.0
22573,65263,1948,0,1948,0.0,1.0
22574,65264,720,0,720,0.0,1.0
22575,65265,15409,11356,4053,0.737,0.263
22576,65270,17681,13933,3748,0.788,0.212
22577,65274,1710,967,743,0.565,0.435
22578,65275,2535,0,2535,0.0,1.0
22579,65276,1609,0,1609,0.0,1.0
22580,65278,123,0,123,0.0,1.0
22581,65279,1766,0,1766,0.0,1.0
22582,65280,243,0,243,0.0,1.0
22583,65281,3098,0,3098,0.0,1.0
22584,65282,178,0,178,0.0,1.0
22585,65283,387,0,387,0.0,1.0
22586,65284,2361,0,2361,0.0,1.0
22587,65285,695,0,695,0.0,1.0
22588,65286,129,0,129,0.0,1.0
22589,65287,422,0,422,0.0,1.0
22590,65301,34267,26178,8089,0.764,0.236
22591,65305,2538,2538,0,1.0,0.0
22592,65320,56,0,56,0.0,1.0
22593,65321,417,0,417,0.0,1.0
22594,65322,587,0,587,0.0,1.0
22595,65323,976,0,976,0.0,1.0
22596,65324,1634,0,1634,0.0,1.0
22597,65325,3171,0,3171,0.0,1.0
22598,65326,1996,0,1996,0.0,1.0
22599,65327,227,0,227,0.0,1.0
22600,65329,494,0,494,0.0,1.0
22601,65330,412,0,412,0.0,1.0
22602,65332,1652,0,1652,0.0,1.0
22603,65333,759,0,759,0.0,1.0
22604,65334,935,0,935,0.0,1.0
22605,65335,196,0,196,0.0,1.0
22606,65336,5981,2849,3132,0.476,0.524
22607,65337,1899,0,1899,0.0,1.0
22608,65338,3046,0,3046,0.0,1.0
22609,65339,712,0,712,0.0,1.0
22610,65340,15937,12665,3272,0.795,0.205
22611,65344,332,0,332,0.0,1.0
22612,65345,387,0,387,0.0,1.0
22613,65347,681,0,681,0.0,1.0
22614,65348,1350,0,1350,0.0,1.0
22615,65349,2441,0,2441,0.0,1.0
22616,65350,1822,0,1822,0.0,1.0
22617,65351,2525,0,2525,0.0,1.0
22618,65354,628,0,628,0.0,1.0
22619,65355,10519,2565,7954,0.244,0.756
22620,65360,4752,2577,2175,0.542,0.458
22621,65401,32383,20160,12223,0.623,0.377
22622,65436,91,0,91,0.0,1.0
22623,65438,2980,0,2980,0.0,1.0
22624,65439,259,0,259,0.0,1.0
22625,65440,527,0,527,0.0,1.0
22626,65441,5194,1998,3196,0.385,0.615
22627,65443,96,0,96,0.0,1.0
22628,65444,1087,0,1087,0.0,1.0
22629,65446,331,0,331,0.0,1.0
22630,65449,351,0,351,0.0,1.0
22631,65452,3315,0,3315,0.0,1.0
22632,65453,8548,3273,5275,0.383,0.617
22633,65456,518,0,518,0.0,1.0
22634,65457,338,0,338,0.0,1.0
22635,65459,8233,232,8001,0.028,0.972
22636,65461,105,0,105,0.0,1.0
22637,65462,1593,0,1593,0.0,1.0
22638,65463,1011,0,1011,0.0,1.0
22639,65464,492,0,492,0.0,1.0
22640,65466,1634,0,1634,0.0,1.0
22641,65468,102,0,102,0.0,1.0
22642,65470,923,0,923,0.0,1.0
22643,65473,15059,14412,647,0.957,0.043
22644,65479,441,0,441,0.0,1.0
22645,65483,4737,0,4737,0.0,1.0
22646,65484,186,0,186,0.0,1.0
22647,65486,3423,0,3423,0.0,1.0
22648,65501,163,0,163,0.0,1.0
22649,65529,232,0,232,0.0,1.0
22650,65534,1029,0,1029,0.0,1.0
22651,65535,1673,0,1673,0.0,1.0
22652,65536,28874,14046,14828,0.486,0.514
22653,65541,236,0,236,0.0,1.0
22654,65542,6776,0,6776,0.0,1.0
22655,65543,431,0,431,0.0,1.0
22656,65548,5908,0,5908,0.0,1.0
22657,65550,3127,0,3127,0.0,1.0
22658,65552,2013,0,2013,0.0,1.0
22659,65555,1087,0,1087,0.0,1.0
22660,65556,5869,0,5869,0.0,1.0
22661,65557,166,0,166,0.0,1.0
22662,65559,9385,4123,5262,0.439,0.561
22663,65560,14392,4921,9471,0.342,0.658
22664,65564,220,0,220,0.0,1.0
22665,65565,5854,0,5854,0.0,1.0
22666,65566,772,0,772,0.0,1.0
22667,65567,1253,0,1253,0.0,1.0
22668,65570,528,0,528,0.0,1.0
22669,65571,2134,0,2134,0.0,1.0
22670,65580,829,0,829,0.0,1.0
22671,65582,2181,0,2181,0.0,1.0
22672,65583,12307,6795,5512,0.552,0.448
22673,65584,9855,7818,2037,0.793,0.207
22674,65586,33,0,33,0.0,1.0
22675,65588,2680,0,2680,0.0,1.0
22676,65589,188,0,188,0.0,1.0
22677,65590,1231,0,1231,0.0,1.0
22678,65591,1512,0,1512,0.0,1.0
22679,65601,812,0,812,0.0,1.0
22680,65603,206,0,206,0.0,1.0
22681,65604,3746,0,3746,0.0,1.0
22682,65605,12136,7577,4559,0.624,0.376
22683,65606,3613,0,3613,0.0,1.0
22684,65608,9403,2857,6546,0.304,0.696
22685,65609,778,0,778,0.0,1.0
22686,65610,5239,0,5239,0.0,1.0
22687,65611,1969,0,1969,0.0,1.0
22688,65612,1354,0,1354,0.0,1.0
22689,65613,17396,9693,7703,0.557,0.443
22690,65614,591,0,591,0.0,1.0
22691,65616,24284,17149,7135,0.706,0.294
22692,65617,1630,0,1630,0.0,1.0
22693,65618,148,0,148,0.0,1.0
22694,65619,7393,6481,912,0.877,0.123
22695,65620,262,0,262,0.0,1.0
22696,65622,8716,3031,5685,0.348,0.652
22697,65623,36,0,36,0.0,1.0
22698,65624,1577,0,1577,0.0,1.0
22699,65625,8328,3376,4952,0.405,0.595
22700,65626,1637,0,1637,0.0,1.0
22701,65627,460,0,460,0.0,1.0
22702,65629,574,0,574,0.0,1.0
22703,65630,310,0,310,0.0,1.0
22704,65631,4678,0,4678,0.0,1.0
22705,65632,2939,0,2939,0.0,1.0
22706,65633,4131,0,4131,0.0,1.0
22707,65634,766,0,766,0.0,1.0
22708,65635,541,0,541,0.0,1.0
22709,65637,1135,0,1135,0.0,1.0
22710,65638,461,0,461,0.0,1.0
22711,65640,887,0,887,0.0,1.0
22712,65641,1250,0,1250,0.0,1.0
22713,65644,2759,0,2759,0.0,1.0
22714,65646,2046,0,2046,0.0,1.0
22715,65647,2347,708,1639,0.302,0.698
22716,65648,5614,0,5614,0.0,1.0
22717,65649,1593,0,1593,0.0,1.0
22718,65650,1520,0,1520,0.0,1.0
22719,65652,4157,0,4157,0.0,1.0
22720,65653,5708,2785,2923,0.488,0.512
22721,65654,159,0,159,0.0,1.0
22722,65655,3186,0,3186,0.0,1.0
22723,65656,4929,0,4929,0.0,1.0
22724,65657,94,0,94,0.0,1.0
22725,65658,1131,0,1131,0.0,1.0
22726,65660,182,0,182,0.0,1.0
22727,65661,2562,0,2562,0.0,1.0
22728,65662,1269,0,1269,0.0,1.0
22729,65663,2481,0,2481,0.0,1.0
22730,65664,159,0,159,0.0,1.0
22731,65667,3305,0,3305,0.0,1.0
22732,65668,1745,0,1745,0.0,1.0
22733,65669,2031,0,2031,0.0,1.0
22734,65672,9048,6128,2920,0.677,0.323
22735,65674,2991,0,2991,0.0,1.0
22736,65676,472,0,472,0.0,1.0
22737,65679,2704,133,2571,0.049,0.951
22738,65680,1201,0,1201,0.0,1.0
22739,65681,2345,0,2345,0.0,1.0
22740,65682,1980,0,1980,0.0,1.0
22741,65685,877,0,877,0.0,1.0
22742,65686,4920,3168,1752,0.644,0.356
22743,65689,4859,0,4859,0.0,1.0
22744,65690,298,0,298,0.0,1.0
22745,65692,1332,0,1332,0.0,1.0
22746,65702,473,0,473,0.0,1.0
22747,65704,4047,0,4047,0.0,1.0
22748,65705,3999,0,3999,0.0,1.0
22749,65706,14439,6701,7738,0.464,0.536
22750,65707,2299,0,2299,0.0,1.0
22751,65708,12624,8470,4154,0.671,0.329
22752,65710,1275,0,1275,0.0,1.0
22753,65711,9926,4603,5323,0.464,0.536
22754,65712,8494,4559,3935,0.537,0.463
22755,65713,2496,0,2496,0.0,1.0
22756,65714,29818,23675,6143,0.794,0.206
22757,65715,92,0,92,0.0,1.0
22758,65717,2568,0,2568,0.0,1.0
22759,65720,665,0,665,0.0,1.0
22760,65721,28550,19798,8752,0.693,0.307
22761,65722,1909,0,1909,0.0,1.0
22762,65723,3606,0,3606,0.0,1.0
22763,65724,1392,0,1392,0.0,1.0
22764,65725,2459,0,2459,0.0,1.0
22765,65727,218,0,218,0.0,1.0
22766,65728,76,0,76,0.0,1.0
22767,65729,264,0,264,0.0,1.0
22768,65730,196,0,196,0.0,1.0
22769,65731,281,0,281,0.0,1.0
22770,65732,871,0,871,0.0,1.0
22771,65733,720,0,720,0.0,1.0
22772,65734,3497,0,3497,0.0,1.0
22773,65735,110,0,110,0.0,1.0
22774,65737,8413,4,8409,0.0,1.0
22775,65738,17550,14639,2911,0.834,0.166
22776,65739,1326,0,1326,0.0,1.0
22777,65740,3405,3286,119,0.965,0.035
22778,65742,11367,2943,8424,0.259,0.741
22779,65744,142,0,142,0.0,1.0
22780,65745,2693,0,2693,0.0,1.0
22781,65746,7895,0,7895,0.0,1.0
22782,65747,3746,0,3746,0.0,1.0
22783,65752,432,0,432,0.0,1.0
22784,65753,5027,0,5027,0.0,1.0
22785,65754,950,0,950,0.0,1.0
22786,65755,519,0,519,0.0,1.0
22787,65756,748,0,748,0.0,1.0
22788,65757,6975,2254,4721,0.323,0.677
22789,65759,1423,0,1423,0.0,1.0
22790,65760,739,0,739,0.0,1.0
22791,65761,1273,0,1273,0.0,1.0
22792,65762,441,0,441,0.0,1.0
22793,65764,1287,0,1287,0.0,1.0
22794,65766,105,0,105,0.0,1.0
22795,65767,2106,0,2106,0.0,1.0
22796,65768,488,0,488,0.0,1.0
22797,65769,3091,788,2303,0.255,0.745
22798,65770,3002,0,3002,0.0,1.0
22799,65771,1398,0,1398,0.0,1.0
22800,65772,2158,0,2158,0.0,1.0
22801,65773,711,0,711,0.0,1.0
22802,65774,953,0,953,0.0,1.0
22803,65775,24908,11242,13666,0.451,0.549
22804,65777,328,0,328,0.0,1.0
22805,65778,524,0,524,0.0,1.0
22806,65779,2207,0,2207,0.0,1.0
22807,65781,8543,4761,3782,0.557,0.443
22808,65783,225,0,225,0.0,1.0
22809,65784,34,0,34,0.0,1.0
22810,65785,5259,0,5259,0.0,1.0
22811,65786,2250,0,2250,0.0,1.0
22812,65787,1864,0,1864,0.0,1.0
22813,65788,422,0,422,0.0,1.0
22814,65789,2014,0,2014,0.0,1.0
22815,65790,739,0,739,0.0,1.0
22816,65791,4585,2118,2467,0.462,0.538
22817,65793,6337,0,6337,0.0,1.0
22818,65802,44270,40397,3873,0.913,0.087
22819,65803,40902,34376,6526,0.84,0.16
22820,65804,36801,36801,0,1.0,0.0
22821,65806,10586,10586,0,1.0,0.0
22822,65807,54952,54941,11,1.0,0.0
22823,65809,11257,9497,1760,0.844,0.156
22824,65810,20984,20984,0,1.0,0.0
22825,66002,13755,11144,2611,0.81,0.19
22826,66006,7459,4428,3031,0.594,0.406
22827,66007,5614,3287,2327,0.586,0.414
22828,66008,286,0,286,0.0,1.0
22829,66010,606,0,606,0.0,1.0
22830,66012,11210,6693,4517,0.597,0.403
22831,66013,1839,0,1839,0.0,1.0
22832,66014,349,0,349,0.0,1.0
22833,66015,782,0,782,0.0,1.0
22834,66016,519,0,519,0.0,1.0
22835,66017,304,0,304,0.0,1.0
22836,66018,5760,4455,1305,0.773,0.227
22837,66019,246,246,0,1.0,0.0
22838,66020,1442,0,1442,0.0,1.0
22839,66021,2612,0,2612,0.0,1.0
22840,66023,1124,0,1124,0.0,1.0
22841,66024,927,811,116,0.875,0.125
22842,66025,7704,6140,1564,0.797,0.203
22843,66026,698,0,698,0.0,1.0
22844,66027,5742,5294,448,0.922,0.078
22845,66030,20961,19408,1553,0.926,0.074
22846,66031,1072,1072,0,1.0,0.0
22847,66032,5115,3336,1779,0.652,0.348
22848,66033,767,0,767,0.0,1.0
22849,66035,1311,0,1311,0.0,1.0
22850,66039,628,0,628,0.0,1.0
22851,66040,3404,0,3404,0.0,1.0
22852,66041,725,0,725,0.0,1.0
22853,66042,657,0,657,0.0,1.0
22854,66043,10787,10640,147,0.986,0.014
22855,66044,28417,26826,1591,0.944,0.056
22856,66045,2023,2023,0,1.0,0.0
22857,66046,19452,18206,1246,0.936,0.064
22858,66047,18268,16493,1775,0.903,0.097
22859,66048,35475,29349,6126,0.827,0.173
22860,66049,25957,24505,1452,0.944,0.056
22861,66050,1822,0,1822,0.0,1.0
22862,66052,2031,0,2031,0.0,1.0
22863,66053,7524,3930,3594,0.522,0.478
22864,66054,2860,0,2860,0.0,1.0
22865,66056,1694,0,1694,0.0,1.0
22866,66058,393,0,393,0.0,1.0
22867,66060,1122,0,1122,0.0,1.0
22868,66061,55805,52596,3209,0.942,0.058
22869,66062,74411,72264,2147,0.971,0.029
22870,66064,6098,4365,1733,0.716,0.284
22871,66066,2636,0,2636,0.0,1.0
22872,66067,16170,12450,3720,0.77,0.23
22873,66070,2661,0,2661,0.0,1.0
22874,66071,12360,5399,6961,0.437,0.563
22875,66072,1054,0,1054,0.0,1.0
22876,66073,2537,0,2537,0.0,1.0
22877,66075,2103,0,2103,0.0,1.0
22878,66076,2200,0,2200,0.0,1.0
22879,66078,961,0,961,0.0,1.0
22880,66079,781,0,781,0.0,1.0
22881,66080,1065,0,1065,0.0,1.0
22882,66083,8910,5452,3458,0.612,0.388
22883,66085,7779,3714,4065,0.477,0.523
22884,66086,9759,4941,4818,0.506,0.494
22885,66087,2042,0,2042,0.0,1.0
22886,66088,2457,0,2457,0.0,1.0
22887,66090,2520,1557,963,0.618,0.382
22888,66091,352,0,352,0.0,1.0
22889,66092,4084,0,4084,0.0,1.0
22890,66093,609,0,609,0.0,1.0
22891,66094,416,0,416,0.0,1.0
22892,66095,896,0,896,0.0,1.0
22893,66097,1071,0,1071,0.0,1.0
22894,66101,13220,13220,0,1.0,0.0
22895,66102,29282,29282,0,1.0,0.0
22896,66103,13934,13934,0,1.0,0.0
22897,66104,25401,24308,1093,0.957,0.043
22898,66105,2924,2924,0,1.0,0.0
22899,66106,23367,22222,1145,0.951,0.049
22900,66109,20480,16237,4243,0.793,0.207
22901,66111,10155,8299,1856,0.817,0.183
22902,66112,11458,11388,70,0.994,0.006
22903,66115,0,0,0,,
22904,66118,3,3,0,1.0,0.0
22905,66202,16173,16173,0,1.0,0.0
22906,66203,19156,19156,0,1.0,0.0
22907,66204,18832,18832,0,1.0,0.0
22908,66205,13216,13216,0,1.0,0.0
22909,66206,9693,9693,0,1.0,0.0
22910,66207,13004,13004,0,1.0,0.0
22911,66208,20945,20945,0,1.0,0.0
22912,66209,19561,19561,0,1.0,0.0
22913,66210,18102,18102,0,1.0,0.0
22914,66211,4276,4276,0,1.0,0.0
22915,66212,32096,32096,0,1.0,0.0
22916,66213,27322,27322,0,1.0,0.0
22917,66214,11691,11691,0,1.0,0.0
22918,66215,24770,24770,0,1.0,0.0
22919,66216,24368,24368,0,1.0,0.0
22920,66217,5319,4959,360,0.932,0.068
22921,66218,7754,7008,746,0.904,0.096
22922,66219,10486,10482,4,1.0,0.0
22923,66220,7133,6424,709,0.901,0.099
22924,66221,15219,15111,108,0.993,0.007
22925,66223,21759,21759,0,1.0,0.0
22926,66224,11917,11894,23,0.998,0.002
22927,66226,12877,12464,413,0.968,0.032
22928,66227,4543,3200,1343,0.704,0.296
22929,66401,1721,0,1721,0.0,1.0
22930,66402,2955,0,2955,0.0,1.0
22931,66403,757,0,757,0.0,1.0
22932,66404,530,0,530,0.0,1.0
22933,66406,421,0,421,0.0,1.0
22934,66407,479,0,479,0.0,1.0
22935,66408,434,0,434,0.0,1.0
22936,66409,2997,0,2997,0.0,1.0
22937,66411,1292,0,1292,0.0,1.0
22938,66412,287,0,287,0.0,1.0
22939,66413,1802,0,1802,0.0,1.0
22940,66414,2914,0,2914,0.0,1.0
22941,66415,885,0,885,0.0,1.0
22942,66416,489,0,489,0.0,1.0
22943,66417,310,0,310,0.0,1.0
22944,66418,707,0,707,0.0,1.0
22945,66419,442,0,442,0.0,1.0
22946,66422,487,0,487,0.0,1.0
22947,66423,985,0,985,0.0,1.0
22948,66424,610,0,610,0.0,1.0
22949,66425,465,0,465,0.0,1.0
22950,66427,1281,0,1281,0.0,1.0
22951,66428,415,0,415,0.0,1.0
22952,66429,579,149,430,0.257,0.743
22953,66431,671,0,671,0.0,1.0
22954,66432,396,0,396,0.0,1.0
22955,66434,4828,3145,1683,0.651,0.349
22956,66436,5879,3245,2634,0.552,0.448
22957,66438,149,0,149,0.0,1.0
22958,66439,2747,0,2747,0.0,1.0
22959,66440,2063,0,2063,0.0,1.0
22960,66441,26746,24703,2043,0.924,0.076
22961,66442,14283,14084,199,0.986,0.014
22962,66449,846,0,846,0.0,1.0
22963,66451,1793,0,1793,0.0,1.0
22964,66501,260,0,260,0.0,1.0
22965,66502,43850,40727,3123,0.929,0.071
22966,66503,13428,10281,3147,0.766,0.234
22967,66506,3614,3614,0,1.0,0.0
22968,66507,1247,0,1247,0.0,1.0
22969,66508,4375,2937,1438,0.671,0.329
22970,66509,2596,0,2596,0.0,1.0
22971,66510,779,0,779,0.0,1.0
22972,66512,3361,0,3361,0.0,1.0
22973,66514,1657,0,1657,0.0,1.0
22974,66515,425,0,425,0.0,1.0
22975,66516,378,0,378,0.0,1.0
22976,66517,2087,0,2087,0.0,1.0
22977,66518,189,0,189,0.0,1.0
22978,66520,577,0,577,0.0,1.0
22979,66521,1532,0,1532,0.0,1.0
22980,66522,49,0,49,0.0,1.0
22981,66523,3833,2683,1150,0.7,0.3
22982,66524,2499,0,2499,0.0,1.0
22983,66526,801,0,801,0.0,1.0
22984,66527,267,0,267,0.0,1.0
22985,66528,945,0,945,0.0,1.0
22986,66531,1380,0,1380,0.0,1.0
22987,66532,668,0,668,0.0,1.0
22988,66533,1832,0,1832,0.0,1.0
22989,66534,3725,2526,1199,0.678,0.322
22990,66535,2616,0,2616,0.0,1.0
22991,66536,3922,2669,1253,0.681,0.319
22992,66537,1448,0,1448,0.0,1.0
22993,66538,3264,0,3264,0.0,1.0
22994,66539,2806,0,2806,0.0,1.0
22995,66540,540,0,540,0.0,1.0
22996,66541,264,0,264,0.0,1.0
22997,66542,3335,878,2457,0.263,0.737
22998,66543,725,0,725,0.0,1.0
22999,66544,337,0,337,0.0,1.0
23000,66546,1012,0,1012,0.0,1.0
23001,66547,7617,4418,3199,0.58,0.42
23002,66548,961,0,961,0.0,1.0
23003,66549,1646,0,1646,0.0,1.0
23004,66550,607,0,607,0.0,1.0
23005,66552,396,0,396,0.0,1.0
23006,66554,567,0,567,0.0,1.0
23007,66603,2001,2001,0,1.0,0.0
23008,66604,23344,23344,0,1.0,0.0
23009,66605,19919,19830,89,0.996,0.004
23010,66606,11284,11279,5,1.0,0.0
23011,66607,10498,10288,210,0.98,0.02
23012,66608,5991,5977,14,0.998,0.002
23013,66609,7068,6507,561,0.921,0.079
23014,66610,9080,6774,2306,0.746,0.254
23015,66611,9832,9832,0,1.0,0.0
23016,66612,2477,2477,0,1.0,0.0
23017,66614,31354,30252,1102,0.965,0.035
23018,66615,2814,913,1901,0.324,0.676
23019,66616,5874,5716,158,0.973,0.027
23020,66617,8688,4375,4313,0.504,0.496
23021,66618,9402,5738,3664,0.61,0.39
23022,66619,3070,2954,116,0.962,0.038
23023,66621,643,643,0,1.0,0.0
23024,66622,76,76,0,1.0,0.0
23025,66701,12325,7895,4430,0.641,0.359
23026,66710,746,0,746,0.0,1.0
23027,66711,610,0,610,0.0,1.0
23028,66712,1939,0,1939,0.0,1.0
23029,66713,5836,4196,1640,0.719,0.281
23030,66714,177,0,177,0.0,1.0
23031,66716,567,0,567,0.0,1.0
23032,66717,497,0,497,0.0,1.0
23033,66720,11299,9059,2240,0.802,0.198
23034,66724,1065,0,1065,0.0,1.0
23035,66725,5739,3272,2467,0.57,0.43
23036,66728,91,0,91,0.0,1.0
23037,66732,291,0,291,0.0,1.0
23038,66733,2215,0,2215,0.0,1.0
23039,66734,332,0,332,0.0,1.0
23040,66735,421,0,421,0.0,1.0
23041,66736,3954,0,3954,0.0,1.0
23042,66738,376,0,376,0.0,1.0
23043,66739,5453,2643,2810,0.485,0.515
23044,66740,477,0,477,0.0,1.0
23045,66741,237,0,237,0.0,1.0
23046,66743,4373,2547,1826,0.582,0.418
23047,66746,261,0,261,0.0,1.0
23048,66748,2750,0,2750,0.0,1.0
23049,66749,7974,5729,2245,0.718,0.282
23050,66751,849,0,849,0.0,1.0
23051,66753,1077,0,1077,0.0,1.0
23052,66754,451,0,451,0.0,1.0
23053,66755,1178,0,1178,0.0,1.0
23054,66756,1007,0,1007,0.0,1.0
23055,66757,3560,2570,990,0.722,0.278
23056,66758,216,0,216,0.0,1.0
23057,66760,98,0,98,0.0,1.0
23058,66761,238,0,238,0.0,1.0
23059,66762,24786,20146,4640,0.813,0.187
23060,66763,3369,2772,597,0.823,0.177
23061,66767,511,0,511,0.0,1.0
23062,66769,557,0,557,0.0,1.0
23063,66770,1158,893,265,0.771,0.229
23064,66771,1028,0,1028,0.0,1.0
23065,66772,253,0,253,0.0,1.0
23066,66773,866,0,866,0.0,1.0
23067,66775,191,0,191,0.0,1.0
23068,66776,1288,0,1288,0.0,1.0
23069,66777,639,0,639,0.0,1.0
23070,66778,139,0,139,0.0,1.0
23071,66779,650,0,650,0.0,1.0
23072,66780,589,0,589,0.0,1.0
23073,66781,1347,0,1347,0.0,1.0
23074,66782,178,0,178,0.0,1.0
23075,66783,2230,0,2230,0.0,1.0
23076,66801,28492,24830,3662,0.871,0.129
23077,66830,262,0,262,0.0,1.0
23078,66833,536,0,536,0.0,1.0
23079,66834,848,0,848,0.0,1.0
23080,66835,1360,0,1360,0.0,1.0
23081,66838,182,0,182,0.0,1.0
23082,66839,4007,2503,1504,0.625,0.375
23083,66840,777,0,777,0.0,1.0
23084,66842,324,0,324,0.0,1.0
23085,66843,205,0,205,0.0,1.0
23086,66845,1232,0,1232,0.0,1.0
23087,66846,3504,0,3504,0.0,1.0
23088,66849,485,0,485,0.0,1.0
23089,66850,228,0,228,0.0,1.0
23090,66851,583,0,583,0.0,1.0
23091,66852,631,0,631,0.0,1.0
23092,66853,429,0,429,0.0,1.0
23093,66854,816,0,816,0.0,1.0
23094,66856,1613,0,1613,0.0,1.0
23095,66857,943,0,943,0.0,1.0
23096,66858,456,0,456,0.0,1.0
23097,66859,178,0,178,0.0,1.0
23098,66860,1258,0,1258,0.0,1.0
23099,66861,3204,0,3204,0.0,1.0
23100,66862,116,0,116,0.0,1.0
23101,66863,63,0,63,0.0,1.0
23102,66864,456,0,456,0.0,1.0
23103,66865,1124,0,1124,0.0,1.0
23104,66866,1789,0,1789,0.0,1.0
23105,66868,764,0,764,0.0,1.0
23106,66869,748,0,748,0.0,1.0
23107,66870,166,0,166,0.0,1.0
23108,66871,1346,0,1346,0.0,1.0
23109,66872,1134,0,1134,0.0,1.0
23110,66873,319,0,319,0.0,1.0
23111,66901,6605,5340,1265,0.808,0.192
23112,66930,186,0,186,0.0,1.0
23113,66932,157,0,157,0.0,1.0
23114,66933,298,0,298,0.0,1.0
23115,66935,2563,0,2563,0.0,1.0
23116,66936,344,0,344,0.0,1.0
23117,66937,893,0,893,0.0,1.0
23118,66938,1005,0,1005,0.0,1.0
23119,66939,537,0,537,0.0,1.0
23120,66940,339,0,339,0.0,1.0
23121,66941,242,0,242,0.0,1.0
23122,66942,247,0,247,0.0,1.0
23123,66943,505,0,505,0.0,1.0
23124,66944,195,0,195,0.0,1.0
23125,66945,1096,0,1096,0.0,1.0
23126,66946,126,0,126,0.0,1.0
23127,66948,494,0,494,0.0,1.0
23128,66949,668,0,668,0.0,1.0
23129,66951,764,0,764,0.0,1.0
23130,66952,499,0,499,0.0,1.0
23131,66953,703,0,703,0.0,1.0
23132,66955,114,0,114,0.0,1.0
23133,66956,1157,0,1157,0.0,1.0
23134,66958,314,0,314,0.0,1.0
23135,66959,203,0,203,0.0,1.0
23136,66960,167,0,167,0.0,1.0
23137,66962,264,0,264,0.0,1.0
23138,66963,135,0,135,0.0,1.0
23139,66964,204,0,204,0.0,1.0
23140,66966,624,0,624,0.0,1.0
23141,66967,2096,0,2096,0.0,1.0
23142,66968,1626,0,1626,0.0,1.0
23143,66970,97,0,97,0.0,1.0
23144,67001,1676,0,1676,0.0,1.0
23145,67002,13764,11492,2272,0.835,0.165
23146,67003,2626,0,2626,0.0,1.0
23147,67004,827,0,827,0.0,1.0
23148,67005,16535,13026,3509,0.788,0.212
23149,67008,556,0,556,0.0,1.0
23150,67009,856,0,856,0.0,1.0
23151,67010,13890,9350,4540,0.673,0.327
23152,67012,61,0,61,0.0,1.0
23153,67013,3145,0,3145,0.0,1.0
23154,67016,530,0,530,0.0,1.0
23155,67017,2294,0,2294,0.0,1.0
23156,67018,149,0,149,0.0,1.0
23157,67019,945,0,945,0.0,1.0
23158,67020,1689,0,1689,0.0,1.0
23159,67021,65,0,65,0.0,1.0
23160,67022,1461,0,1461,0.0,1.0
23161,67023,230,0,230,0.0,1.0
23162,67024,849,0,849,0.0,1.0
23163,67025,3884,0,3884,0.0,1.0
23164,67026,4845,0,4845,0.0,1.0
23165,67028,225,0,225,0.0,1.0
23166,67029,1063,0,1063,0.0,1.0
23167,67030,2659,0,2659,0.0,1.0
23168,67031,2308,0,2308,0.0,1.0
23169,67035,970,0,970,0.0,1.0
23170,67036,151,0,151,0.0,1.0
23171,67037,26577,22549,4028,0.848,0.152
23172,67038,602,0,602,0.0,1.0
23173,67039,3395,0,3395,0.0,1.0
23174,67041,229,0,229,0.0,1.0
23175,67042,17969,14724,3245,0.819,0.181
23176,67045,3644,2591,1053,0.711,0.289
23177,67047,731,0,731,0.0,1.0
23178,67049,79,0,79,0.0,1.0
23179,67050,1844,0,1844,0.0,1.0
23180,67051,456,0,456,0.0,1.0
23181,67052,8325,5428,2897,0.652,0.348
23182,67053,539,0,539,0.0,1.0
23183,67054,1167,0,1167,0.0,1.0
23184,67055,71,0,71,0.0,1.0
23185,67056,2935,0,2935,0.0,1.0
23186,67057,241,0,241,0.0,1.0
23187,67058,2093,0,2093,0.0,1.0
23188,67059,1042,0,1042,0.0,1.0
23189,67060,13733,12287,1446,0.895,0.105
23190,67061,171,0,171,0.0,1.0
23191,67062,4156,3306,850,0.795,0.205
23192,67063,3942,2815,1127,0.714,0.286
23193,67065,228,0,228,0.0,1.0
23194,67066,302,0,302,0.0,1.0
23195,67067,1541,1284,257,0.833,0.167
23196,67068,4354,2978,1376,0.684,0.316
23197,67070,1169,0,1169,0.0,1.0
23198,67071,94,0,94,0.0,1.0
23199,67072,244,0,244,0.0,1.0
23200,67073,309,0,309,0.0,1.0
23201,67074,1741,0,1741,0.0,1.0
23202,67101,3604,2834,770,0.786,0.214
23203,67103,326,0,326,0.0,1.0
23204,67104,2506,0,2506,0.0,1.0
23205,67105,190,0,190,0.0,1.0
23206,67106,388,0,388,0.0,1.0
23207,67107,2979,0,2979,0.0,1.0
23208,67108,1696,0,1696,0.0,1.0
23209,67109,418,0,418,0.0,1.0
23210,67110,8415,6196,2219,0.736,0.264
23211,67111,352,0,352,0.0,1.0
23212,67112,227,0,227,0.0,1.0
23213,67114,21852,18895,2957,0.865,0.135
23214,67117,1769,1759,10,0.994,0.006
23215,67118,810,0,810,0.0,1.0
23216,67119,1457,0,1457,0.0,1.0
23217,67120,1358,0,1358,0.0,1.0
23218,67122,221,0,221,0.0,1.0
23219,67123,741,0,741,0.0,1.0
23220,67124,8203,6546,1657,0.798,0.202
23221,67127,701,0,701,0.0,1.0
23222,67131,258,0,258,0.0,1.0
23223,67132,410,0,410,0.0,1.0
23224,67133,6379,3650,2729,0.572,0.428
23225,67134,420,0,420,0.0,1.0
23226,67135,3493,0,3493,0.0,1.0
23227,67137,634,0,634,0.0,1.0
23228,67138,397,0,397,0.0,1.0
23229,67140,802,0,802,0.0,1.0
23230,67142,445,0,445,0.0,1.0
23231,67143,58,0,58,0.0,1.0
23232,67144,2716,0,2716,0.0,1.0
23233,67146,1830,0,1830,0.0,1.0
23234,67147,9908,5818,4090,0.587,0.413
23235,67149,988,0,988,0.0,1.0
23236,67150,12,0,12,0.0,1.0
23237,67151,479,0,479,0.0,1.0
23238,67152,9541,7783,1758,0.816,0.184
23239,67154,1510,0,1510,0.0,1.0
23240,67155,166,0,166,0.0,1.0
23241,67156,15269,12029,3240,0.788,0.212
23242,67159,169,0,169,0.0,1.0
23243,67202,1393,1393,0,1.0,0.0
23244,67203,31287,31287,0,1.0,0.0
23245,67204,21194,20871,323,0.985,0.015
23246,67205,16811,16368,443,0.974,0.026
23247,67206,15186,15186,0,1.0,0.0
23248,67207,26978,26911,67,0.998,0.002
23249,67208,18161,18161,0,1.0,0.0
23250,67209,13654,13654,0,1.0,0.0
23251,67210,10339,9949,390,0.962,0.038
23252,67211,20644,20644,0,1.0,0.0
23253,67212,44707,44707,0,1.0,0.0
23254,67213,21368,21368,0,1.0,0.0
23255,67214,16542,16542,0,1.0,0.0
23256,67215,5708,5017,691,0.879,0.121
23257,67216,24041,23994,47,0.998,0.002
23258,67217,30186,29926,260,0.991,0.009
23259,67218,22772,22772,0,1.0,0.0
23260,67219,12121,11994,127,0.99,0.01
23261,67220,14214,13741,473,0.967,0.033
23262,67223,513,238,275,0.464,0.536
23263,67226,17757,17307,450,0.975,0.025
23264,67227,344,0,344,0.0,1.0
23265,67228,2033,1718,315,0.845,0.155
23266,67230,9959,9916,43,0.996,0.004
23267,67232,298,0,298,0.0,1.0
23268,67235,11446,11318,128,0.989,0.011
23269,67260,0,0,0,,
23270,67301,13556,9959,3597,0.735,0.265
23271,67330,1535,0,1535,0.0,1.0
23272,67332,207,0,207,0.0,1.0
23273,67333,3089,0,3089,0.0,1.0
23274,67334,104,0,104,0.0,1.0
23275,67335,3671,0,3671,0.0,1.0
23276,67336,1683,0,1683,0.0,1.0
23277,67337,13493,10109,3384,0.749,0.251
23278,67340,355,0,355,0.0,1.0
23279,67341,373,0,373,0.0,1.0
23280,67342,969,0,969,0.0,1.0
23281,67344,877,0,877,0.0,1.0
23282,67345,161,0,161,0.0,1.0
23283,67346,372,0,372,0.0,1.0
23284,67347,431,0,431,0.0,1.0
23285,67349,1034,0,1034,0.0,1.0
23286,67351,391,0,391,0.0,1.0
23287,67352,593,0,593,0.0,1.0
23288,67353,582,0,582,0.0,1.0
23289,67354,825,0,825,0.0,1.0
23290,67355,213,0,213,0.0,1.0
23291,67356,2834,0,2834,0.0,1.0
23292,67357,13006,10298,2708,0.792,0.208
23293,67360,409,0,409,0.0,1.0
23294,67361,1841,0,1841,0.0,1.0
23295,67363,78,0,78,0.0,1.0
23296,67364,311,0,311,0.0,1.0
23297,67401,51499,47493,4006,0.922,0.078
23298,67410,10141,7054,3087,0.696,0.304
23299,67416,1146,0,1146,0.0,1.0
23300,67417,179,0,179,0.0,1.0
23301,67418,246,0,246,0.0,1.0
23302,67420,4721,3295,1426,0.698,0.302
23303,67422,1366,0,1366,0.0,1.0
23304,67423,316,0,316,0.0,1.0
23305,67425,689,0,689,0.0,1.0
23306,67427,408,0,408,0.0,1.0
23307,67428,1465,0,1465,0.0,1.0
23308,67430,611,0,611,0.0,1.0
23309,67431,2471,0,2471,0.0,1.0
23310,67432,6019,4307,1712,0.716,0.284
23311,67436,636,0,636,0.0,1.0
23312,67437,1161,0,1161,0.0,1.0
23313,67438,300,0,300,0.0,1.0
23314,67439,3674,2982,692,0.812,0.188
23315,67441,1115,0,1115,0.0,1.0
23316,67442,266,0,266,0.0,1.0
23317,67443,1794,0,1794,0.0,1.0
23318,67444,527,0,527,0.0,1.0
23319,67445,680,0,680,0.0,1.0
23320,67446,617,0,617,0.0,1.0
23321,67447,320,0,320,0.0,1.0
23322,67448,1374,0,1374,0.0,1.0
23323,67449,3351,0,3351,0.0,1.0
23324,67450,555,0,555,0.0,1.0
23325,67451,948,0,948,0.0,1.0
23326,67452,201,0,201,0.0,1.0
23327,67454,563,0,563,0.0,1.0
23328,67455,1980,0,1980,0.0,1.0
23329,67456,4736,3405,1331,0.719,0.281
23330,67457,878,0,878,0.0,1.0
23331,67458,261,0,261,0.0,1.0
23332,67459,251,0,251,0.0,1.0
23333,67460,15168,13083,2085,0.863,0.137
23334,67464,1090,0,1090,0.0,1.0
23335,67466,774,0,774,0.0,1.0
23336,67467,2904,0,2904,0.0,1.0
23337,67468,307,0,307,0.0,1.0
23338,67470,456,0,456,0.0,1.0
23339,67473,1728,0,1728,0.0,1.0
23340,67474,224,0,224,0.0,1.0
23341,67475,283,0,283,0.0,1.0
23342,67478,89,0,89,0.0,1.0
23343,67480,1805,0,1805,0.0,1.0
23344,67481,590,0,590,0.0,1.0
23345,67482,99,0,99,0.0,1.0
23346,67483,338,0,338,0.0,1.0
23347,67484,891,0,891,0.0,1.0
23348,67485,339,0,339,0.0,1.0
23349,67487,1422,0,1422,0.0,1.0
23350,67490,1055,0,1055,0.0,1.0
23351,67491,399,0,399,0.0,1.0
23352,67492,166,0,166,0.0,1.0
23353,67501,27212,22980,4232,0.844,0.156
23354,67502,23739,18988,4751,0.8,0.2
23355,67505,2457,2352,105,0.957,0.043
23356,67510,281,0,281,0.0,1.0
23357,67511,318,0,318,0.0,1.0
23358,67512,234,0,234,0.0,1.0
23359,67513,93,0,93,0.0,1.0
23360,67514,765,0,765,0.0,1.0
23361,67515,63,0,63,0.0,1.0
23362,67516,447,0,447,0.0,1.0
23363,67518,69,0,69,0.0,1.0
23364,67519,193,0,193,0.0,1.0
23365,67520,415,0,415,0.0,1.0
23366,67521,155,0,155,0.0,1.0
23367,67522,2049,0,2049,0.0,1.0
23368,67523,373,0,373,0.0,1.0
23369,67524,630,0,630,0.0,1.0
23370,67525,1119,0,1119,0.0,1.0
23371,67526,2759,0,2759,0.0,1.0
23372,67529,365,0,365,0.0,1.0
23373,67530,19699,16177,3522,0.821,0.179
23374,67543,2125,0,2125,0.0,1.0
23375,67544,3216,2709,507,0.842,0.158
23376,67545,215,0,215,0.0,1.0
23377,67546,2597,0,2597,0.0,1.0
23378,67547,1769,0,1769,0.0,1.0
23379,67548,1467,0,1467,0.0,1.0
23380,67550,5905,4764,1141,0.807,0.193
23381,67552,720,0,720,0.0,1.0
23382,67553,114,0,114,0.0,1.0
23383,67554,4334,3652,682,0.843,0.157
23384,67556,320,0,320,0.0,1.0
23385,67557,723,0,723,0.0,1.0
23386,67559,52,0,52,0.0,1.0
23387,67560,1740,0,1740,0.0,1.0
23388,67561,1538,0,1538,0.0,1.0
23389,67563,371,0,371,0.0,1.0
23390,67564,308,0,308,0.0,1.0
23391,67565,429,0,429,0.0,1.0
23392,67566,650,0,650,0.0,1.0
23393,67567,526,0,526,0.0,1.0
23394,67568,309,0,309,0.0,1.0
23395,67570,1338,0,1338,0.0,1.0
23396,67572,456,0,456,0.0,1.0
23397,67573,170,0,170,0.0,1.0
23398,67574,252,0,252,0.0,1.0
23399,67575,465,0,465,0.0,1.0
23400,67576,1915,0,1915,0.0,1.0
23401,67578,1405,0,1405,0.0,1.0
23402,67579,3095,0,3095,0.0,1.0
23403,67581,416,0,416,0.0,1.0
23404,67583,1022,0,1022,0.0,1.0
23405,67584,269,0,269,0.0,1.0
23406,67601,23797,21180,2617,0.89,0.11
23407,67621,393,0,393,0.0,1.0
23408,67622,599,0,599,0.0,1.0
23409,67623,270,0,270,0.0,1.0
23410,67625,257,0,257,0.0,1.0
23411,67626,145,0,145,0.0,1.0
23412,67628,78,0,78,0.0,1.0
23413,67629,143,0,143,0.0,1.0
23414,67631,249,0,249,0.0,1.0
23415,67632,227,0,227,0.0,1.0
23416,67634,301,0,301,0.0,1.0
23417,67635,169,0,169,0.0,1.0
23418,67637,2651,0,2651,0.0,1.0
23419,67638,230,0,230,0.0,1.0
23420,67639,193,0,193,0.0,1.0
23421,67640,505,0,505,0.0,1.0
23422,67642,1729,0,1729,0.0,1.0
23423,67643,195,0,195,0.0,1.0
23424,67644,264,0,264,0.0,1.0
23425,67645,546,0,546,0.0,1.0
23426,67646,718,0,718,0.0,1.0
23427,67647,256,0,256,0.0,1.0
23428,67648,549,0,549,0.0,1.0
23429,67649,297,0,297,0.0,1.0
23430,67650,258,0,258,0.0,1.0
23431,67651,507,0,507,0.0,1.0
23432,67653,298,0,298,0.0,1.0
23433,67654,4362,2893,1469,0.663,0.337
23434,67656,156,0,156,0.0,1.0
23435,67657,429,0,429,0.0,1.0
23436,67658,120,0,120,0.0,1.0
23437,67659,154,0,154,0.0,1.0
23438,67660,81,0,81,0.0,1.0
23439,67661,3483,2609,874,0.749,0.251
23440,67663,2615,0,2615,0.0,1.0
23441,67664,305,0,305,0.0,1.0
23442,67665,5162,4108,1054,0.796,0.204
23443,67667,204,0,204,0.0,1.0
23444,67669,1725,0,1725,0.0,1.0
23445,67671,1714,0,1714,0.0,1.0
23446,67672,2359,0,2359,0.0,1.0
23447,67673,108,0,108,0.0,1.0
23448,67674,55,0,55,0.0,1.0
23449,67675,217,0,217,0.0,1.0
23450,67701,6502,5463,1039,0.84,0.16
23451,67730,1612,0,1612,0.0,1.0
23452,67731,675,0,675,0.0,1.0
23453,67732,543,0,543,0.0,1.0
23454,67733,149,0,149,0.0,1.0
23455,67734,182,0,182,0.0,1.0
23456,67735,5476,4553,923,0.831,0.169
23457,67736,228,0,228,0.0,1.0
23458,67737,444,0,444,0.0,1.0
23459,67738,520,0,520,0.0,1.0
23460,67739,258,0,258,0.0,1.0
23461,67740,1724,0,1724,0.0,1.0
23462,67741,326,0,326,0.0,1.0
23463,67743,158,0,158,0.0,1.0
23464,67744,185,0,185,0.0,1.0
23465,67745,322,0,322,0.0,1.0
23466,67747,158,0,158,0.0,1.0
23467,67748,2544,0,2544,0.0,1.0
23468,67749,2317,0,2317,0.0,1.0
23469,67751,259,0,259,0.0,1.0
23470,67752,1399,0,1399,0.0,1.0
23471,67753,530,0,530,0.0,1.0
23472,67756,2016,0,2016,0.0,1.0
23473,67757,482,0,482,0.0,1.0
23474,67758,1016,0,1016,0.0,1.0
23475,67761,249,0,249,0.0,1.0
23476,67762,288,0,288,0.0,1.0
23477,67764,345,0,345,0.0,1.0
23478,67801,30559,27316,3243,0.894,0.106
23479,67831,1117,0,1117,0.0,1.0
23480,67834,964,0,964,0.0,1.0
23481,67835,2954,0,2954,0.0,1.0
23482,67836,147,0,147,0.0,1.0
23483,67837,903,0,903,0.0,1.0
23484,67838,982,0,982,0.0,1.0
23485,67839,1416,0,1416,0.0,1.0
23486,67840,103,0,103,0.0,1.0
23487,67841,339,0,339,0.0,1.0
23488,67842,427,0,427,0.0,1.0
23489,67843,165,0,165,0.0,1.0
23490,67844,894,0,894,0.0,1.0
23491,67846,33696,29942,3754,0.889,0.111
23492,67849,380,0,380,0.0,1.0
23493,67850,335,0,335,0.0,1.0
23494,67851,2691,0,2691,0.0,1.0
23495,67853,860,0,860,0.0,1.0
23496,67854,1407,0,1407,0.0,1.0
23497,67855,1976,0,1976,0.0,1.0
23498,67857,174,0,174,0.0,1.0
23499,67859,735,0,735,0.0,1.0
23500,67860,2878,0,2878,0.0,1.0
23501,67861,1962,0,1962,0.0,1.0
23502,67862,302,0,302,0.0,1.0
23503,67863,305,0,305,0.0,1.0
23504,67864,2227,0,2227,0.0,1.0
23505,67865,1081,0,1081,0.0,1.0
23506,67867,1578,0,1578,0.0,1.0
23507,67868,198,0,198,0.0,1.0
23508,67869,1492,0,1492,0.0,1.0
23509,67870,1765,0,1765,0.0,1.0
23510,67871,4973,3647,1326,0.733,0.267
23511,67876,1156,0,1156,0.0,1.0
23512,67877,2255,0,2255,0.0,1.0
23513,67878,2436,0,2436,0.0,1.0
23514,67879,1247,0,1247,0.0,1.0
23515,67880,7878,6279,1599,0.797,0.203
23516,67882,346,0,346,0.0,1.0
23517,67901,22073,20329,1744,0.921,0.079
23518,67950,2558,0,2558,0.0,1.0
23519,67951,4981,3936,1045,0.79,0.21
23520,67952,710,0,710,0.0,1.0
23521,67953,144,0,144,0.0,1.0
23522,67954,661,0,661,0.0,1.0
23523,68001,77,0,77,0.0,1.0
23524,68002,2150,0,2150,0.0,1.0
23525,68003,4284,2631,1653,0.614,0.386
23526,68004,885,0,885,0.0,1.0
23527,68005,22132,22060,72,0.997,0.003
23528,68007,7612,5939,1673,0.78,0.22
23529,68008,12285,7844,4441,0.639,0.361
23530,68010,745,745,0,1.0,0.0
23531,68014,287,0,287,0.0,1.0
23532,68015,1151,0,1151,0.0,1.0
23533,68016,413,0,413,0.0,1.0
23534,68017,1692,0,1692,0.0,1.0
23535,68018,516,0,516,0.0,1.0
23536,68019,550,0,550,0.0,1.0
23537,68020,749,0,749,0.0,1.0
23538,68022,16422,14337,2085,0.873,0.127
23539,68023,2536,0,2536,0.0,1.0
23540,68025,30376,27471,2905,0.904,0.096
23541,68028,10839,8441,2398,0.779,0.221
23542,68029,899,0,899,0.0,1.0
23543,68030,835,0,835,0.0,1.0
23544,68031,1745,0,1745,0.0,1.0
23545,68033,392,0,392,0.0,1.0
23546,68034,886,0,886,0.0,1.0
23547,68036,402,0,402,0.0,1.0
23548,68037,2286,0,2286,0.0,1.0
23549,68038,1280,0,1280,0.0,1.0
23550,68039,1421,0,1421,0.0,1.0
23551,68040,369,0,369,0.0,1.0
23552,68041,955,0,955,0.0,1.0
23553,68042,122,0,122,0.0,1.0
23554,68044,724,0,724,0.0,1.0
23555,68045,1801,0,1801,0.0,1.0
23556,68046,25191,23682,1509,0.94,0.06
23557,68047,1614,0,1614,0.0,1.0
23558,68048,12422,6709,5713,0.54,0.46
23559,68050,609,0,609,0.0,1.0
23560,68055,341,0,341,0.0,1.0
23561,68057,1544,0,1544,0.0,1.0
23562,68058,252,0,252,0.0,1.0
23563,68059,3158,0,3158,0.0,1.0
23564,68061,2504,0,2504,0.0,1.0
23565,68062,311,0,311,0.0,1.0
23566,68063,234,0,234,0.0,1.0
23567,68064,3376,0,3376,0.0,1.0
23568,68065,1510,0,1510,0.0,1.0
23569,68066,5640,4450,1190,0.789,0.211
23570,68067,1288,0,1288,0.0,1.0
23571,68068,127,0,127,0.0,1.0
23572,68069,2558,1281,1277,0.501,0.499
23573,68070,836,0,836,0.0,1.0
23574,68071,1934,0,1934,0.0,1.0
23575,68072,66,0,66,0.0,1.0
23576,68073,1960,0,1960,0.0,1.0
23577,68102,6102,6102,0,1.0,0.0
23578,68104,34664,34664,0,1.0,0.0
23579,68105,23842,23842,0,1.0,0.0
23580,68106,19936,19936,0,1.0,0.0
23581,68107,29491,29491,0,1.0,0.0
23582,68108,14664,14664,0,1.0,0.0
23583,68110,9173,9173,0,1.0,0.0
23584,68111,23393,23393,0,1.0,0.0
23585,68112,11508,10645,863,0.925,0.075
23586,68113,994,994,0,1.0,0.0
23587,68114,16928,16928,0,1.0,0.0
23588,68116,25429,25321,108,0.996,0.004
23589,68117,8032,8032,0,1.0,0.0
23590,68118,9389,9389,0,1.0,0.0
23591,68122,9794,8830,964,0.902,0.098
23592,68123,27926,27698,228,0.992,0.008
23593,68124,15690,15690,0,1.0,0.0
23594,68127,21117,21117,0,1.0,0.0
23595,68128,17784,17781,3,1.0,0.0
23596,68130,17972,17972,0,1.0,0.0
23597,68131,12302,12302,0,1.0,0.0
23598,68132,14101,14101,0,1.0,0.0
23599,68133,9703,8972,731,0.925,0.075
23600,68134,28257,28257,0,1.0,0.0
23601,68135,25875,25875,0,1.0,0.0
23602,68136,13829,13771,58,0.996,0.004
23603,68137,24921,24921,0,1.0,0.0
23604,68138,12013,11819,194,0.984,0.016
23605,68142,3072,2309,763,0.752,0.248
23606,68144,24233,24233,0,1.0,0.0
23607,68147,10351,10351,0,1.0,0.0
23608,68152,5837,4426,1411,0.758,0.242
23609,68154,22692,22692,0,1.0,0.0
23610,68157,5213,5213,0,1.0,0.0
23611,68164,27387,27387,0,1.0,0.0
23612,68178,1573,1573,0,1.0,0.0
23613,68301,1466,0,1466,0.0,1.0
23614,68303,289,0,289,0.0,1.0
23615,68304,330,0,330,0.0,1.0
23616,68305,4389,3474,915,0.792,0.208
23617,68307,515,0,515,0.0,1.0
23618,68309,121,0,121,0.0,1.0
23619,68310,14546,12405,2141,0.853,0.147
23620,68313,900,0,900,0.0,1.0
23621,68314,351,0,351,0.0,1.0
23622,68315,129,0,129,0.0,1.0
23623,68316,447,0,447,0.0,1.0
23624,68317,1495,0,1495,0.0,1.0
23625,68318,526,0,526,0.0,1.0
23626,68319,552,0,552,0.0,1.0
23627,68320,369,0,369,0.0,1.0
23628,68321,311,0,311,0.0,1.0
23629,68322,440,0,440,0.0,1.0
23630,68323,315,0,315,0.0,1.0
23631,68324,174,0,174,0.0,1.0
23632,68325,232,0,232,0.0,1.0
23633,68326,241,0,241,0.0,1.0
23634,68327,299,0,299,0.0,1.0
23635,68328,429,0,429,0.0,1.0
23636,68329,673,0,673,0.0,1.0
23637,68331,961,0,961,0.0,1.0
23638,68332,146,0,146,0.0,1.0
23639,68333,8327,6948,1379,0.834,0.166
23640,68335,518,0,518,0.0,1.0
23641,68336,557,0,557,0.0,1.0
23642,68337,383,0,383,0.0,1.0
23643,68338,324,0,324,0.0,1.0
23644,68339,1311,0,1311,0.0,1.0
23645,68340,992,0,992,0.0,1.0
23646,68341,1041,0,1041,0.0,1.0
23647,68342,530,0,530,0.0,1.0
23648,68343,1050,0,1050,0.0,1.0
23649,68344,441,0,441,0.0,1.0
23650,68345,269,0,269,0.0,1.0
23651,68346,493,0,493,0.0,1.0
23652,68347,2570,0,2570,0.0,1.0
23653,68348,256,0,256,0.0,1.0
23654,68349,1098,0,1098,0.0,1.0
23655,68350,216,0,216,0.0,1.0
23656,68351,853,0,853,0.0,1.0
23657,68352,5222,3912,1310,0.749,0.251
23658,68354,839,0,839,0.0,1.0
23659,68355,5113,4133,980,0.808,0.192
23660,68357,421,0,421,0.0,1.0
23661,68358,1877,0,1877,0.0,1.0
23662,68359,1585,0,1585,0.0,1.0
23663,68360,501,0,501,0.0,1.0
23664,68361,2573,0,2573,0.0,1.0
23665,68362,46,0,46,0.0,1.0
23666,68364,142,0,142,0.0,1.0
23667,68365,245,0,245,0.0,1.0
23668,68366,1047,0,1047,0.0,1.0
23669,68367,461,0,461,0.0,1.0
23670,68368,485,0,485,0.0,1.0
23671,68370,2075,0,2075,0.0,1.0
23672,68371,1467,0,1467,0.0,1.0
23673,68372,2827,0,2827,0.0,1.0
23674,68375,121,0,121,0.0,1.0
23675,68376,1445,0,1445,0.0,1.0
23676,68377,425,0,425,0.0,1.0
23677,68378,680,0,680,0.0,1.0
23678,68379,59,0,59,0.0,1.0
23679,68380,81,0,81,0.0,1.0
23680,68381,249,0,249,0.0,1.0
23681,68382,41,0,41,0.0,1.0
23682,68401,717,0,717,0.0,1.0
23683,68402,1210,0,1210,0.0,1.0
23684,68403,206,0,206,0.0,1.0
23685,68404,902,0,902,0.0,1.0
23686,68405,3257,0,3257,0.0,1.0
23687,68406,458,0,458,0.0,1.0
23688,68407,747,0,747,0.0,1.0
23689,68409,807,0,807,0.0,1.0
23690,68410,8716,7066,1650,0.811,0.189
23691,68413,533,0,533,0.0,1.0
23692,68414,256,0,256,0.0,1.0
23693,68415,649,0,649,0.0,1.0
23694,68416,226,0,226,0.0,1.0
23695,68417,292,0,292,0.0,1.0
23696,68418,1070,0,1070,0.0,1.0
23697,68419,256,0,256,0.0,1.0
23698,68420,1285,0,1285,0.0,1.0
23699,68421,1107,0,1107,0.0,1.0
23700,68422,513,0,513,0.0,1.0
23701,68423,898,0,898,0.0,1.0
23702,68424,730,0,730,0.0,1.0
23703,68428,1375,0,1375,0.0,1.0
23704,68430,1402,10,1392,0.007,0.993
23705,68431,353,0,353,0.0,1.0
23706,68433,265,0,265,0.0,1.0
23707,68434,8576,6636,1940,0.774,0.226
23708,68436,581,0,581,0.0,1.0
23709,68437,261,0,261,0.0,1.0
23710,68438,142,0,142,0.0,1.0
23711,68439,478,0,478,0.0,1.0
23712,68440,110,0,110,0.0,1.0
23713,68441,302,0,302,0.0,1.0
23714,68442,313,0,313,0.0,1.0
23715,68443,1047,0,1047,0.0,1.0
23716,68444,97,0,97,0.0,1.0
23717,68445,152,0,152,0.0,1.0
23718,68446,2690,0,2690,0.0,1.0
23719,68447,464,0,464,0.0,1.0
23720,68448,399,0,399,0.0,1.0
23721,68450,3182,0,3182,0.0,1.0
23722,68452,86,0,86,0.0,1.0
23723,68453,304,0,304,0.0,1.0
23724,68454,625,0,625,0.0,1.0
23725,68455,681,0,681,0.0,1.0
23726,68456,1127,0,1127,0.0,1.0
23727,68457,343,0,343,0.0,1.0
23728,68458,135,0,135,0.0,1.0
23729,68460,788,0,788,0.0,1.0
23730,68461,734,0,734,0.0,1.0
23731,68462,3827,3133,694,0.819,0.181
23732,68463,1517,0,1517,0.0,1.0
23733,68464,478,0,478,0.0,1.0
23734,68465,2404,0,2404,0.0,1.0
23735,68466,1861,0,1861,0.0,1.0
23736,68467,9338,7633,1705,0.817,0.183
23737,68502,26238,26238,0,1.0,0.0
23738,68503,15264,15264,0,1.0,0.0
23739,68504,16444,16444,0,1.0,0.0
23740,68505,15137,14993,144,0.99,0.01
23741,68506,27952,27952,0,1.0,0.0
23742,68507,13429,13226,203,0.985,0.015
23743,68508,14475,14475,0,1.0,0.0
23744,68510,20514,20395,119,0.994,0.006
23745,68512,11659,11619,40,0.997,0.003
23746,68514,127,0,127,0.0,1.0
23747,68516,38956,38046,910,0.977,0.023
23748,68517,538,0,538,0.0,1.0
23749,68520,1143,766,377,0.67,0.33
23750,68521,31733,31390,343,0.989,0.011
23751,68522,12728,12053,675,0.947,0.053
23752,68523,1390,0,1390,0.0,1.0
23753,68524,5983,5609,374,0.937,0.063
23754,68526,4800,4323,477,0.901,0.099
23755,68527,696,0,696,0.0,1.0
23756,68528,6285,5916,369,0.941,0.059
23757,68531,48,0,48,0.0,1.0
23758,68532,493,0,493,0.0,1.0
23759,68601,28185,22106,6079,0.784,0.216
23760,68620,2967,0,2967,0.0,1.0
23761,68621,517,0,517,0.0,1.0
23762,68622,275,0,275,0.0,1.0
23763,68623,313,0,313,0.0,1.0
23764,68624,1062,0,1062,0.0,1.0
23765,68626,614,0,614,0.0,1.0
23766,68627,622,0,622,0.0,1.0
23767,68628,826,0,826,0.0,1.0
23768,68629,1344,0,1344,0.0,1.0
23769,68631,480,0,480,0.0,1.0
23770,68632,3989,2879,1110,0.722,0.278
23771,68633,1179,0,1179,0.0,1.0
23772,68634,345,0,345,0.0,1.0
23773,68635,491,0,491,0.0,1.0
23774,68636,1254,0,1254,0.0,1.0
23775,68637,267,0,267,0.0,1.0
23776,68638,1749,0,1749,0.0,1.0
23777,68640,1613,0,1613,0.0,1.0
23778,68641,1063,0,1063,0.0,1.0
23779,68642,1721,0,1721,0.0,1.0
23780,68643,903,0,903,0.0,1.0
23781,68644,721,0,721,0.0,1.0
23782,68647,646,0,646,0.0,1.0
23783,68648,484,0,484,0.0,1.0
23784,68649,1835,0,1835,0.0,1.0
23785,68651,1470,0,1470,0.0,1.0
23786,68652,715,0,715,0.0,1.0
23787,68653,783,0,783,0.0,1.0
23788,68654,541,0,541,0.0,1.0
23789,68655,159,0,159,0.0,1.0
23790,68658,683,0,683,0.0,1.0
23791,68659,215,0,215,0.0,1.0
23792,68660,1137,0,1137,0.0,1.0
23793,68661,7282,6255,1027,0.859,0.141
23794,68662,1231,0,1231,0.0,1.0
23795,68663,761,0,761,0.0,1.0
23796,68664,300,0,300,0.0,1.0
23797,68665,940,0,940,0.0,1.0
23798,68666,1611,0,1611,0.0,1.0
23799,68667,92,0,92,0.0,1.0
23800,68669,422,0,422,0.0,1.0
23801,68701,30670,26769,3901,0.873,0.127
23802,68710,830,0,830,0.0,1.0
23803,68711,141,0,141,0.0,1.0
23804,68713,2212,0,2212,0.0,1.0
23805,68714,1224,0,1224,0.0,1.0
23806,68715,1446,0,1446,0.0,1.0
23807,68716,1011,0,1011,0.0,1.0
23808,68717,198,0,198,0.0,1.0
23809,68718,1765,0,1765,0.0,1.0
23810,68719,146,0,146,0.0,1.0
23811,68720,340,0,340,0.0,1.0
23812,68722,555,0,555,0.0,1.0
23813,68723,566,0,566,0.0,1.0
23814,68724,140,0,140,0.0,1.0
23815,68725,501,0,501,0.0,1.0
23816,68726,893,0,893,0.0,1.0
23817,68727,730,0,730,0.0,1.0
23818,68728,254,0,254,0.0,1.0
23819,68729,1745,0,1745,0.0,1.0
23820,68730,1860,0,1860,0.0,1.0
23821,68731,2637,1927,710,0.731,0.269
23822,68732,260,0,260,0.0,1.0
23823,68733,1286,0,1286,0.0,1.0
23824,68734,155,0,155,0.0,1.0
23825,68735,922,0,922,0.0,1.0
23826,68736,726,0,726,0.0,1.0
23827,68739,3002,0,3002,0.0,1.0
23828,68740,892,0,892,0.0,1.0
23829,68741,790,0,790,0.0,1.0
23830,68742,243,0,243,0.0,1.0
23831,68743,693,0,693,0.0,1.0
23832,68745,1572,0,1572,0.0,1.0
23833,68746,480,0,480,0.0,1.0
23834,68747,174,0,174,0.0,1.0
23835,68748,3260,0,3260,0.0,1.0
23836,68749,65,0,65,0.0,1.0
23837,68751,76,0,76,0.0,1.0
23838,68752,789,0,789,0.0,1.0
23839,68753,111,0,111,0.0,1.0
23840,68755,259,0,259,0.0,1.0
23841,68756,2058,0,2058,0.0,1.0
23842,68757,754,0,754,0.0,1.0
23843,68758,1164,0,1164,0.0,1.0
23844,68759,295,0,295,0.0,1.0
23845,68760,1364,0,1364,0.0,1.0
23846,68761,434,0,434,0.0,1.0
23847,68763,4887,3682,1205,0.753,0.247
23848,68764,753,0,753,0.0,1.0
23849,68765,1380,0,1380,0.0,1.0
23850,68766,393,0,393,0.0,1.0
23851,68767,3174,0,3174,0.0,1.0
23852,68768,642,0,642,0.0,1.0
23853,68769,1806,0,1806,0.0,1.0
23854,68770,1552,0,1552,0.0,1.0
23855,68771,1637,0,1637,0.0,1.0
23856,68773,173,0,173,0.0,1.0
23857,68774,348,0,348,0.0,1.0
23858,68776,15447,14649,798,0.948,0.052
23859,68777,774,0,774,0.0,1.0
23860,68778,572,0,572,0.0,1.0
23861,68779,2433,0,2433,0.0,1.0
23862,68780,1028,0,1028,0.0,1.0
23863,68781,1407,0,1407,0.0,1.0
23864,68783,1086,0,1086,0.0,1.0
23865,68784,2104,0,2104,0.0,1.0
23866,68785,274,0,274,0.0,1.0
23867,68786,1079,0,1079,0.0,1.0
23868,68787,6647,5557,1090,0.836,0.164
23869,68788,4898,3180,1718,0.649,0.351
23870,68789,176,0,176,0.0,1.0
23871,68790,777,0,777,0.0,1.0
23872,68791,1800,0,1800,0.0,1.0
23873,68792,407,0,407,0.0,1.0
23874,68801,30005,28627,1378,0.954,0.046
23875,68803,22560,21185,1375,0.939,0.061
23876,68810,1109,628,481,0.566,0.434
23877,68812,785,0,785,0.0,1.0
23878,68813,534,0,534,0.0,1.0
23879,68814,911,0,911,0.0,1.0
23880,68815,596,0,596,0.0,1.0
23881,68816,180,0,180,0.0,1.0
23882,68817,386,0,386,0.0,1.0
23883,68818,5475,4466,1009,0.816,0.184
23884,68820,391,0,391,0.0,1.0
23885,68821,134,0,134,0.0,1.0
23886,68822,4834,3537,1297,0.732,0.268
23887,68823,2401,0,2401,0.0,1.0
23888,68824,1414,0,1414,0.0,1.0
23889,68825,1024,0,1024,0.0,1.0
23890,68826,3955,2821,1134,0.713,0.287
23891,68827,693,0,693,0.0,1.0
23892,68828,240,0,240,0.0,1.0
23893,68831,812,0,812,0.0,1.0
23894,68832,1974,0,1974,0.0,1.0
23895,68833,299,0,299,0.0,1.0
23896,68834,226,0,226,0.0,1.0
23897,68835,485,0,485,0.0,1.0
23898,68836,1688,0,1688,0.0,1.0
23899,68837,103,0,103,0.0,1.0
23900,68838,301,0,301,0.0,1.0
23901,68840,2945,0,2945,0.0,1.0
23902,68841,610,0,610,0.0,1.0
23903,68842,668,0,668,0.0,1.0
23904,68843,806,0,806,0.0,1.0
23905,68844,228,0,228,0.0,1.0
23906,68845,19523,15943,3580,0.817,0.183
23907,68846,296,0,296,0.0,1.0
23908,68847,16504,14960,1544,0.906,0.094
23909,68849,384,384,0,1.0,0.0
23910,68850,12295,10464,1831,0.851,0.149
23911,68852,565,0,565,0.0,1.0
23912,68853,1559,0,1559,0.0,1.0
23913,68854,731,0,731,0.0,1.0
23914,68855,417,0,417,0.0,1.0
23915,68856,611,0,611,0.0,1.0
23916,68858,266,0,266,0.0,1.0
23917,68859,509,0,509,0.0,1.0
23918,68860,324,0,324,0.0,1.0
23919,68861,118,0,118,0.0,1.0
23920,68862,3007,0,3007,0.0,1.0
23921,68863,1151,0,1151,0.0,1.0
23922,68864,1027,0,1027,0.0,1.0
23923,68865,894,0,894,0.0,1.0
23924,68866,850,0,850,0.0,1.0
23925,68869,2202,0,2202,0.0,1.0
23926,68870,439,0,439,0.0,1.0
23927,68871,250,0,250,0.0,1.0
23928,68872,853,0,853,0.0,1.0
23929,68873,3289,0,3289,0.0,1.0
23930,68874,956,0,956,0.0,1.0
23931,68875,658,0,658,0.0,1.0
23932,68876,1545,0,1545,0.0,1.0
23933,68878,446,0,446,0.0,1.0
23934,68879,417,0,417,0.0,1.0
23935,68881,73,0,73,0.0,1.0
23936,68882,473,0,473,0.0,1.0
23937,68883,2411,0,2411,0.0,1.0
23938,68901,26354,23873,2481,0.906,0.094
23939,68920,1446,0,1446,0.0,1.0
23940,68922,1336,0,1336,0.0,1.0
23941,68923,131,0,131,0.0,1.0
23942,68924,1180,0,1180,0.0,1.0
23943,68925,474,0,474,0.0,1.0
23944,68926,783,0,783,0.0,1.0
23945,68927,1164,0,1164,0.0,1.0
23946,68928,426,0,426,0.0,1.0
23947,68929,160,0,160,0.0,1.0
23948,68930,1461,0,1461,0.0,1.0
23949,68932,493,0,493,0.0,1.0
23950,68933,932,0,932,0.0,1.0
23951,68934,188,0,188,0.0,1.0
23952,68935,750,0,750,0.0,1.0
23953,68936,243,0,243,0.0,1.0
23954,68937,1836,0,1836,0.0,1.0
23955,68938,582,0,582,0.0,1.0
23956,68939,1318,0,1318,0.0,1.0
23957,68940,496,0,496,0.0,1.0
23958,68941,832,0,832,0.0,1.0
23959,68942,490,0,490,0.0,1.0
23960,68943,269,0,269,0.0,1.0
23961,68944,1323,0,1323,0.0,1.0
23962,68945,213,0,213,0.0,1.0
23963,68946,53,0,53,0.0,1.0
23964,68947,549,0,549,0.0,1.0
23965,68948,363,0,363,0.0,1.0
23966,68949,6567,5340,1227,0.813,0.187
23967,68950,331,0,331,0.0,1.0
23968,68952,172,0,172,0.0,1.0
23969,68954,94,0,94,0.0,1.0
23970,68955,2025,439,1586,0.217,0.783
23971,68956,1215,0,1215,0.0,1.0
23972,68957,631,0,631,0.0,1.0
23973,68958,661,0,661,0.0,1.0
23974,68959,4015,2891,1124,0.72,0.28
23975,68960,183,0,183,0.0,1.0
23976,68961,732,0,732,0.0,1.0
23977,68964,135,0,135,0.0,1.0
23978,68966,674,0,674,0.0,1.0
23979,68967,1142,0,1142,0.0,1.0
23980,68969,38,0,38,0.0,1.0
23981,68970,1342,0,1342,0.0,1.0
23982,68971,458,0,458,0.0,1.0
23983,68972,209,0,209,0.0,1.0
23984,68973,463,0,463,0.0,1.0
23985,68974,184,0,184,0.0,1.0
23986,68975,160,0,160,0.0,1.0
23987,68976,316,0,316,0.0,1.0
23988,68977,342,0,342,0.0,1.0
23989,68978,2377,0,2377,0.0,1.0
23990,68979,1888,0,1888,0.0,1.0
23991,68980,388,0,388,0.0,1.0
23992,68981,314,0,314,0.0,1.0
23993,68982,649,0,649,0.0,1.0
23994,69001,9449,7563,1886,0.8,0.2
23995,69020,397,0,397,0.0,1.0
23996,69021,1348,0,1348,0.0,1.0
23997,69022,1570,0,1570,0.0,1.0
23998,69023,440,0,440,0.0,1.0
23999,69024,1195,0,1195,0.0,1.0
24000,69025,1220,0,1220,0.0,1.0
24001,69026,220,0,220,0.0,1.0
24002,69027,133,0,133,0.0,1.0
24003,69028,731,0,731,0.0,1.0
24004,69029,316,0,316,0.0,1.0
24005,69030,324,0,324,0.0,1.0
24006,69032,498,0,498,0.0,1.0
24007,69033,2577,0,2577,0.0,1.0
24008,69034,908,0,908,0.0,1.0
24009,69036,126,0,126,0.0,1.0
24010,69037,115,0,115,0.0,1.0
24011,69038,449,0,449,0.0,1.0
24012,69039,139,0,139,0.0,1.0
24013,69040,634,0,634,0.0,1.0
24014,69041,161,0,161,0.0,1.0
24015,69042,36,0,36,0.0,1.0
24016,69043,549,0,549,0.0,1.0
24017,69044,825,0,825,0.0,1.0
24018,69045,975,0,975,0.0,1.0
24019,69046,194,0,194,0.0,1.0
24020,69101,29904,25213,4691,0.843,0.157
24021,69120,931,0,931,0.0,1.0
24022,69121,400,0,400,0.0,1.0
24023,69122,619,0,619,0.0,1.0
24024,69123,935,0,935,0.0,1.0
24025,69125,346,0,346,0.0,1.0
24026,69127,739,0,739,0.0,1.0
24027,69128,302,0,302,0.0,1.0
24028,69129,1368,0,1368,0.0,1.0
24029,69130,5307,3863,1444,0.728,0.272
24030,69131,561,0,561,0.0,1.0
24031,69132,117,0,117,0.0,1.0
24032,69133,386,0,386,0.0,1.0
24033,69134,364,0,364,0.0,1.0
24034,69135,65,0,65,0.0,1.0
24035,69138,4489,3515,974,0.783,0.217
24036,69140,1775,0,1775,0.0,1.0
24037,69141,385,0,385,0.0,1.0
24038,69142,137,0,137,0.0,1.0
24039,69143,1460,0,1460,0.0,1.0
24040,69144,202,0,202,0.0,1.0
24041,69145,3214,0,3214,0.0,1.0
24042,69146,334,0,334,0.0,1.0
24043,69147,737,0,737,0.0,1.0
24044,69148,217,0,217,0.0,1.0
24045,69149,699,0,699,0.0,1.0
24046,69150,522,0,522,0.0,1.0
24047,69151,815,0,815,0.0,1.0
24048,69152,886,0,886,0.0,1.0
24049,69153,5769,4424,1345,0.767,0.233
24050,69154,1291,0,1291,0.0,1.0
24051,69155,1034,0,1034,0.0,1.0
24052,69156,699,0,699,0.0,1.0
24053,69157,21,0,21,0.0,1.0
24054,69161,81,0,81,0.0,1.0
24055,69162,7765,6373,1392,0.821,0.179
24056,69163,873,0,873,0.0,1.0
24057,69165,1789,0,1789,0.0,1.0
24058,69166,600,0,600,0.0,1.0
24059,69167,441,0,441,0.0,1.0
24060,69168,271,0,271,0.0,1.0
24061,69169,651,0,651,0.0,1.0
24062,69170,372,0,372,0.0,1.0
24063,69171,26,0,26,0.0,1.0
24064,69201,4005,2713,1292,0.677,0.323
24065,69210,2484,0,2484,0.0,1.0
24066,69211,311,0,311,0.0,1.0
24067,69212,248,0,248,0.0,1.0
24068,69214,203,0,203,0.0,1.0
24069,69216,232,0,232,0.0,1.0
24070,69217,533,0,533,0.0,1.0
24071,69218,260,0,260,0.0,1.0
24072,69219,80,0,80,0.0,1.0
24073,69220,59,0,59,0.0,1.0
24074,69221,222,0,222,0.0,1.0
24075,69301,10125,8486,1639,0.838,0.162
24076,69331,59,0,59,0.0,1.0
24077,69333,239,0,239,0.0,1.0
24078,69334,2351,0,2351,0.0,1.0
24079,69335,53,0,53,0.0,1.0
24080,69336,2466,0,2466,0.0,1.0
24081,69337,7365,5515,1850,0.749,0.251
24082,69339,1462,0,1462,0.0,1.0
24083,69340,121,0,121,0.0,1.0
24084,69341,11165,9990,1175,0.895,0.105
24085,69343,2538,0,2538,0.0,1.0
24086,69345,455,0,455,0.0,1.0
24087,69346,592,0,592,0.0,1.0
24088,69347,1249,0,1249,0.0,1.0
24089,69348,1503,0,1503,0.0,1.0
24090,69350,383,0,383,0.0,1.0
24091,69351,235,0,235,0.0,1.0
24092,69352,619,0,619,0.0,1.0
24093,69353,37,0,37,0.0,1.0
24094,69354,97,0,97,0.0,1.0
24095,69355,115,0,115,0.0,1.0
24096,69356,1882,0,1882,0.0,1.0
24097,69357,3567,24,3543,0.007,0.993
24098,69358,1907,0,1907,0.0,1.0
24099,69360,1361,0,1361,0.0,1.0
24100,69361,17999,15932,2067,0.885,0.115
24101,69365,44,0,44,0.0,1.0
24102,69366,253,0,253,0.0,1.0
24103,69367,259,0,259,0.0,1.0
24104,70001,37996,37996,0,1.0,0.0
24105,70002,18879,18879,0,1.0,0.0
24106,70003,40150,40150,0,1.0,0.0
24107,70005,24339,24339,0,1.0,0.0
24108,70006,15703,15703,0,1.0,0.0
24109,70030,4585,1809,2776,0.395,0.605
24110,70031,1316,1041,275,0.791,0.209
24111,70032,3635,3635,0,1.0,0.0
24112,70036,1227,463,764,0.377,0.623
24113,70037,15590,14773,817,0.948,0.052
24114,70038,426,411,15,0.965,0.035
24115,70039,2460,1952,508,0.793,0.207
24116,70040,1604,0,1604,0.0,1.0
24117,70041,2381,2043,338,0.858,0.142
24118,70043,16760,16749,11,0.999,0.001
24119,70047,13006,12965,41,0.997,0.003
24120,70049,2481,0,2481,0.0,1.0
24121,70050,74,64,10,0.865,0.135
24122,70051,2518,2292,226,0.91,0.09
24123,70052,3795,3765,30,0.992,0.008
24124,70053,16499,16499,0,1.0,0.0
24125,70056,39082,39082,0,1.0,0.0
24126,70057,4719,2845,1874,0.603,0.397
24127,70058,39887,39598,289,0.993,0.007
24128,70062,17095,17095,0,1.0,0.0
24129,70065,51116,51116,0,1.0,0.0
24130,70067,2757,1675,1082,0.608,0.392
24131,70068,34101,31122,2979,0.913,0.087
24132,70070,12471,12105,366,0.971,0.029
24133,70071,3653,3653,0,1.0,0.0
24134,70072,56344,55871,473,0.992,0.008
24135,70075,4417,4417,0,1.0,0.0
24136,70076,292,189,103,0.647,0.353
24137,70079,3067,3067,0,1.0,0.0
24138,70080,1556,1387,169,0.891,0.109
24139,70082,336,0,336,0.0,1.0
24140,70083,2353,1057,1296,0.449,0.551
24141,70084,7552,7479,73,0.99,0.01
24142,70085,4427,3101,1326,0.7,0.3
24143,70086,1969,130,1839,0.066,0.934
24144,70087,8122,8084,38,0.995,0.005
24145,70090,7671,4828,2843,0.629,0.371
24146,70091,278,192,86,0.691,0.309
24147,70092,6651,6468,183,0.972,0.028
24148,70094,31669,30640,1029,0.968,0.032
24149,70112,3655,3655,0,1.0,0.0
24150,70113,7025,7025,0,1.0,0.0
24151,70114,22870,22870,0,1.0,0.0
24152,70115,31695,31695,0,1.0,0.0
24153,70116,11507,11507,0,1.0,0.0
24154,70117,23389,23389,0,1.0,0.0
24155,70118,33008,33008,0,1.0,0.0
24156,70119,36228,36228,0,1.0,0.0
24157,70121,12029,12029,0,1.0,0.0
24158,70122,28564,28564,0,1.0,0.0
24159,70123,26475,26475,0,1.0,0.0
24160,70124,16824,16824,0,1.0,0.0
24161,70125,14479,14479,0,1.0,0.0
24162,70126,23958,23958,0,1.0,0.0
24163,70127,20471,20471,0,1.0,0.0
24164,70128,17113,17113,0,1.0,0.0
24165,70129,9064,7720,1344,0.852,0.148
24166,70130,14064,14064,0,1.0,0.0
24167,70131,29915,29224,691,0.977,0.023
24168,70139,0,0,0,,
24169,70163,0,0,0,,
24170,70301,43037,32491,10546,0.755,0.245
24171,70339,6033,3829,2204,0.635,0.365
24172,70340,109,109,0,1.0,0.0
24173,70341,4449,2727,1722,0.613,0.387
24174,70342,4979,4869,110,0.978,0.022
24175,70343,5504,3913,1591,0.711,0.289
24176,70344,6143,3621,2522,0.589,0.411
24177,70345,9754,9145,609,0.938,0.062
24178,70346,10925,9183,1742,0.841,0.159
24179,70352,205,0,205,0.0,1.0
24180,70353,1402,0,1402,0.0,1.0
24181,70354,4931,4665,266,0.946,0.054
24182,70355,1041,0,1041,0.0,1.0
24183,70356,2484,0,2484,0.0,1.0
24184,70357,3043,2429,614,0.798,0.202
24185,70358,1296,0,1296,0.0,1.0
24186,70359,8408,7159,1249,0.851,0.149
24187,70360,26429,23267,3162,0.88,0.12
24188,70363,26513,22800,3713,0.86,0.14
24189,70364,30503,26979,3524,0.884,0.116
24190,70372,2518,1666,852,0.662,0.338
24191,70373,7141,5197,1944,0.728,0.272
24192,70374,7125,5346,1779,0.75,0.25
24193,70375,125,100,25,0.8,0.2
24194,70377,4403,1259,3144,0.286,0.714
24195,70380,22928,19843,3085,0.865,0.135
24196,70390,6969,4049,2920,0.581,0.419
24197,70391,202,116,86,0.574,0.426
24198,70392,8456,7001,1455,0.828,0.172
24199,70393,774,368,406,0.475,0.525
24200,70394,14328,10018,4310,0.699,0.301
24201,70395,4658,3497,1161,0.751,0.249
24202,70397,1365,0,1365,0.0,1.0
24203,70401,20415,17405,3010,0.853,0.147
24204,70402,1514,1514,0,1.0,0.0
24205,70403,26011,22331,3680,0.859,0.141
24206,70420,7345,4679,2666,0.637,0.363
24207,70422,13797,5314,8483,0.385,0.615
24208,70426,6342,0,6342,0.0,1.0
24209,70427,20033,12213,7820,0.61,0.39
24210,70431,5366,0,5366,0.0,1.0
24211,70433,31133,29408,1725,0.945,0.055
24212,70435,16603,2850,13753,0.172,0.828
24213,70436,629,0,629,0.0,1.0
24214,70437,7918,0,7918,0.0,1.0
24215,70438,18540,3506,15034,0.189,0.811
24216,70441,5112,0,5112,0.0,1.0
24217,70442,277,0,277,0.0,1.0
24218,70443,10232,2414,7818,0.236,0.764
24219,70444,10160,0,10160,0.0,1.0
24220,70445,10840,6486,4354,0.598,0.402
24221,70446,5877,0,5877,0.0,1.0
24222,70447,10150,8771,1379,0.864,0.136
24223,70448,24851,23469,1382,0.944,0.056
24224,70449,3611,0,3611,0.0,1.0
24225,70450,2884,0,2884,0.0,1.0
24226,70451,182,182,0,1.0,0.0
24227,70452,13163,5589,7574,0.425,0.575
24228,70453,1045,0,1045,0.0,1.0
24229,70454,24954,17525,7429,0.702,0.298
24230,70455,1474,0,1474,0.0,1.0
24231,70456,2850,1065,1785,0.374,0.626
24232,70458,35077,34992,85,0.998,0.002
24233,70460,22096,20267,1829,0.917,0.083
24234,70461,27818,23817,4001,0.856,0.144
24235,70462,5699,602,5097,0.106,0.894
24236,70463,126,0,126,0.0,1.0
24237,70464,312,0,312,0.0,1.0
24238,70465,776,0,776,0.0,1.0
24239,70466,8512,3794,4718,0.446,0.554
24240,70471,21383,19142,2241,0.895,0.105
24241,70501,31358,31042,316,0.99,0.01
24242,70503,27816,27813,3,1.0,0.0
24243,70506,41163,40744,419,0.99,0.01
24244,70507,16558,16231,327,0.98,0.02
24245,70508,34810,34707,103,0.997,0.003
24246,70510,25313,15138,10175,0.598,0.402
24247,70512,9780,864,8916,0.088,0.912
24248,70513,124,0,124,0.0,1.0
24249,70514,2545,2302,243,0.905,0.095
24250,70515,3838,0,3838,0.0,1.0
24251,70516,1546,0,1546,0.0,1.0
24252,70517,26500,16566,9934,0.625,0.375
24253,70518,12297,9562,2735,0.778,0.222
24254,70519,222,0,222,0.0,1.0
24255,70520,18405,12255,6150,0.666,0.334
24256,70523,906,697,209,0.769,0.231
24257,70524,314,0,314,0.0,1.0
24258,70525,13150,4588,8562,0.349,0.651
24259,70526,19206,14908,4298,0.776,0.224
24260,70528,2333,2149,184,0.921,0.079
24261,70529,11752,8509,3243,0.724,0.276
24262,70531,1261,0,1261,0.0,1.0
24263,70532,2685,0,2685,0.0,1.0
24264,70533,7385,2482,4903,0.336,0.664
24265,70534,899,0,899,0.0,1.0
24266,70535,18215,11940,6275,0.656,0.344
24267,70537,541,0,541,0.0,1.0
24268,70538,14844,11409,3435,0.769,0.231
24269,70541,432,242,190,0.56,0.44
24270,70542,3435,0,3435,0.0,1.0
24271,70543,4077,0,4077,0.0,1.0
24272,70544,11677,7255,4422,0.621,0.379
24273,70546,16425,9869,6556,0.601,0.399
24274,70548,10353,4826,5527,0.466,0.534
24275,70549,3948,2786,1162,0.706,0.294
24276,70550,174,92,82,0.529,0.471
24277,70552,1819,882,937,0.485,0.515
24278,70554,5582,3608,1974,0.646,0.354
24279,70555,7372,2454,4918,0.333,0.667
24280,70556,331,0,331,0.0,1.0
24281,70558,134,134,0,1.0,0.0
24282,70559,2943,0,2943,0.0,1.0
24283,70560,42022,30268,11754,0.72,0.28
24284,70563,18502,13785,4717,0.745,0.255
24285,70570,38987,24511,14476,0.629,0.371
24286,70575,55,55,0,1.0,0.0
24287,70576,1526,0,1526,0.0,1.0
24288,70577,4645,2531,2114,0.545,0.455
24289,70578,16122,9385,6737,0.582,0.418
24290,70580,179,179,0,1.0,0.0
24291,70581,929,0,929,0.0,1.0
24292,70582,19781,8466,11315,0.428,0.572
24293,70583,11693,8527,3166,0.729,0.271
24294,70584,7358,3466,3892,0.471,0.529
24295,70585,235,0,235,0.0,1.0
24296,70586,20313,9435,10878,0.464,0.536
24297,70589,3283,970,2313,0.295,0.705
24298,70591,5299,2631,2668,0.497,0.503
24299,70592,18878,15221,3657,0.806,0.194
24300,70601,32384,32384,0,1.0,0.0
24301,70605,32741,29670,3071,0.906,0.094
24302,70607,25560,19736,5824,0.772,0.228
24303,70611,19256,13969,5287,0.725,0.275
24304,70615,14335,9916,4419,0.692,0.308
24305,70630,1440,0,1440,0.0,1.0
24306,70631,962,0,962,0.0,1.0
24307,70632,371,0,371,0.0,1.0
24308,70633,7604,4096,3508,0.539,0.461
24309,70634,25125,12100,13025,0.482,0.518
24310,70637,654,0,654,0.0,1.0
24311,70638,937,0,937,0.0,1.0
24312,70639,684,0,684,0.0,1.0
24313,70640,301,0,301,0.0,1.0
24314,70643,352,0,352,0.0,1.0
24315,70644,308,0,308,0.0,1.0
24316,70645,1262,0,1262,0.0,1.0
24317,70646,750,0,750,0.0,1.0
24318,70647,8703,3360,5343,0.386,0.614
24319,70648,8026,0,8026,0.0,1.0
24320,70650,435,0,435,0.0,1.0
24321,70651,500,0,500,0.0,1.0
24322,70652,2203,0,2203,0.0,1.0
24323,70653,3111,0,3111,0.0,1.0
24324,70654,155,0,155,0.0,1.0
24325,70655,3002,0,3002,0.0,1.0
24326,70656,4023,0,4023,0.0,1.0
24327,70657,4315,0,4315,0.0,1.0
24328,70658,955,0,955,0.0,1.0
24329,70659,1482,1117,365,0.754,0.246
24330,70660,2612,921,1691,0.353,0.647
24331,70661,2309,0,2309,0.0,1.0
24332,70662,411,0,411,0.0,1.0
24333,70663,28150,20921,7229,0.743,0.257
24334,70665,10743,6809,3934,0.634,0.366
24335,70668,6424,2752,3672,0.428,0.572
24336,70669,10131,9927,204,0.98,0.02
24337,70706,20752,15055,5697,0.725,0.275
24338,70710,3593,3351,242,0.933,0.067
24339,70711,5266,2250,3016,0.427,0.573
24340,70712,479,0,479,0.0,1.0
24341,70714,19803,16405,3398,0.828,0.172
24342,70715,1433,0,1433,0.0,1.0
24343,70719,4460,4213,247,0.945,0.055
24344,70721,701,0,701,0.0,1.0
24345,70722,5713,0,5713,0.0,1.0
24346,70723,1759,758,1001,0.431,0.569
24347,70725,1826,1215,611,0.665,0.335
24348,70726,50583,44945,5638,0.889,0.111
24349,70729,1032,0,1032,0.0,1.0
24350,70730,3499,0,3499,0.0,1.0
24351,70732,1178,0,1178,0.0,1.0
24352,70733,1621,0,1621,0.0,1.0
24353,70734,7554,6494,1060,0.86,0.14
24354,70736,518,0,518,0.0,1.0
24355,70737,38643,36244,2399,0.938,0.062
24356,70739,12486,7109,5377,0.569,0.431
24357,70740,1305,572,733,0.438,0.562
24358,70743,350,189,161,0.54,0.46
24359,70744,6181,0,6181,0.0,1.0
24360,70747,180,0,180,0.0,1.0
24361,70748,6657,0,6657,0.0,1.0
24362,70749,1554,614,940,0.395,0.605
24363,70750,1951,0,1951,0.0,1.0
24364,70752,806,69,737,0.086,0.914
24365,70753,870,0,870,0.0,1.0
24366,70754,10170,745,9425,0.073,0.927
24367,70755,2186,1376,810,0.629,0.371
24368,70756,393,0,393,0.0,1.0
24369,70757,3177,1693,1484,0.533,0.467
24370,70759,1528,17,1511,0.011,0.989
24371,70760,6993,5432,1561,0.777,0.223
24372,70761,897,0,897,0.0,1.0
24373,70762,926,372,554,0.402,0.598
24374,70763,3816,2984,832,0.782,0.218
24375,70764,17584,10999,6585,0.626,0.374
24376,70767,14914,8978,5936,0.602,0.398
24377,70769,36084,31810,4274,0.882,0.118
24378,70770,2923,1408,1515,0.482,0.518
24379,70772,784,172,612,0.219,0.781
24380,70773,143,0,143,0.0,1.0
24381,70774,10076,6051,4025,0.601,0.399
24382,70775,14720,0,14720,0.0,1.0
24383,70776,6043,478,5565,0.079,0.921
24384,70777,4269,0,4269,0.0,1.0
24385,70778,2291,2048,243,0.894,0.106
24386,70780,1015,0,1015,0.0,1.0
24387,70782,299,0,299,0.0,1.0
24388,70783,2604,1443,1161,0.554,0.446
24389,70785,20979,11392,9587,0.543,0.457
24390,70787,127,0,127,0.0,1.0
24391,70788,4051,0,4051,0.0,1.0
24392,70789,750,0,750,0.0,1.0
24393,70791,24918,12196,12722,0.489,0.511
24394,70801,13,13,0,1.0,0.0
24395,70802,27267,27267,0,1.0,0.0
24396,70803,1335,1335,0,1.0,0.0
24397,70805,29909,29909,0,1.0,0.0
24398,70806,28706,28706,0,1.0,0.0
24399,70807,20377,20139,238,0.988,0.012
24400,70808,32504,32504,0,1.0,0.0
24401,70809,25050,25050,0,1.0,0.0
24402,70810,37980,35544,2436,0.936,0.064
24403,70811,13676,13659,17,0.999,0.001
24404,70812,11206,11206,0,1.0,0.0
24405,70814,14514,14514,0,1.0,0.0
24406,70815,30075,30075,0,1.0,0.0
24407,70816,43194,43126,68,0.998,0.002
24408,70817,31192,29967,1225,0.961,0.039
24409,70818,9649,8570,1079,0.888,0.112
24410,70819,5040,4836,204,0.96,0.04
24411,70820,17222,16753,469,0.973,0.027
24412,70836,0,0,0,,
24413,71001,4531,2894,1637,0.639,0.361
24414,71003,989,0,989,0.0,1.0
24415,71004,644,0,644,0.0,1.0
24416,71006,12158,5371,6787,0.442,0.558
24417,71007,1141,0,1141,0.0,1.0
24418,71008,739,0,739,0.0,1.0
24419,71016,2070,0,2070,0.0,1.0
24420,71018,1622,0,1622,0.0,1.0
24421,71019,8555,0,8555,0.0,1.0
24422,71021,772,772,0,1.0,0.0
24423,71023,3632,0,3632,0.0,1.0
24424,71024,1420,0,1420,0.0,1.0
24425,71027,1585,0,1585,0.0,1.0
24426,71028,1666,0,1666,0.0,1.0
24427,71029,219,0,219,0.0,1.0
24428,71030,1537,0,1537,0.0,1.0
24429,71031,1064,0,1064,0.0,1.0
24430,71032,2164,0,2164,0.0,1.0
24431,71033,3510,2463,1047,0.702,0.298
24432,71034,313,0,313,0.0,1.0
24433,71037,19325,11764,7561,0.609,0.391
24434,71038,4064,0,4064,0.0,1.0
24435,71039,1934,0,1934,0.0,1.0
24436,71040,10268,3034,7234,0.295,0.705
24437,71043,546,0,546,0.0,1.0
24438,71044,657,0,657,0.0,1.0
24439,71045,663,0,663,0.0,1.0
24440,71046,1351,0,1351,0.0,1.0
24441,71047,12203,2743,9460,0.225,0.775
24442,71048,104,0,104,0.0,1.0
24443,71049,3460,0,3460,0.0,1.0
24444,71051,2409,0,2409,0.0,1.0
24445,71052,10259,6061,4198,0.591,0.409
24446,71055,20268,12501,7767,0.617,0.383
24447,71060,3089,0,3089,0.0,1.0
24448,71061,1712,0,1712,0.0,1.0
24449,71063,748,0,748,0.0,1.0
24450,71064,4096,0,4096,0.0,1.0
24451,71065,1232,0,1232,0.0,1.0
24452,71067,3297,624,2673,0.189,0.811
24453,71068,3627,0,3627,0.0,1.0
24454,71069,812,0,812,0.0,1.0
24455,71070,1833,0,1833,0.0,1.0
24456,71071,2685,0,2685,0.0,1.0
24457,71072,1530,0,1530,0.0,1.0
24458,71073,2319,837,1482,0.361,0.639
24459,71075,6416,5240,1176,0.817,0.183
24460,71078,5546,0,5546,0.0,1.0
24461,71079,272,0,272,0.0,1.0
24462,71082,5119,2980,2139,0.582,0.418
24463,71101,8197,8197,0,1.0,0.0
24464,71103,7813,7813,0,1.0,0.0
24465,71104,14802,14802,0,1.0,0.0
24466,71105,21907,21871,36,0.998,0.002
24467,71106,34814,32752,2062,0.941,0.059
24468,71107,33800,25439,8361,0.753,0.247
24469,71108,20388,20388,0,1.0,0.0
24470,71109,22154,22073,81,0.996,0.004
24471,71110,2793,2287,506,0.819,0.181
24472,71111,38456,36901,1555,0.96,0.04
24473,71112,31358,28852,2506,0.92,0.08
24474,71115,14506,13361,1145,0.921,0.079
24475,71118,24761,24414,347,0.986,0.014
24476,71119,11562,10550,1012,0.912,0.088
24477,71129,13391,11023,2368,0.823,0.177
24478,71201,20319,20294,25,0.999,0.001
24479,71202,29044,25716,3328,0.885,0.115
24480,71203,37105,28996,8109,0.781,0.219
24481,71209,154,154,0,1.0,0.0
24482,71219,1288,0,1288,0.0,1.0
24483,71220,23266,13979,9287,0.601,0.399
24484,71222,3481,0,3481,0.0,1.0
24485,71223,523,0,523,0.0,1.0
24486,71225,7068,0,7068,0.0,1.0
24487,71226,1638,0,1638,0.0,1.0
24488,71227,3635,0,3635,0.0,1.0
24489,71229,1662,0,1662,0.0,1.0
24490,71232,6581,2770,3811,0.421,0.579
24491,71233,305,194,111,0.636,0.364
24492,71234,3992,0,3992,0.0,1.0
24493,71235,4280,0,4280,0.0,1.0
24494,71237,1578,0,1578,0.0,1.0
24495,71238,2807,0,2807,0.0,1.0
24496,71241,9982,3883,6099,0.389,0.611
24497,71243,194,0,194,0.0,1.0
24498,71245,4718,4165,553,0.883,0.117
24499,71247,1175,984,191,0.837,0.163
24500,71250,220,0,220,0.0,1.0
24501,71251,9051,4526,4525,0.5,0.5
24502,71253,255,0,255,0.0,1.0
24503,71254,6759,5076,1683,0.751,0.249
24504,71256,688,0,688,0.0,1.0
24505,71259,1697,0,1697,0.0,1.0
24506,71260,3177,0,3177,0.0,1.0
24507,71261,1684,0,1684,0.0,1.0
24508,71263,8275,0,8275,0.0,1.0
24509,71264,1045,0,1045,0.0,1.0
24510,71266,1699,0,1699,0.0,1.0
24511,71268,2819,99,2720,0.035,0.965
24512,71269,12757,4267,8490,0.334,0.666
24513,71270,30887,21666,9221,0.701,0.299
24514,71272,1893,1893,0,1.0,0.0
24515,71275,2453,0,2453,0.0,1.0
24516,71276,289,0,289,0.0,1.0
24517,71277,1758,0,1758,0.0,1.0
24518,71279,45,0,45,0.0,1.0
24519,71280,3647,0,3647,0.0,1.0
24520,71282,11070,9185,1885,0.83,0.17
24521,71286,615,0,615,0.0,1.0
24522,71291,32644,30041,2603,0.92,0.08
24523,71292,21541,11332,10209,0.526,0.474
24524,71295,14343,5361,8982,0.374,0.626
24525,71301,22859,22807,52,0.998,0.002
24526,71302,15049,12871,2178,0.855,0.145
24527,71303,21015,18052,2963,0.859,0.141
24528,71316,37,0,37,0.0,1.0
24529,71322,6969,4090,2879,0.587,0.413
24530,71323,989,0,989,0.0,1.0
24531,71325,1321,0,1321,0.0,1.0
24532,71326,1164,0,1164,0.0,1.0
24533,71327,5454,3631,1823,0.666,0.334
24534,71328,7414,0,7414,0.0,1.0
24535,71331,1036,0,1036,0.0,1.0
24536,71333,666,0,666,0.0,1.0
24537,71334,9839,7402,2437,0.752,0.248
24538,71336,1650,0,1650,0.0,1.0
24539,71339,130,0,130,0.0,1.0
24540,71340,1710,0,1710,0.0,1.0
24541,71341,3069,0,3069,0.0,1.0
24542,71342,7533,3992,3541,0.53,0.47
24543,71343,7678,0,7678,0.0,1.0
24544,71345,69,0,69,0.0,1.0
24545,71346,3040,0,3040,0.0,1.0
24546,71350,4124,1607,2517,0.39,0.61
24547,71351,11502,5910,5592,0.514,0.486
24548,71353,1664,0,1664,0.0,1.0
24549,71354,1699,0,1699,0.0,1.0
24550,71355,2764,0,2764,0.0,1.0
24551,71356,648,0,648,0.0,1.0
24552,71357,2149,0,2149,0.0,1.0
24553,71358,1111,0,1111,0.0,1.0
24554,71360,35361,20833,14528,0.589,0.411
24555,71362,2169,0,2169,0.0,1.0
24556,71366,1974,0,1974,0.0,1.0
24557,71367,1278,0,1278,0.0,1.0
24558,71368,1459,0,1459,0.0,1.0
24559,71369,3222,0,3222,0.0,1.0
24560,71371,2151,0,2151,0.0,1.0
24561,71373,7358,6454,904,0.877,0.123
24562,71375,1129,0,1129,0.0,1.0
24563,71377,112,0,112,0.0,1.0
24564,71378,2536,0,2536,0.0,1.0
24565,71401,117,0,117,0.0,1.0
24566,71403,4584,0,4584,0.0,1.0
24567,71404,797,0,797,0.0,1.0
24568,71405,5592,4473,1119,0.8,0.2
24569,71406,216,0,216,0.0,1.0
24570,71407,933,0,933,0.0,1.0
24571,71409,6874,226,6648,0.033,0.967
24572,71410,124,0,124,0.0,1.0
24573,71411,2875,0,2875,0.0,1.0
24574,71414,238,0,238,0.0,1.0
24575,71416,842,0,842,0.0,1.0
24576,71417,4932,0,4932,0.0,1.0
24577,71418,6295,0,6295,0.0,1.0
24578,71419,2444,0,2444,0.0,1.0
24579,71422,1542,0,1542,0.0,1.0
24580,71423,4538,0,4538,0.0,1.0
24581,71424,1225,0,1225,0.0,1.0
24582,71425,214,0,214,0.0,1.0
24583,71426,229,0,229,0.0,1.0
24584,71427,413,0,413,0.0,1.0
24585,71429,3179,0,3179,0.0,1.0
24586,71430,2576,0,2576,0.0,1.0
24587,71432,1053,0,1053,0.0,1.0
24588,71433,4367,0,4367,0.0,1.0
24589,71435,3979,0,3979,0.0,1.0
24590,71438,1626,0,1626,0.0,1.0
24591,71439,1897,0,1897,0.0,1.0
24592,71441,618,0,618,0.0,1.0
24593,71446,22762,9672,13090,0.425,0.575
24594,71447,1469,0,1469,0.0,1.0
24595,71449,9696,2860,6836,0.295,0.705
24596,71450,1070,0,1070,0.0,1.0
24597,71452,57,0,57,0.0,1.0
24598,71454,2527,0,2527,0.0,1.0
24599,71455,227,0,227,0.0,1.0
24600,71456,1223,0,1223,0.0,1.0
24601,71457,27809,19763,8046,0.711,0.289
24602,71459,11902,11854,48,0.996,0.004
24603,71461,2577,2503,74,0.971,0.029
24604,71462,1432,0,1432,0.0,1.0
24605,71463,10801,7878,2923,0.729,0.271
24606,71465,3139,0,3139,0.0,1.0
24607,71466,591,0,591,0.0,1.0
24608,71467,7998,3214,4784,0.402,0.598
24609,71468,868,0,868,0.0,1.0
24610,71469,2792,0,2792,0.0,1.0
24611,71472,287,0,287,0.0,1.0
24612,71473,495,0,495,0.0,1.0
24613,71474,663,0,663,0.0,1.0
24614,71479,738,0,738,0.0,1.0
24615,71480,1324,0,1324,0.0,1.0
24616,71483,11294,5376,5918,0.476,0.524
24617,71485,1804,328,1476,0.182,0.818
24618,71486,4940,0,4940,0.0,1.0
24619,71601,17327,16235,1092,0.937,0.063
24620,71602,17982,11837,6145,0.658,0.342
24621,71603,34343,25423,8920,0.74,0.26
24622,71630,405,0,405,0.0,1.0
24623,71631,673,0,673,0.0,1.0
24624,71635,12348,7835,4513,0.635,0.365
24625,71638,3794,2816,978,0.742,0.258
24626,71639,6579,5023,1556,0.763,0.237
24627,71640,3227,0,3227,0.0,1.0
24628,71642,648,0,648,0.0,1.0
24629,71643,1109,0,1109,0.0,1.0
24630,71644,4264,0,4264,0.0,1.0
24631,71646,6756,2724,4032,0.403,0.597
24632,71647,2111,0,2111,0.0,1.0
24633,71651,150,0,150,0.0,1.0
24634,71652,1159,0,1159,0.0,1.0
24635,71653,5152,2586,2566,0.502,0.498
24636,71654,4671,3898,773,0.835,0.165
24637,71655,15387,9505,5882,0.618,0.382
24638,71658,728,0,728,0.0,1.0
24639,71659,104,0,104,0.0,1.0
24640,71660,963,0,963,0.0,1.0
24641,71661,450,0,450,0.0,1.0
24642,71662,82,0,82,0.0,1.0
24643,71663,732,0,732,0.0,1.0
24644,71665,6054,0,6054,0.0,1.0
24645,71666,79,0,79,0.0,1.0
24646,71667,8267,0,8267,0.0,1.0
24647,71670,1403,0,1403,0.0,1.0
24648,71671,8665,5801,2864,0.669,0.331
24649,71674,738,0,738,0.0,1.0
24650,71675,1824,0,1824,0.0,1.0
24651,71676,684,0,684,0.0,1.0
24652,71677,185,0,185,0.0,1.0
24653,71701,20286,11401,8885,0.562,0.438
24654,71711,106,0,106,0.0,1.0
24655,71720,2498,0,2498,0.0,1.0
24656,71722,87,0,87,0.0,1.0
24657,71724,431,0,431,0.0,1.0
24658,71725,555,0,555,0.0,1.0
24659,71726,1435,0,1435,0.0,1.0
24660,71730,32213,18944,13269,0.588,0.412
24661,71740,1735,0,1735,0.0,1.0
24662,71742,5980,3844,2136,0.643,0.357
24663,71743,4090,0,4090,0.0,1.0
24664,71744,3224,0,3224,0.0,1.0
24665,71745,264,0,264,0.0,1.0
24666,71747,1097,0,1097,0.0,1.0
24667,71749,2595,0,2595,0.0,1.0
24668,71751,939,0,939,0.0,1.0
24669,71752,1052,0,1052,0.0,1.0
24670,71753,16848,10438,6410,0.62,0.38
24671,71758,450,0,450,0.0,1.0
24672,71759,600,0,600,0.0,1.0
24673,71762,2501,0,2501,0.0,1.0
24674,71763,1666,0,1666,0.0,1.0
24675,71764,1880,0,1880,0.0,1.0
24676,71765,2156,0,2156,0.0,1.0
24677,71766,670,0,670,0.0,1.0
24678,71770,3526,0,3526,0.0,1.0
24679,71772,34,0,34,0.0,1.0
24680,71801,16745,9991,6754,0.597,0.403
24681,71820,103,0,103,0.0,1.0
24682,71822,8925,3983,4942,0.446,0.554
24683,71823,83,0,83,0.0,1.0
24684,71825,645,0,645,0.0,1.0
24685,71826,1315,0,1315,0.0,1.0
24686,71827,817,0,817,0.0,1.0
24687,71832,11253,6209,5044,0.552,0.448
24688,71833,2280,0,2280,0.0,1.0
24689,71834,1491,0,1491,0.0,1.0
24690,71835,1334,0,1334,0.0,1.0
24691,71836,2856,0,2856,0.0,1.0
24692,71837,5227,0,5227,0.0,1.0
24693,71838,1148,0,1148,0.0,1.0
24694,71839,280,0,280,0.0,1.0
24695,71841,913,0,913,0.0,1.0
24696,71842,2241,0,2241,0.0,1.0
24697,71845,2387,0,2387,0.0,1.0
24698,71846,2652,0,2652,0.0,1.0
24699,71847,673,0,673,0.0,1.0
24700,71851,2241,0,2241,0.0,1.0
24701,71852,10102,4488,5614,0.444,0.556
24702,71853,365,0,365,0.0,1.0
24703,71854,36438,26072,10366,0.716,0.284
24704,71855,708,0,708,0.0,1.0
24705,71857,5894,2773,3121,0.47,0.53
24706,71858,1710,0,1710,0.0,1.0
24707,71859,477,0,477,0.0,1.0
24708,71860,2633,0,2633,0.0,1.0
24709,71861,2258,0,2258,0.0,1.0
24710,71862,771,0,771,0.0,1.0
24711,71865,194,163,31,0.84,0.16
24712,71866,725,0,725,0.0,1.0
24713,71901,29491,22969,6522,0.779,0.221
24714,71909,15508,9133,6375,0.589,0.411
24715,71913,43436,32152,11284,0.74,0.26
24716,71921,3652,0,3652,0.0,1.0
24717,71922,129,0,129,0.0,1.0
24718,71923,15637,9464,6173,0.605,0.395
24719,71929,4487,0,4487,0.0,1.0
24720,71933,1616,0,1616,0.0,1.0
24721,71935,808,0,808,0.0,1.0
24722,71937,2026,0,2026,0.0,1.0
24723,71940,1652,0,1652,0.0,1.0
24724,71941,2098,0,2098,0.0,1.0
24725,71943,4821,0,4821,0.0,1.0
24726,71944,773,0,773,0.0,1.0
24727,71945,1437,0,1437,0.0,1.0
24728,71949,1989,0,1989,0.0,1.0
24729,71950,875,0,875,0.0,1.0
24730,71952,145,0,145,0.0,1.0
24731,71953,14882,5499,9383,0.37,0.63
24732,71956,1882,0,1882,0.0,1.0
24733,71957,3133,0,3133,0.0,1.0
24734,71958,2525,0,2525,0.0,1.0
24735,71959,754,0,754,0.0,1.0
24736,71960,1383,0,1383,0.0,1.0
24737,71961,1003,0,1003,0.0,1.0
24738,71962,792,0,792,0.0,1.0
24739,71964,3926,0,3926,0.0,1.0
24740,71965,315,0,315,0.0,1.0
24741,71968,4717,0,4717,0.0,1.0
24742,71969,376,0,376,0.0,1.0
24743,71970,792,0,792,0.0,1.0
24744,71971,513,0,513,0.0,1.0
24745,71972,309,0,309,0.0,1.0
24746,71973,1424,0,1424,0.0,1.0
24747,71998,321,321,0,1.0,0.0
24748,71999,706,706,0,1.0,0.0
24749,72001,566,0,566,0.0,1.0
24750,72002,14134,6592,7542,0.466,0.534
24751,72003,746,0,746,0.0,1.0
24752,72004,1311,0,1311,0.0,1.0
24753,72005,248,0,248,0.0,1.0
24754,72006,2603,0,2603,0.0,1.0
24755,72007,6708,2085,4623,0.311,0.689
24756,72010,6577,2517,4060,0.383,0.617
24757,72011,4074,379,3695,0.093,0.907
24758,72012,11986,6714,5272,0.56,0.44
24759,72013,2197,0,2197,0.0,1.0
24760,72014,60,0,60,0.0,1.0
24761,72015,27307,24091,3216,0.882,0.118
24762,72016,3268,0,3268,0.0,1.0
24763,72017,726,0,726,0.0,1.0
24764,72019,23346,16753,6593,0.718,0.282
24765,72020,4295,0,4295,0.0,1.0
24766,72021,4348,2528,1820,0.581,0.419
24767,72022,14270,14236,34,0.998,0.002
24768,72023,35026,24966,10060,0.713,0.287
24769,72024,3777,0,3777,0.0,1.0
24770,72025,847,0,847,0.0,1.0
24771,72026,393,0,393,0.0,1.0
24772,72027,1417,0,1417,0.0,1.0
24773,72029,1912,0,1912,0.0,1.0
24774,72030,705,0,705,0.0,1.0
24775,72031,7683,0,7683,0.0,1.0
24776,72032,31436,19565,11871,0.622,0.378
24777,72034,44723,42128,2595,0.942,0.058
24778,72035,1083,1083,0,1.0,0.0
24779,72036,817,0,817,0.0,1.0
24780,72037,28,0,28,0.0,1.0
24781,72038,74,0,74,0.0,1.0
24782,72039,2131,0,2131,0.0,1.0
24783,72040,2867,0,2867,0.0,1.0
24784,72041,1457,0,1457,0.0,1.0
24785,72042,5161,3185,1976,0.617,0.383
24786,72044,881,0,881,0.0,1.0
24787,72045,1151,0,1151,0.0,1.0
24788,72046,4470,2762,1708,0.618,0.382
24789,72047,969,0,969,0.0,1.0
24790,72048,114,0,114,0.0,1.0
24791,72051,622,0,622,0.0,1.0
24792,72055,849,0,849,0.0,1.0
24793,72057,1070,0,1070,0.0,1.0
24794,72058,15911,4069,11842,0.256,0.744
24795,72059,37,0,37,0.0,1.0
24796,72060,666,0,666,0.0,1.0
24797,72061,250,0,250,0.0,1.0
24798,72063,1683,0,1683,0.0,1.0
24799,72064,2451,0,2451,0.0,1.0
24800,72065,5207,0,5207,0.0,1.0
24801,72067,2726,0,2726,0.0,1.0
24802,72068,424,320,104,0.755,0.245
24803,72069,1369,0,1369,0.0,1.0
24804,72070,1813,0,1813,0.0,1.0
24805,72072,544,0,544,0.0,1.0
24806,72073,1139,0,1139,0.0,1.0
24807,72074,167,0,167,0.0,1.0
24808,72076,37979,29856,8123,0.786,0.214
24809,72079,786,0,786,0.0,1.0
24810,72080,662,0,662,0.0,1.0
24811,72081,7798,1182,6616,0.152,0.848
24812,72082,1935,1744,191,0.901,0.099
24813,72083,237,0,237,0.0,1.0
24814,72084,1229,0,1229,0.0,1.0
24815,72085,220,0,220,0.0,1.0
24816,72086,10727,4058,6669,0.378,0.622
24817,72087,2051,11,2040,0.005,0.995
24818,72088,2391,0,2391,0.0,1.0
24819,72099,616,616,0,1.0,0.0
24820,72101,3378,0,3378,0.0,1.0
24821,72102,2873,0,2873,0.0,1.0
24822,72103,13078,6245,6833,0.478,0.522
24823,72104,23354,11186,12168,0.479,0.521
24824,72106,5376,2501,2875,0.465,0.535
24825,72107,339,0,339,0.0,1.0
24826,72108,73,0,73,0.0,1.0
24827,72110,11498,6272,5226,0.545,0.455
24828,72111,1362,0,1362,0.0,1.0
24829,72112,11467,6288,5179,0.548,0.452
24830,72113,21273,18864,2409,0.887,0.113
24831,72114,12658,12658,0,1.0,0.0
24832,72116,21431,21431,0,1.0,0.0
24833,72117,12684,9966,2718,0.786,0.214
24834,72118,22592,19196,3396,0.85,0.15
24835,72119,5,0,5,0.0,1.0
24836,72120,31610,28451,3159,0.9,0.1
24837,72121,2704,0,2704,0.0,1.0
24838,72122,927,0,927,0.0,1.0
24839,72123,450,0,450,0.0,1.0
24840,72125,905,0,905,0.0,1.0
24841,72126,3674,0,3674,0.0,1.0
24842,72127,2149,0,2149,0.0,1.0
24843,72128,814,0,814,0.0,1.0
24844,72129,1409,0,1409,0.0,1.0
24845,72130,560,0,560,0.0,1.0
24846,72131,4631,0,4631,0.0,1.0
24847,72132,3242,0,3242,0.0,1.0
24848,72134,315,0,315,0.0,1.0
24849,72135,2623,0,2623,0.0,1.0
24850,72136,1772,0,1772,0.0,1.0
24851,72137,2555,0,2555,0.0,1.0
24852,72139,216,0,216,0.0,1.0
24853,72140,305,0,305,0.0,1.0
24854,72141,625,0,625,0.0,1.0
24855,72142,2499,0,2499,0.0,1.0
24856,72143,35169,22733,12436,0.646,0.354
24857,72149,0,0,0,,
24858,72150,12006,4458,7548,0.371,0.629
24859,72152,429,0,429,0.0,1.0
24860,72153,2572,0,2572,0.0,1.0
24861,72156,639,0,639,0.0,1.0
24862,72157,1607,0,1607,0.0,1.0
24863,72160,10736,9233,1503,0.86,0.14
24864,72165,111,0,111,0.0,1.0
24865,72166,260,0,260,0.0,1.0
24866,72167,1719,0,1719,0.0,1.0
24867,72168,1834,0,1834,0.0,1.0
24868,72169,203,0,203,0.0,1.0
24869,72170,202,0,202,0.0,1.0
24870,72173,9078,0,9078,0.0,1.0
24871,72175,354,0,354,0.0,1.0
24872,72176,8141,4032,4109,0.495,0.505
24873,72179,450,0,450,0.0,1.0
24874,72181,62,0,62,0.0,1.0
24875,72201,1024,1024,0,1.0,0.0
24876,72202,9978,9978,0,1.0,0.0
24877,72204,32505,32163,342,0.989,0.011
24878,72205,23000,23000,0,1.0,0.0
24879,72206,25624,12968,12656,0.506,0.494
24880,72207,10344,10344,0,1.0,0.0
24881,72209,32376,32121,255,0.992,0.008
24882,72210,14258,8609,5649,0.604,0.396
24883,72211,21288,21149,139,0.993,0.007
24884,72212,12705,12705,0,1.0,0.0
24885,72223,19890,15448,4442,0.777,0.223
24886,72227,11462,11462,0,1.0,0.0
24887,72301,26069,26045,24,0.999,0.001
24888,72311,135,0,135,0.0,1.0
24889,72315,23966,18219,5747,0.76,0.24
24890,72320,1847,0,1847,0.0,1.0
24891,72321,154,0,154,0.0,1.0
24892,72322,195,0,195,0.0,1.0
24893,72324,1978,0,1978,0.0,1.0
24894,72325,43,0,43,0.0,1.0
24895,72326,2267,0,2267,0.0,1.0
24896,72327,1732,0,1732,0.0,1.0
24897,72328,64,0,64,0.0,1.0
24898,72329,80,0,80,0.0,1.0
24899,72330,756,0,756,0.0,1.0
24900,72331,3184,0,3184,0.0,1.0
24901,72332,104,0,104,0.0,1.0
24902,72333,667,0,667,0.0,1.0
24903,72335,20121,13690,6431,0.68,0.32
24904,72338,52,0,52,0.0,1.0
24905,72339,204,0,204,0.0,1.0
24906,72340,90,0,90,0.0,1.0
24907,72341,222,0,222,0.0,1.0
24908,72342,5532,3505,2027,0.634,0.366
24909,72346,697,0,697,0.0,1.0
24910,72347,711,0,711,0.0,1.0
24911,72348,2594,0,2594,0.0,1.0
24912,72350,1226,0,1226,0.0,1.0
24913,72351,835,0,835,0.0,1.0
24914,72353,114,0,114,0.0,1.0
24915,72354,2470,0,2470,0.0,1.0
24916,72355,2768,0,2768,0.0,1.0
24917,72358,1690,1175,515,0.695,0.305
24918,72359,430,0,430,0.0,1.0
24919,72360,6466,3804,2662,0.588,0.412
24920,72364,15831,14225,1606,0.899,0.101
24921,72365,3146,0,3146,0.0,1.0
24922,72366,2543,0,2543,0.0,1.0
24923,72367,108,0,108,0.0,1.0
24924,72368,1228,0,1228,0.0,1.0
24925,72370,8606,7105,1501,0.826,0.174
24926,72372,1945,0,1945,0.0,1.0
24927,72373,1329,0,1329,0.0,1.0
24928,72374,876,0,876,0.0,1.0
24929,72376,1977,0,1977,0.0,1.0
24930,72377,36,0,36,0.0,1.0
24931,72379,50,0,50,0.0,1.0
24932,72383,53,0,53,0.0,1.0
24933,72384,953,0,953,0.0,1.0
24934,72386,1777,0,1777,0.0,1.0
24935,72389,204,0,204,0.0,1.0
24936,72390,9107,7816,1291,0.858,0.142
24937,72392,481,0,481,0.0,1.0
24938,72394,625,0,625,0.0,1.0
24939,72395,1017,0,1017,0.0,1.0
24940,72396,13734,7722,6012,0.562,0.438
24941,72401,53767,45895,7872,0.854,0.146
24942,72404,23482,17491,5991,0.745,0.255
24943,72410,498,0,498,0.0,1.0
24944,72411,2294,0,2294,0.0,1.0
24945,72412,633,0,633,0.0,1.0
24946,72413,598,0,598,0.0,1.0
24947,72414,443,0,443,0.0,1.0
24948,72415,1346,0,1346,0.0,1.0
24949,72416,5783,326,5457,0.056,0.944
24950,72417,3568,1404,2164,0.393,0.607
24951,72419,1748,0,1748,0.0,1.0
24952,72421,554,0,554,0.0,1.0
24953,72422,4979,3180,1799,0.639,0.361
24954,72424,94,0,94,0.0,1.0
24955,72425,446,0,446,0.0,1.0
24956,72426,196,0,196,0.0,1.0
24957,72427,174,0,174,0.0,1.0
24958,72428,95,0,95,0.0,1.0
24959,72429,427,0,427,0.0,1.0
24960,72430,411,0,411,0.0,1.0
24961,72431,401,0,401,0.0,1.0
24962,72432,6462,0,6462,0.0,1.0
24963,72433,3067,1874,1193,0.611,0.389
24964,72434,2108,0,2108,0.0,1.0
24965,72435,505,0,505,0.0,1.0
24966,72436,942,0,942,0.0,1.0
24967,72437,3272,0,3272,0.0,1.0
24968,72438,2574,0,2574,0.0,1.0
24969,72440,255,0,255,0.0,1.0
24970,72441,94,0,94,0.0,1.0
24971,72442,4886,3124,1762,0.639,0.361
24972,72443,2986,0,2986,0.0,1.0
24973,72444,1821,0,1821,0.0,1.0
24974,72445,91,0,91,0.0,1.0
24975,72447,1964,0,1964,0.0,1.0
24976,72449,213,0,213,0.0,1.0
24977,72450,36033,24620,11413,0.683,0.317
24978,72453,198,0,198,0.0,1.0
24979,72454,5127,3437,1690,0.67,0.33
24980,72455,12518,5854,6664,0.468,0.532
24981,72456,585,0,585,0.0,1.0
24982,72457,132,0,132,0.0,1.0
24983,72458,755,0,755,0.0,1.0
24984,72459,1329,0,1329,0.0,1.0
24985,72460,832,0,832,0.0,1.0
24986,72461,3789,0,3789,0.0,1.0
24987,72462,408,0,408,0.0,1.0
24988,72464,98,0,98,0.0,1.0
24989,72466,1481,0,1481,0.0,1.0
24990,72467,303,303,0,1.0,0.0
24991,72469,1124,0,1124,0.0,1.0
24992,72470,319,0,319,0.0,1.0
24993,72471,1108,0,1108,0.0,1.0
24994,72472,9447,7095,2352,0.751,0.249
24995,72473,2376,0,2376,0.0,1.0
24996,72476,7155,4472,2683,0.625,0.375
24997,72478,390,0,390,0.0,1.0
24998,72479,1489,0,1489,0.0,1.0
24999,72482,1241,0,1241,0.0,1.0
25000,72501,25099,11327,13772,0.451,0.549
25001,72512,2234,0,2234,0.0,1.0
25002,72513,2856,0,2856,0.0,1.0
25003,72515,63,0,63,0.0,1.0
25004,72517,487,0,487,0.0,1.0
25005,72519,3150,0,3150,0.0,1.0
25006,72520,309,0,309,0.0,1.0
25007,72521,4814,0,4814,0.0,1.0
25008,72522,405,0,405,0.0,1.0
25009,72523,1091,0,1091,0.0,1.0
25010,72524,376,0,376,0.0,1.0
25011,72526,154,0,154,0.0,1.0
25012,72527,583,186,397,0.319,0.681
25013,72528,65,0,65,0.0,1.0
25014,72529,4726,3241,1485,0.686,0.314
25015,72530,1987,0,1987,0.0,1.0
25016,72531,800,0,800,0.0,1.0
25017,72532,1712,0,1712,0.0,1.0
25018,72533,416,0,416,0.0,1.0
25019,72534,1320,0,1320,0.0,1.0
25020,72536,429,0,429,0.0,1.0
25021,72537,805,0,805,0.0,1.0
25022,72538,432,0,432,0.0,1.0
25023,72539,253,0,253,0.0,1.0
25024,72540,149,0,149,0.0,1.0
25025,72542,3826,202,3624,0.053,0.947
25026,72543,12535,6357,6178,0.507,0.493
25027,72544,636,0,636,0.0,1.0
25028,72546,181,0,181,0.0,1.0
25029,72550,985,0,985,0.0,1.0
25030,72553,69,0,69,0.0,1.0
25031,72554,2923,867,2056,0.297,0.703
25032,72555,182,0,182,0.0,1.0
25033,72556,3375,0,3375,0.0,1.0
25034,72560,8754,0,8754,0.0,1.0
25035,72561,981,0,981,0.0,1.0
25036,72562,2238,0,2238,0.0,1.0
25037,72564,546,0,546,0.0,1.0
25038,72565,999,0,999,0.0,1.0
25039,72566,624,0,624,0.0,1.0
25040,72567,262,0,262,0.0,1.0
25041,72568,1662,0,1662,0.0,1.0
25042,72569,468,0,468,0.0,1.0
25043,72571,369,0,369,0.0,1.0
25044,72572,228,0,228,0.0,1.0
25045,72573,278,0,278,0.0,1.0
25046,72576,3868,0,3868,0.0,1.0
25047,72577,700,0,700,0.0,1.0
25048,72578,212,0,212,0.0,1.0
25049,72579,1287,0,1287,0.0,1.0
25050,72581,1030,0,1030,0.0,1.0
25051,72583,1679,0,1679,0.0,1.0
25052,72584,568,0,568,0.0,1.0
25053,72585,216,0,216,0.0,1.0
25054,72587,134,0,134,0.0,1.0
25055,72601,30163,13950,16213,0.462,0.538
25056,72611,1696,0,1696,0.0,1.0
25057,72616,10441,4800,5641,0.46,0.54
25058,72617,198,0,198,0.0,1.0
25059,72619,1936,0,1936,0.0,1.0
25060,72623,648,0,648,0.0,1.0
25061,72624,594,0,594,0.0,1.0
25062,72626,1243,0,1243,0.0,1.0
25063,72628,803,0,803,0.0,1.0
25064,72629,629,0,629,0.0,1.0
25065,72630,197,0,197,0.0,1.0
25066,72631,3709,0,3709,0.0,1.0
25067,72632,4449,0,4449,0.0,1.0
25068,72633,1833,0,1833,0.0,1.0
25069,72634,4670,0,4670,0.0,1.0
25070,72635,3624,0,3624,0.0,1.0
25071,72636,24,0,24,0.0,1.0
25072,72638,7186,2656,4530,0.37,0.63
25073,72639,683,0,683,0.0,1.0
25074,72640,385,0,385,0.0,1.0
25075,72641,2585,0,2585,0.0,1.0
25076,72642,1979,0,1979,0.0,1.0
25077,72644,2268,0,2268,0.0,1.0
25078,72645,1867,0,1867,0.0,1.0
25079,72648,716,0,716,0.0,1.0
25080,72650,4362,0,4362,0.0,1.0
25081,72651,1206,0,1206,0.0,1.0
25082,72653,28560,14180,14380,0.496,0.504
25083,72655,457,0,457,0.0,1.0
25084,72658,1685,0,1685,0.0,1.0
25085,72660,524,0,524,0.0,1.0
25086,72661,580,0,580,0.0,1.0
25087,72662,2986,0,2986,0.0,1.0
25088,72663,361,0,361,0.0,1.0
25089,72666,275,0,275,0.0,1.0
25090,72668,521,0,521,0.0,1.0
25091,72669,107,0,107,0.0,1.0
25092,72670,99,0,99,0.0,1.0
25093,72672,279,0,279,0.0,1.0
25094,72675,1399,0,1399,0.0,1.0
25095,72677,525,0,525,0.0,1.0
25096,72679,48,0,48,0.0,1.0
25097,72680,807,0,807,0.0,1.0
25098,72682,194,0,194,0.0,1.0
25099,72683,211,0,211,0.0,1.0
25100,72685,1365,0,1365,0.0,1.0
25101,72686,182,0,182,0.0,1.0
25102,72687,6461,0,6461,0.0,1.0
25103,72701,39782,33768,6014,0.849,0.151
25104,72703,28261,24722,3539,0.875,0.125
25105,72704,21336,15831,5505,0.742,0.258
25106,72712,40933,34538,6395,0.844,0.156
25107,72714,11880,10883,997,0.916,0.084
25108,72715,15051,12425,2626,0.826,0.174
25109,72717,1071,0,1071,0.0,1.0
25110,72718,1465,848,617,0.579,0.421
25111,72719,8975,8687,288,0.968,0.032
25112,72721,391,0,391,0.0,1.0
25113,72722,3138,0,3138,0.0,1.0
25114,72727,5658,1274,4384,0.225,0.775
25115,72729,280,0,280,0.0,1.0
25116,72730,7585,5183,2402,0.683,0.317
25117,72732,4716,0,4716,0.0,1.0
25118,72734,7322,3157,4165,0.431,0.569
25119,72736,6208,0,6208,0.0,1.0
25120,72738,2419,0,2419,0.0,1.0
25121,72739,473,0,473,0.0,1.0
25122,72740,9543,0,9543,0.0,1.0
25123,72742,545,0,545,0.0,1.0
25124,72744,5343,0,5343,0.0,1.0
25125,72745,11376,6968,4408,0.613,0.387
25126,72747,152,0,152,0.0,1.0
25127,72749,84,0,84,0.0,1.0
25128,72751,6434,4422,2012,0.687,0.313
25129,72752,293,0,293,0.0,1.0
25130,72753,7936,3398,4538,0.428,0.572
25131,72756,38455,29272,9183,0.761,0.239
25132,72758,33487,31505,1982,0.941,0.059
25133,72760,342,0,342,0.0,1.0
25134,72761,21211,15493,5718,0.73,0.27
25135,72762,35342,29685,5657,0.84,0.16
25136,72764,50230,44885,5345,0.894,0.106
25137,72768,1306,0,1306,0.0,1.0
25138,72769,1162,0,1162,0.0,1.0
25139,72773,953,0,953,0.0,1.0
25140,72774,6121,0,6121,0.0,1.0
25141,72776,574,0,574,0.0,1.0
25142,72801,18685,18685,0,1.0,0.0
25143,72802,20973,9321,11652,0.444,0.556
25144,72821,2048,0,2048,0.0,1.0
25145,72823,6765,0,6765,0.0,1.0
25146,72824,1876,0,1876,0.0,1.0
25147,72826,47,0,47,0.0,1.0
25148,72827,187,0,187,0.0,1.0
25149,72828,114,0,114,0.0,1.0
25150,72830,14896,7313,7583,0.491,0.509
25151,72832,923,0,923,0.0,1.0
25152,72833,4384,0,4384,0.0,1.0
25153,72834,10565,4631,5934,0.438,0.562
25154,72835,923,0,923,0.0,1.0
25155,72837,7845,0,7845,0.0,1.0
25156,72838,115,0,115,0.0,1.0
25157,72839,242,0,242,0.0,1.0
25158,72840,2149,0,2149,0.0,1.0
25159,72841,227,0,227,0.0,1.0
25160,72842,1478,0,1478,0.0,1.0
25161,72843,2274,0,2274,0.0,1.0
25162,72845,1216,0,1216,0.0,1.0
25163,72846,3913,0,3913,0.0,1.0
25164,72847,2850,0,2850,0.0,1.0
25165,72851,572,0,572,0.0,1.0
25166,72852,315,0,315,0.0,1.0
25167,72853,2217,0,2217,0.0,1.0
25168,72854,703,0,703,0.0,1.0
25169,72855,6314,3143,3171,0.498,0.502
25170,72856,464,0,464,0.0,1.0
25171,72857,1430,0,1430,0.0,1.0
25172,72858,3178,96,3082,0.03,0.97
25173,72860,375,0,375,0.0,1.0
25174,72863,1582,0,1582,0.0,1.0
25175,72865,1366,0,1366,0.0,1.0
25176,72901,21591,21591,0,1.0,0.0
25177,72903,26148,26121,27,0.999,0.001
25178,72904,21893,21499,394,0.982,0.018
25179,72908,13378,13366,12,0.999,0.001
25180,72916,7131,3566,3565,0.5,0.5
25181,72921,13787,5277,8510,0.383,0.617
25182,72923,4735,4727,8,0.998,0.002
25183,72926,545,0,545,0.0,1.0
25184,72927,8701,3335,5366,0.383,0.617
25185,72928,755,0,755,0.0,1.0
25186,72930,320,0,320,0.0,1.0
25187,72932,1597,0,1597,0.0,1.0
25188,72933,4999,0,4999,0.0,1.0
25189,72934,1047,0,1047,0.0,1.0
25190,72935,577,0,577,0.0,1.0
25191,72936,14527,8704,5823,0.599,0.401
25192,72937,3858,0,3858,0.0,1.0
25193,72938,1391,0,1391,0.0,1.0
25194,72940,2515,0,2515,0.0,1.0
25195,72941,5251,0,5251,0.0,1.0
25196,72943,2646,0,2646,0.0,1.0
25197,72944,2919,0,2919,0.0,1.0
25198,72945,314,0,314,0.0,1.0
25199,72946,3654,0,3654,0.0,1.0
25200,72947,4433,0,4433,0.0,1.0
25201,72948,518,0,518,0.0,1.0
25202,72949,10177,3153,7024,0.31,0.69
25203,72950,409,0,409,0.0,1.0
25204,72951,988,0,988,0.0,1.0
25205,72952,2945,0,2945,0.0,1.0
25206,72955,438,0,438,0.0,1.0
25207,72956,34074,24482,9592,0.718,0.282
25208,72958,8117,3330,4787,0.41,0.59
25209,72959,2786,0,2786,0.0,1.0
25210,73002,1062,0,1062,0.0,1.0
25211,73003,20617,20352,265,0.987,0.013
25212,73004,857,0,857,0.0,1.0
25213,73005,9541,5929,3612,0.621,0.379
25214,73006,3718,0,3718,0.0,1.0
25215,73007,2178,173,2005,0.079,0.921
25216,73008,19800,19800,0,1.0,0.0
25217,73009,1264,0,1264,0.0,1.0
25218,73010,17563,4683,12880,0.267,0.733
25219,73011,416,0,416,0.0,1.0
25220,73012,25851,23075,2776,0.893,0.107
25221,73013,43933,41283,2650,0.94,0.06
25222,73014,1431,0,1431,0.0,1.0
25223,73015,2877,0,2877,0.0,1.0
25224,73016,1850,0,1850,0.0,1.0
25225,73017,1780,0,1780,0.0,1.0
25226,73018,19936,15739,4197,0.789,0.211
25227,73019,0,0,0,,
25228,73020,20810,11447,9363,0.55,0.45
25229,73021,352,0,352,0.0,1.0
25230,73024,637,0,637,0.0,1.0
25231,73025,11579,7863,3716,0.679,0.321
25232,73026,10437,129,10308,0.012,0.988
25233,73027,1493,0,1493,0.0,1.0
25234,73028,3454,0,3454,0.0,1.0
25235,73029,1818,0,1818,0.0,1.0
25236,73030,4464,2591,1873,0.58,0.42
25237,73032,222,0,222,0.0,1.0
25238,73033,387,0,387,0.0,1.0
25239,73034,39872,36549,3323,0.917,0.083
25240,73036,18595,15069,3526,0.81,0.19
25241,73038,2032,0,2032,0.0,1.0
25242,73040,1976,0,1976,0.0,1.0
25243,73041,366,0,366,0.0,1.0
25244,73042,1073,0,1073,0.0,1.0
25245,73043,125,0,125,0.0,1.0
25246,73044,20226,8810,11416,0.436,0.564
25247,73045,10378,3857,6521,0.372,0.628
25248,73047,4774,0,4774,0.0,1.0
25249,73048,2020,42,1978,0.021,0.979
25250,73049,5910,1316,4594,0.223,0.777
25251,73050,1370,0,1370,0.0,1.0
25252,73051,10264,2059,8205,0.201,0.799
25253,73052,6315,2796,3519,0.443,0.557
25254,73053,745,0,745,0.0,1.0
25255,73054,4189,0,4189,0.0,1.0
25256,73055,9942,4230,5712,0.425,0.575
25257,73056,441,0,441,0.0,1.0
25258,73057,2384,0,2384,0.0,1.0
25259,73058,332,0,332,0.0,1.0
25260,73059,2924,0,2924,0.0,1.0
25261,73061,1596,0,1596,0.0,1.0
25262,73062,1396,0,1396,0.0,1.0
25263,73063,691,0,691,0.0,1.0
25264,73064,20611,16984,3627,0.824,0.176
25265,73065,6546,19,6527,0.003,0.997
25266,73066,417,357,60,0.856,0.144
25267,73067,2161,0,2161,0.0,1.0
25268,73068,11707,5074,6633,0.433,0.567
25269,73069,23912,23393,519,0.978,0.022
25270,73071,36711,36147,564,0.985,0.015
25271,73072,42797,39480,3317,0.922,0.078
25272,73073,541,0,541,0.0,1.0
25273,73074,1190,0,1190,0.0,1.0
25274,73075,9519,5835,3684,0.613,0.387
25275,73077,7135,5052,2083,0.708,0.292
25276,73078,7786,98,7688,0.013,0.987
25277,73079,643,0,643,0.0,1.0
25278,73080,9276,4818,4458,0.519,0.481
25279,73082,2980,0,2980,0.0,1.0
25280,73084,6518,4646,1872,0.713,0.287
25281,73086,8345,4733,3612,0.567,0.433
25282,73089,11522,1249,10273,0.108,0.892
25283,73090,1198,0,1198,0.0,1.0
25284,73092,908,0,908,0.0,1.0
25285,73093,2612,0,2612,0.0,1.0
25286,73095,1895,0,1895,0.0,1.0
25287,73096,13037,10671,2366,0.819,0.181
25288,73097,187,35,152,0.187,0.813
25289,73098,4227,0,4227,0.0,1.0
25290,73099,57492,51526,5966,0.896,0.104
25291,73102,3858,3858,0,1.0,0.0
25292,73103,4315,4315,0,1.0,0.0
25293,73104,1664,1664,0,1.0,0.0
25294,73105,5210,5210,0,1.0,0.0
25295,73106,13581,13581,0,1.0,0.0
25296,73107,26561,26561,0,1.0,0.0
25297,73108,15350,15350,0,1.0,0.0
25298,73109,20594,20594,0,1.0,0.0
25299,73110,32666,32664,2,1.0,0.0
25300,73111,11781,11668,113,0.99,0.01
25301,73112,30943,30943,0,1.0,0.0
25302,73114,17422,17257,165,0.991,0.009
25303,73115,20541,20541,0,1.0,0.0
25304,73116,9241,9241,0,1.0,0.0
25305,73117,5191,5191,0,1.0,0.0
25306,73118,13571,13571,0,1.0,0.0
25307,73119,31347,31347,0,1.0,0.0
25308,73120,34824,34824,0,1.0,0.0
25309,73121,3053,1845,1208,0.604,0.396
25310,73122,13164,13164,0,1.0,0.0
25311,73127,24077,24077,0,1.0,0.0
25312,73128,4200,4072,128,0.97,0.03
25313,73129,20126,20126,0,1.0,0.0
25314,73130,19439,19401,38,0.998,0.002
25315,73131,3145,2094,1051,0.666,0.334
25316,73132,26432,26432,0,1.0,0.0
25317,73134,4312,4189,123,0.971,0.029
25318,73135,20529,20529,0,1.0,0.0
25319,73139,17253,17253,0,1.0,0.0
25320,73141,2727,2295,432,0.842,0.158
25321,73142,10707,10534,173,0.984,0.016
25322,73145,2859,2859,0,1.0,0.0
25323,73149,4643,4643,0,1.0,0.0
25324,73150,4609,1069,3540,0.232,0.768
25325,73151,1446,1040,406,0.719,0.281
25326,73159,30350,30350,0,1.0,0.0
25327,73160,53666,53016,650,0.988,0.012
25328,73162,27758,27758,0,1.0,0.0
25329,73165,5809,1710,4099,0.294,0.706
25330,73169,1782,1181,601,0.663,0.337
25331,73170,35343,34510,833,0.976,0.024
25332,73173,1299,0,1299,0.0,1.0
25333,73179,3082,2577,505,0.836,0.164
25334,73401,34927,20888,14039,0.598,0.402
25335,73425,84,0,84,0.0,1.0
25336,73430,1176,0,1176,0.0,1.0
25337,73432,974,0,974,0.0,1.0
25338,73433,2761,0,2761,0.0,1.0
25339,73434,699,0,699,0.0,1.0
25340,73437,107,0,107,0.0,1.0
25341,73438,3708,0,3708,0.0,1.0
25342,73439,7400,0,7400,0.0,1.0
25343,73440,398,0,398,0.0,1.0
25344,73441,165,0,165,0.0,1.0
25345,73442,428,0,428,0.0,1.0
25346,73443,3585,0,3585,0.0,1.0
25347,73444,156,0,156,0.0,1.0
25348,73446,8042,4419,3623,0.549,0.451
25349,73447,1205,0,1205,0.0,1.0
25350,73448,5784,0,5784,0.0,1.0
25351,73449,2987,0,2987,0.0,1.0
25352,73450,1248,0,1248,0.0,1.0
25353,73453,661,0,661,0.0,1.0
25354,73455,673,0,673,0.0,1.0
25355,73456,2082,0,2082,0.0,1.0
25356,73458,952,0,952,0.0,1.0
25357,73459,1132,0,1132,0.0,1.0
25358,73460,4747,0,4747,0.0,1.0
25359,73461,795,0,795,0.0,1.0
25360,73463,3501,0,3501,0.0,1.0
25361,73481,978,0,978,0.0,1.0
25362,73487,232,0,232,0.0,1.0
25363,73491,721,0,721,0.0,1.0
25364,73501,20935,16369,4566,0.782,0.218
25365,73503,10996,10782,214,0.981,0.019
25366,73505,49809,48501,1308,0.974,0.026
25367,73507,22847,18805,4042,0.823,0.177
25368,73520,149,0,149,0.0,1.0
25369,73521,21636,19900,1736,0.92,0.08
25370,73526,2133,0,2133,0.0,1.0
25371,73527,5184,2600,2584,0.502,0.498
25372,73528,680,0,680,0.0,1.0
25373,73529,5344,0,5344,0.0,1.0
25374,73530,442,0,442,0.0,1.0
25375,73531,401,0,401,0.0,1.0
25376,73532,600,0,600,0.0,1.0
25377,73533,28434,21301,7133,0.749,0.251
25378,73537,643,0,643,0.0,1.0
25379,73538,4675,0,4675,0.0,1.0
25380,73539,218,0,218,0.0,1.0
25381,73540,439,0,439,0.0,1.0
25382,73541,3106,0,3106,0.0,1.0
25383,73542,4659,3899,760,0.837,0.163
25384,73543,1859,0,1859,0.0,1.0
25385,73544,268,0,268,0.0,1.0
25386,73546,1232,0,1232,0.0,1.0
25387,73547,2319,0,2319,0.0,1.0
25388,73548,519,0,519,0.0,1.0
25389,73549,296,0,296,0.0,1.0
25390,73550,2512,0,2512,0.0,1.0
25391,73551,65,0,65,0.0,1.0
25392,73552,1612,0,1612,0.0,1.0
25393,73553,46,0,46,0.0,1.0
25394,73554,3614,2954,660,0.817,0.183
25395,73555,214,0,214,0.0,1.0
25396,73556,166,0,166,0.0,1.0
25397,73557,427,0,427,0.0,1.0
25398,73559,540,0,540,0.0,1.0
25399,73560,829,0,829,0.0,1.0
25400,73562,772,0,772,0.0,1.0
25401,73564,551,0,551,0.0,1.0
25402,73565,1092,0,1092,0.0,1.0
25403,73566,1674,0,1674,0.0,1.0
25404,73567,860,0,860,0.0,1.0
25405,73568,1182,0,1182,0.0,1.0
25406,73569,537,0,537,0.0,1.0
25407,73570,1128,0,1128,0.0,1.0
25408,73571,87,0,87,0.0,1.0
25409,73572,3699,2506,1193,0.677,0.323
25410,73573,2551,0,2551,0.0,1.0
25411,73601,10299,8426,1873,0.818,0.182
25412,73620,1194,0,1194,0.0,1.0
25413,73622,266,0,266,0.0,1.0
25414,73624,2142,0,2142,0.0,1.0
25415,73625,554,0,554,0.0,1.0
25416,73626,1136,0,1136,0.0,1.0
25417,73627,628,0,628,0.0,1.0
25418,73628,1583,0,1583,0.0,1.0
25419,73632,3433,2876,557,0.838,0.162
25420,73638,142,0,142,0.0,1.0
25421,73639,602,0,602,0.0,1.0
25422,73641,762,0,762,0.0,1.0
25423,73642,187,0,187,0.0,1.0
25424,73644,14147,10855,3292,0.767,0.233
25425,73645,1538,0,1538,0.0,1.0
25426,73646,384,0,384,0.0,1.0
25427,73647,519,0,519,0.0,1.0
25428,73650,1020,0,1020,0.0,1.0
25429,73651,4268,3622,646,0.849,0.151
25430,73654,866,0,866,0.0,1.0
25431,73655,864,0,864,0.0,1.0
25432,73658,260,0,260,0.0,1.0
25433,73659,160,0,160,0.0,1.0
25434,73660,430,0,430,0.0,1.0
25435,73661,420,0,420,0.0,1.0
25436,73662,6093,4041,2052,0.663,0.337
25437,73663,1332,0,1332,0.0,1.0
25438,73664,1184,0,1184,0.0,1.0
25439,73666,180,0,180,0.0,1.0
25440,73667,517,0,517,0.0,1.0
25441,73669,1675,0,1675,0.0,1.0
25442,73673,319,0,319,0.0,1.0
25443,73701,24808,22547,2261,0.909,0.091
25444,73703,27951,24795,3156,0.887,0.113
25445,73705,267,267,0,1.0,0.0
25446,73716,510,0,510,0.0,1.0
25447,73717,6846,5620,1226,0.821,0.179
25448,73718,501,0,501,0.0,1.0
25449,73719,83,0,83,0.0,1.0
25450,73720,265,0,265,0.0,1.0
25451,73722,427,0,427,0.0,1.0
25452,73724,1190,0,1190,0.0,1.0
25453,73726,472,0,472,0.0,1.0
25454,73727,267,0,267,0.0,1.0
25455,73728,1861,0,1861,0.0,1.0
25456,73729,578,0,578,0.0,1.0
25457,73730,734,0,734,0.0,1.0
25458,73731,171,0,171,0.0,1.0
25459,73733,221,0,221,0.0,1.0
25460,73734,1067,0,1067,0.0,1.0
25461,73735,684,0,684,0.0,1.0
25462,73736,356,0,356,0.0,1.0
25463,73737,3367,0,3367,0.0,1.0
25464,73738,1134,0,1134,0.0,1.0
25465,73739,369,0,369,0.0,1.0
25466,73741,1614,0,1614,0.0,1.0
25467,73742,3824,0,3824,0.0,1.0
25468,73743,122,0,122,0.0,1.0
25469,73744,267,0,267,0.0,1.0
25470,73746,37,0,37,0.0,1.0
25471,73747,285,0,285,0.0,1.0
25472,73749,448,0,448,0.0,1.0
25473,73750,7025,4144,2881,0.59,0.41
25474,73753,468,0,468,0.0,1.0
25475,73754,1078,0,1078,0.0,1.0
25476,73755,905,0,905,0.0,1.0
25477,73756,352,0,352,0.0,1.0
25478,73757,178,0,178,0.0,1.0
25479,73758,197,0,197,0.0,1.0
25480,73759,1468,0,1468,0.0,1.0
25481,73760,470,0,470,0.0,1.0
25482,73761,395,0,395,0.0,1.0
25483,73762,2156,0,2156,0.0,1.0
25484,73763,1623,0,1623,0.0,1.0
25485,73764,144,0,144,0.0,1.0
25486,73766,1096,0,1096,0.0,1.0
25487,73768,1568,0,1568,0.0,1.0
25488,73771,495,0,495,0.0,1.0
25489,73772,6119,5084,1035,0.831,0.169
25490,73773,1744,0,1744,0.0,1.0
25491,73801,15228,11344,3884,0.745,0.255
25492,73832,929,0,929,0.0,1.0
25493,73834,1643,0,1643,0.0,1.0
25494,73835,309,0,309,0.0,1.0
25495,73838,462,0,462,0.0,1.0
25496,73840,691,0,691,0.0,1.0
25497,73841,1482,0,1482,0.0,1.0
25498,73842,494,0,494,0.0,1.0
25499,73843,883,0,883,0.0,1.0
25500,73844,269,0,269,0.0,1.0
25501,73848,2156,0,2156,0.0,1.0
25502,73851,80,0,80,0.0,1.0
25503,73852,2051,0,2051,0.0,1.0
25504,73853,379,0,379,0.0,1.0
25505,73855,106,0,106,0.0,1.0
25506,73857,623,0,623,0.0,1.0
25507,73858,1666,0,1666,0.0,1.0
25508,73859,1459,0,1459,0.0,1.0
25509,73860,1337,0,1337,0.0,1.0
25510,73901,156,0,156,0.0,1.0
25511,73931,510,0,510,0.0,1.0
25512,73932,2092,0,2092,0.0,1.0
25513,73933,1697,0,1697,0.0,1.0
25514,73937,173,0,173,0.0,1.0
25515,73938,781,0,781,0.0,1.0
25516,73939,1695,0,1695,0.0,1.0
25517,73942,12953,11338,1615,0.875,0.125
25518,73944,388,0,388,0.0,1.0
25519,73945,2889,0,2889,0.0,1.0
25520,73946,45,0,45,0.0,1.0
25521,73947,472,0,472,0.0,1.0
25522,73949,1688,0,1688,0.0,1.0
25523,73950,1736,0,1736,0.0,1.0
25524,73951,1141,0,1141,0.0,1.0
25525,74001,367,0,367,0.0,1.0
25526,74002,2333,0,2333,0.0,1.0
25527,74003,14249,12343,1906,0.866,0.134
25528,74006,25750,22931,2819,0.891,0.109
25529,74008,22461,17198,5263,0.766,0.234
25530,74010,10501,4110,6391,0.391,0.609
25531,74011,25448,23462,1986,0.922,0.078
25532,74012,57526,57516,10,1.0,0.0
25533,74014,34579,27980,6599,0.809,0.191
25534,74015,8064,4383,3681,0.544,0.456
25535,74016,6005,0,6005,0.0,1.0
25536,74017,28057,16285,11772,0.58,0.42
25537,74019,17648,9328,8320,0.529,0.471
25538,74020,7294,3128,4166,0.429,0.571
25539,74021,17359,11844,5515,0.682,0.318
25540,74022,1760,0,1760,0.0,1.0
25541,74023,11741,6742,4999,0.574,0.426
25542,74026,896,0,896,0.0,1.0
25543,74027,1015,0,1015,0.0,1.0
25544,74028,1881,0,1881,0.0,1.0
25545,74029,5128,3600,1528,0.702,0.298
25546,74030,3864,0,3864,0.0,1.0
25547,74032,2219,0,2219,0.0,1.0
25548,74033,10163,8928,1235,0.878,0.122
25549,74034,150,0,150,0.0,1.0
25550,74035,4565,3493,1072,0.765,0.235
25551,74036,6734,0,6734,0.0,1.0
25552,74037,15159,14489,670,0.956,0.044
25553,74038,2254,0,2254,0.0,1.0
25554,74039,3770,0,3770,0.0,1.0
25555,74041,2057,1629,428,0.792,0.208
25556,74042,540,0,540,0.0,1.0
25557,74044,7406,2986,4420,0.403,0.597
25558,74045,311,0,311,0.0,1.0
25559,74046,115,0,115,0.0,1.0
25560,74047,7163,285,6878,0.04,0.96
25561,74048,6092,3632,2460,0.596,0.404
25562,74050,323,312,11,0.966,0.034
25563,74051,1904,0,1904,0.0,1.0
25564,74052,1180,0,1180,0.0,1.0
25565,74053,4315,0,4315,0.0,1.0
25566,74054,844,0,844,0.0,1.0
25567,74055,38680,35794,2886,0.925,0.075
25568,74056,5720,3623,2097,0.633,0.367
25569,74058,4259,0,4259,0.0,1.0
25570,74059,5476,0,5476,0.0,1.0
25571,74060,586,0,586,0.0,1.0
25572,74061,2095,0,2095,0.0,1.0
25573,74062,1123,0,1123,0.0,1.0
25574,74063,29808,17875,11933,0.6,0.4
25575,74066,31060,19707,11353,0.634,0.366
25576,74068,111,0,111,0.0,1.0
25577,74070,13928,6768,7160,0.486,0.514
25578,74071,180,0,180,0.0,1.0
25579,74072,1816,800,1016,0.441,0.559
25580,74073,5118,1061,4057,0.207,0.793
25581,74074,29184,23295,5889,0.798,0.202
25582,74075,23866,18925,4941,0.793,0.207
25583,74078,2295,2295,0,1.0,0.0
25584,74079,4504,0,4504,0.0,1.0
25585,74080,2829,0,2829,0.0,1.0
25586,74081,1837,0,1837,0.0,1.0
25587,74082,107,0,107,0.0,1.0
25588,74083,1031,0,1031,0.0,1.0
25589,74084,628,0,628,0.0,1.0
25590,74085,2588,0,2588,0.0,1.0
25591,74103,2692,2692,0,1.0,0.0
25592,74104,12724,12724,0,1.0,0.0
25593,74105,26547,26547,0,1.0,0.0
25594,74106,17648,17648,0,1.0,0.0
25595,74107,19458,18213,1245,0.936,0.064
25596,74108,7490,6899,591,0.921,0.079
25597,74110,14862,14853,9,0.999,0.001
25598,74112,20684,20684,0,1.0,0.0
25599,74114,15778,15778,0,1.0,0.0
25600,74115,22941,22810,131,0.994,0.006
25601,74116,3890,3733,157,0.96,0.04
25602,74117,87,24,63,0.276,0.724
25603,74119,3561,3561,0,1.0,0.0
25604,74120,4940,4940,0,1.0,0.0
25605,74126,10598,9393,1205,0.886,0.114
25606,74127,17151,16402,749,0.956,0.044
25607,74128,12676,12676,0,1.0,0.0
25608,74129,18976,18976,0,1.0,0.0
25609,74130,2065,1879,186,0.91,0.09
25610,74131,2775,1965,810,0.708,0.292
25611,74132,7543,6975,568,0.925,0.075
25612,74133,43414,43414,0,1.0,0.0
25613,74134,15083,14819,264,0.982,0.018
25614,74135,20651,20651,0,1.0,0.0
25615,74136,30703,30703,0,1.0,0.0
25616,74137,25737,25737,0,1.0,0.0
25617,74145,17402,17402,0,1.0,0.0
25618,74146,15498,15498,0,1.0,0.0
25619,74301,11840,6002,5838,0.507,0.493
25620,74330,2884,0,2884,0.0,1.0
25621,74331,7258,0,7258,0.0,1.0
25622,74332,1972,0,1972,0.0,1.0
25623,74333,1221,0,1221,0.0,1.0
25624,74337,5060,0,5060,0.0,1.0
25625,74338,5480,409,5071,0.075,0.925
25626,74339,2606,2498,108,0.959,0.041
25627,74340,311,0,311,0.0,1.0
25628,74342,2927,0,2927,0.0,1.0
25629,74343,3100,0,3100,0.0,1.0
25630,74344,14412,7158,7254,0.497,0.503
25631,74346,7864,0,7864,0.0,1.0
25632,74347,2593,0,2593,0.0,1.0
25633,74349,318,0,318,0.0,1.0
25634,74350,862,0,862,0.0,1.0
25635,74352,6803,0,6803,0.0,1.0
25636,74354,18126,13379,4747,0.738,0.262
25637,74358,270,267,3,0.989,0.011
25638,74359,656,0,656,0.0,1.0
25639,74360,31,0,31,0.0,1.0
25640,74361,16293,9325,6968,0.572,0.428
25641,74363,2892,0,2892,0.0,1.0
25642,74364,1750,0,1750,0.0,1.0
25643,74365,5110,0,5110,0.0,1.0
25644,74366,1474,0,1474,0.0,1.0
25645,74367,587,0,587,0.0,1.0
25646,74368,117,0,117,0.0,1.0
25647,74369,1803,0,1803,0.0,1.0
25648,74370,3537,0,3537,0.0,1.0
25649,74401,17476,13275,4201,0.76,0.24
25650,74403,30709,24643,6066,0.802,0.198
25651,74421,4607,0,4607,0.0,1.0
25652,74422,824,0,824,0.0,1.0
25653,74423,872,0,872,0.0,1.0
25654,74425,1240,0,1240,0.0,1.0
25655,74426,9891,2572,7319,0.26,0.74
25656,74427,1383,0,1383,0.0,1.0
25657,74428,882,0,882,0.0,1.0
25658,74429,14445,9219,5226,0.638,0.362
25659,74430,588,0,588,0.0,1.0
25660,74431,918,843,75,0.918,0.082
25661,74432,9730,0,9730,0.0,1.0
25662,74434,9067,4134,4933,0.456,0.544
25663,74435,3185,0,3185,0.0,1.0
25664,74436,5078,0,5078,0.0,1.0
25665,74437,10448,5719,4729,0.547,0.453
25666,74438,163,0,163,0.0,1.0
25667,74441,5362,0,5362,0.0,1.0
25668,74442,920,0,920,0.0,1.0
25669,74445,3226,1547,1679,0.48,0.52
25670,74446,558,0,558,0.0,1.0
25671,74447,17275,12506,4769,0.724,0.276
25672,74450,1948,0,1948,0.0,1.0
25673,74451,4283,441,3842,0.103,0.897
25674,74452,473,0,473,0.0,1.0
25675,74454,3179,0,3179,0.0,1.0
25676,74455,3158,0,3158,0.0,1.0
25677,74456,247,0,247,0.0,1.0
25678,74457,608,0,608,0.0,1.0
25679,74458,147,0,147,0.0,1.0
25680,74459,86,0,86,0.0,1.0
25681,74460,283,0,283,0.0,1.0
25682,74462,7875,2843,5032,0.361,0.639
25683,74463,2033,0,2033,0.0,1.0
25684,74464,30111,18080,12031,0.6,0.4
25685,74467,14995,8043,6952,0.536,0.464
25686,74468,263,0,263,0.0,1.0
25687,74469,2531,0,2531,0.0,1.0
25688,74470,1693,0,1693,0.0,1.0
25689,74471,1800,0,1800,0.0,1.0
25690,74472,554,0,554,0.0,1.0
25691,74477,5,0,5,0.0,1.0
25692,74501,29073,18232,10841,0.627,0.373
25693,74521,217,0,217,0.0,1.0
25694,74522,344,0,344,0.0,1.0
25695,74523,6048,0,6048,0.0,1.0
25696,74525,10112,0,10112,0.0,1.0
25697,74528,174,0,174,0.0,1.0
25698,74530,214,0,214,0.0,1.0
25699,74531,1062,0,1062,0.0,1.0
25700,74533,849,0,849,0.0,1.0
25701,74534,250,0,250,0.0,1.0
25702,74535,126,0,126,0.0,1.0
25703,74536,1760,0,1760,0.0,1.0
25704,74538,4200,0,4200,0.0,1.0
25705,74540,172,0,172,0.0,1.0
25706,74543,370,0,370,0.0,1.0
25707,74546,824,740,84,0.898,0.102
25708,74547,3463,1799,1664,0.519,0.481
25709,74549,76,0,76,0.0,1.0
25710,74552,1058,0,1058,0.0,1.0
25711,74553,1384,0,1384,0.0,1.0
25712,74554,1744,1269,475,0.728,0.272
25713,74555,861,0,861,0.0,1.0
25714,74556,422,0,422,0.0,1.0
25715,74557,464,0,464,0.0,1.0
25716,74558,455,0,455,0.0,1.0
25717,74560,635,0,635,0.0,1.0
25718,74561,2175,0,2175,0.0,1.0
25719,74562,937,0,937,0.0,1.0
25720,74563,2042,0,2042,0.0,1.0
25721,74565,707,0,707,0.0,1.0
25722,74567,242,0,242,0.0,1.0
25723,74569,633,0,633,0.0,1.0
25724,74570,1089,0,1089,0.0,1.0
25725,74571,3765,0,3765,0.0,1.0
25726,74572,712,0,712,0.0,1.0
25727,74574,1080,0,1080,0.0,1.0
25728,74576,210,0,210,0.0,1.0
25729,74577,271,0,271,0.0,1.0
25730,74578,6822,2979,3843,0.437,0.563
25731,74601,20257,17693,2564,0.873,0.127
25732,74604,12301,8354,3947,0.679,0.321
25733,74630,702,0,702,0.0,1.0
25734,74631,7709,6916,793,0.897,0.103
25735,74632,578,0,578,0.0,1.0
25736,74633,471,0,471,0.0,1.0
25737,74636,268,0,268,0.0,1.0
25738,74637,1899,0,1899,0.0,1.0
25739,74640,312,0,312,0.0,1.0
25740,74641,715,0,715,0.0,1.0
25741,74643,615,0,615,0.0,1.0
25742,74644,478,0,478,0.0,1.0
25743,74646,233,0,233,0.0,1.0
25744,74647,3765,0,3765,0.0,1.0
25745,74650,693,0,693,0.0,1.0
25746,74651,743,0,743,0.0,1.0
25747,74652,897,0,897,0.0,1.0
25748,74653,3892,3141,751,0.807,0.193
25749,74701,22365,14770,7595,0.66,0.34
25750,74720,608,0,608,0.0,1.0
25751,74722,286,0,286,0.0,1.0
25752,74723,1729,0,1729,0.0,1.0
25753,74724,377,0,377,0.0,1.0
25754,74726,2398,0,2398,0.0,1.0
25755,74727,2038,0,2038,0.0,1.0
25756,74728,11343,4253,7090,0.375,0.625
25757,74729,2741,0,2741,0.0,1.0
25758,74730,4259,1632,2627,0.383,0.617
25759,74731,1747,0,1747,0.0,1.0
25760,74733,2853,0,2853,0.0,1.0
25761,74734,1087,0,1087,0.0,1.0
25762,74735,1549,0,1549,0.0,1.0
25763,74736,1178,0,1178,0.0,1.0
25764,74738,560,0,560,0.0,1.0
25765,74740,2288,0,2288,0.0,1.0
25766,74741,972,0,972,0.0,1.0
25767,74743,8537,5028,3509,0.589,0.411
25768,74745,9912,5940,3972,0.599,0.401
25769,74747,153,0,153,0.0,1.0
25770,74748,642,0,642,0.0,1.0
25771,74750,364,0,364,0.0,1.0
25772,74753,52,0,52,0.0,1.0
25773,74754,385,0,385,0.0,1.0
25774,74755,83,0,83,0.0,1.0
25775,74756,870,0,870,0.0,1.0
25776,74759,1358,0,1358,0.0,1.0
25777,74760,295,0,295,0.0,1.0
25778,74761,70,0,70,0.0,1.0
25779,74764,3473,0,3473,0.0,1.0
25780,74766,1595,0,1595,0.0,1.0
25781,74801,21657,14986,6671,0.692,0.308
25782,74804,19631,14312,5319,0.729,0.271
25783,74820,30802,17400,13402,0.565,0.435
25784,74824,1253,0,1253,0.0,1.0
25785,74825,2170,0,2170,0.0,1.0
25786,74826,1252,0,1252,0.0,1.0
25787,74827,387,0,387,0.0,1.0
25788,74829,1521,0,1521,0.0,1.0
25789,74830,229,0,229,0.0,1.0
25790,74831,923,0,923,0.0,1.0
25791,74832,936,0,936,0.0,1.0
25792,74833,703,0,703,0.0,1.0
25793,74834,7590,2704,4886,0.356,0.644
25794,74836,171,0,171,0.0,1.0
25795,74837,310,0,310,0.0,1.0
25796,74839,770,0,770,0.0,1.0
25797,74840,1924,0,1924,0.0,1.0
25798,74842,135,0,135,0.0,1.0
25799,74843,340,0,340,0.0,1.0
25800,74844,371,0,371,0.0,1.0
25801,74845,494,0,494,0.0,1.0
25802,74848,8326,5768,2558,0.693,0.307
25803,74849,3132,0,3132,0.0,1.0
25804,74850,283,0,283,0.0,1.0
25805,74851,9805,0,9805,0.0,1.0
25806,74852,1347,0,1347,0.0,1.0
25807,74854,1897,0,1897,0.0,1.0
25808,74855,4639,0,4639,0.0,1.0
25809,74856,782,0,782,0.0,1.0
25810,74857,9288,0,9288,0.0,1.0
25811,74859,6221,3152,3069,0.507,0.493
25812,74860,1653,0,1653,0.0,1.0
25813,74864,5274,0,5274,0.0,1.0
25814,74865,1711,0,1711,0.0,1.0
25815,74867,1045,0,1045,0.0,1.0
25816,74868,13152,5931,7221,0.451,0.549
25817,74869,710,0,710,0.0,1.0
25818,74871,2415,0,2415,0.0,1.0
25819,74872,3692,0,3692,0.0,1.0
25820,74873,11821,4957,6864,0.419,0.581
25821,74875,1165,0,1165,0.0,1.0
25822,74878,1565,0,1565,0.0,1.0
25823,74880,2239,0,2239,0.0,1.0
25824,74881,4509,0,4509,0.0,1.0
25825,74883,2526,0,2526,0.0,1.0
25826,74884,6024,3071,2953,0.51,0.49
25827,74901,1992,1713,279,0.86,0.14
25828,74902,4095,392,3703,0.096,0.904
25829,74930,2155,0,2155,0.0,1.0
25830,74931,1411,0,1411,0.0,1.0
25831,74932,2286,0,2286,0.0,1.0
25832,74935,174,0,174,0.0,1.0
25833,74936,1153,0,1153,0.0,1.0
25834,74937,5959,3058,2901,0.513,0.487
25835,74939,1455,0,1455,0.0,1.0
25836,74940,2697,702,1995,0.26,0.74
25837,74941,2713,0,2713,0.0,1.0
25838,74942,193,0,193,0.0,1.0
25839,74943,112,0,112,0.0,1.0
25840,74944,1272,0,1272,0.0,1.0
25841,74945,497,0,497,0.0,1.0
25842,74946,137,128,9,0.934,0.066
25843,74948,12788,2913,9875,0.228,0.772
25844,74949,308,0,308,0.0,1.0
25845,74951,1504,0,1504,0.0,1.0
25846,74953,11632,7167,4465,0.616,0.384
25847,74954,4590,2928,1662,0.638,0.362
25848,74955,15344,8179,7165,0.533,0.467
25849,74956,1905,624,1281,0.328,0.672
25850,74957,1170,0,1170,0.0,1.0
25851,74959,6736,0,6736,0.0,1.0
25852,74960,13643,3789,9854,0.278,0.722
25853,74962,5092,0,5092,0.0,1.0
25854,74963,608,0,608,0.0,1.0
25855,74964,2834,267,2567,0.094,0.906
25856,74965,5170,0,5170,0.0,1.0
25857,74966,3719,0,3719,0.0,1.0
25858,75001,12414,12414,0,1.0,0.0
25859,75002,63140,61203,1937,0.969,0.031
25860,75006,46364,46364,0,1.0,0.0
25861,75007,51624,51624,0,1.0,0.0
25862,75009,8785,5076,3709,0.578,0.422
25863,75010,21607,21607,0,1.0,0.0
25864,75013,30347,30064,283,0.991,0.009
25865,75019,38666,38666,0,1.0,0.0
25866,75020,21872,18405,3467,0.841,0.159
25867,75021,8036,3563,4473,0.443,0.557
25868,75022,22545,21497,1048,0.954,0.046
25869,75023,45452,45452,0,1.0,0.0
25870,75024,36039,36039,0,1.0,0.0
25871,75025,50926,50926,0,1.0,0.0
25872,75028,42226,42226,0,1.0,0.0
25873,75032,27986,24652,3334,0.881,0.119
25874,75034,72723,72384,339,0.995,0.005
25875,75035,47553,47124,429,0.991,0.009
25876,75038,27802,27802,0,1.0,0.0
25877,75039,11032,11032,0,1.0,0.0
25878,75040,59406,59406,0,1.0,0.0
25879,75041,30700,30700,0,1.0,0.0
25880,75042,37881,37881,0,1.0,0.0
25881,75043,58094,58094,0,1.0,0.0
25882,75044,40811,40811,0,1.0,0.0
25883,75048,20328,19964,364,0.982,0.018
25884,75050,41041,41041,0,1.0,0.0
25885,75051,39285,39285,0,1.0,0.0
25886,75052,88996,88996,0,1.0,0.0
25887,75054,5053,5053,0,1.0,0.0
25888,75056,47852,47060,792,0.983,0.017
25889,75057,12900,12818,82,0.994,0.006
25890,75058,2982,0,2982,0.0,1.0
25891,75060,45980,45980,0,1.0,0.0
25892,75061,53442,53442,0,1.0,0.0
25893,75062,44537,44537,0,1.0,0.0
25894,75063,35090,35090,0,1.0,0.0
25895,75065,10748,10563,185,0.983,0.017
25896,75067,60982,60982,0,1.0,0.0
25897,75068,34934,33269,1665,0.952,0.048
25898,75069,34108,33099,1009,0.97,0.03
25899,75070,74734,74696,38,0.999,0.001
25900,75071,36090,32268,3822,0.894,0.106
25901,75074,44622,44622,0,1.0,0.0
25902,75075,33262,33262,0,1.0,0.0
25903,75076,7378,1940,5438,0.263,0.737
25904,75077,35330,35200,130,0.996,0.004
25905,75078,10592,8587,2005,0.811,0.189
25906,75080,44009,44009,0,1.0,0.0
25907,75081,34156,34156,0,1.0,0.0
25908,75082,21182,21182,0,1.0,0.0
25909,75087,28145,26262,1883,0.933,0.067
25910,75088,24712,24712,0,1.0,0.0
25911,75089,30251,30097,154,0.995,0.005
25912,75090,23724,19067,4657,0.804,0.196
25913,75092,22839,18925,3914,0.829,0.171
25914,75093,47187,47187,0,1.0,0.0
25915,75094,20579,20579,0,1.0,0.0
25916,75098,48197,47312,885,0.982,0.018
25917,75101,646,0,646,0.0,1.0
25918,75102,1322,0,1322,0.0,1.0
25919,75103,12851,3563,9288,0.277,0.723
25920,75104,45373,42331,3042,0.933,0.067
25921,75105,301,0,301,0.0,1.0
25922,75109,3658,34,3624,0.009,0.991
25923,75110,28132,22565,5567,0.802,0.198
25924,75114,4660,0,4660,0.0,1.0
25925,75115,48877,48877,0,1.0,0.0
25926,75116,19669,19669,0,1.0,0.0
25927,75117,3722,0,3722,0.0,1.0
25928,75119,26601,18258,8343,0.686,0.314
25929,75124,4446,56,4390,0.013,0.987
25930,75125,6691,2616,4075,0.391,0.609
25931,75126,33396,28243,5153,0.846,0.154
25932,75127,1593,0,1593,0.0,1.0
25933,75132,294,240,54,0.816,0.184
25934,75134,20276,20248,28,0.999,0.001
25935,75135,5910,0,5910,0.0,1.0
25936,75137,18861,18861,0,1.0,0.0
25937,75140,6958,3236,3722,0.465,0.535
25938,75141,5374,4413,961,0.821,0.179
25939,75142,18982,6268,12714,0.33,0.67
25940,75143,14619,585,14034,0.04,0.96
25941,75144,3291,0,3291,0.0,1.0
25942,75146,17993,15364,2629,0.854,0.146
25943,75147,6602,2808,3794,0.425,0.575
25944,75148,5842,2969,2873,0.508,0.492
25945,75149,56065,56065,0,1.0,0.0
25946,75150,58730,58730,0,1.0,0.0
25947,75152,4606,371,4235,0.081,0.919
25948,75153,605,0,605,0.0,1.0
25949,75154,36041,33703,2338,0.935,0.065
25950,75155,2579,0,2579,0.0,1.0
25951,75156,14580,11435,3145,0.784,0.216
25952,75157,310,0,310,0.0,1.0
25953,75158,4139,0,4139,0.0,1.0
25954,75159,18339,13236,5103,0.722,0.278
25955,75160,23627,16176,7451,0.685,0.315
25956,75161,6165,0,6165,0.0,1.0
25957,75163,2285,0,2285,0.0,1.0
25958,75164,671,0,671,0.0,1.0
25959,75165,37966,29856,8110,0.786,0.214
25960,75166,3070,2215,855,0.721,0.279
25961,75167,8436,2003,6433,0.237,0.763
25962,75169,14644,4686,9958,0.32,0.68
25963,75172,3956,3525,431,0.891,0.109
25964,75173,4353,0,4353,0.0,1.0
25965,75180,23031,23031,0,1.0,0.0
25966,75181,25908,25205,703,0.973,0.027
25967,75182,5118,3163,1955,0.618,0.382
25968,75189,22406,8210,14196,0.366,0.634
25969,75201,9409,9409,0,1.0,0.0
25970,75202,1666,1666,0,1.0,0.0
25971,75203,15721,15721,0,1.0,0.0
25972,75204,26279,26279,0,1.0,0.0
25973,75205,23061,23061,0,1.0,0.0
25974,75206,36248,36248,0,1.0,0.0
25975,75207,9648,9648,0,1.0,0.0
25976,75208,30171,30171,0,1.0,0.0
25977,75209,13653,13653,0,1.0,0.0
25978,75210,7482,7482,0,1.0,0.0
25979,75211,73146,73043,103,0.999,0.001
25980,75212,24884,24884,0,1.0,0.0
25981,75214,32950,32950,0,1.0,0.0
25982,75215,14648,14617,31,0.998,0.002
25983,75216,49416,49245,171,0.997,0.003
25984,75217,80324,79224,1100,0.986,0.014
25985,75218,21665,21665,0,1.0,0.0
25986,75219,22124,22124,0,1.0,0.0
25987,75220,41891,41891,0,1.0,0.0
25988,75223,13947,13947,0,1.0,0.0
25989,75224,34034,34034,0,1.0,0.0
25990,75225,20892,20892,0,1.0,0.0
25991,75226,3506,3506,0,1.0,0.0
25992,75227,55029,55029,0,1.0,0.0
25993,75228,66551,66551,0,1.0,0.0
25994,75229,31571,31571,0,1.0,0.0
25995,75230,26934,26934,0,1.0,0.0
25996,75231,37052,37052,0,1.0,0.0
25997,75232,28682,28682,0,1.0,0.0
25998,75233,14043,14043,0,1.0,0.0
25999,75234,28794,28794,0,1.0,0.0
26000,75235,17177,17177,0,1.0,0.0
26001,75236,15949,15668,281,0.982,0.018
26002,75237,17101,17101,0,1.0,0.0
26003,75238,30483,30483,0,1.0,0.0
26004,75240,24296,24296,0,1.0,0.0
26005,75241,27066,26703,363,0.987,0.013
26006,75243,55406,55406,0,1.0,0.0
26007,75244,13266,13266,0,1.0,0.0
26008,75246,2770,2770,0,1.0,0.0
26009,75247,468,468,0,1.0,0.0
26010,75248,33395,33395,0,1.0,0.0
26011,75249,13373,13373,0,1.0,0.0
26012,75251,2331,2331,0,1.0,0.0
26013,75252,24112,24112,0,1.0,0.0
26014,75253,18450,17639,811,0.956,0.044
26015,75254,23253,23253,0,1.0,0.0
26016,75270,0,0,0,,
26017,75287,49004,49004,0,1.0,0.0
26018,75390,0,0,0,,
26019,75401,18552,14349,4203,0.773,0.227
26020,75402,15920,8934,6986,0.561,0.439
26021,75407,14120,6705,7415,0.475,0.525
26022,75409,11831,7708,4123,0.652,0.348
26023,75410,4334,0,4334,0.0,1.0
26024,75411,1118,0,1118,0.0,1.0
26025,75412,778,0,778,0.0,1.0
26026,75413,305,0,305,0.0,1.0
26027,75414,3136,0,3136,0.0,1.0
26028,75415,144,0,144,0.0,1.0
26029,75416,2893,0,2893,0.0,1.0
26030,75417,2456,0,2456,0.0,1.0
26031,75418,14411,9995,4416,0.694,0.306
26032,75420,1076,0,1076,0.0,1.0
26033,75421,1003,0,1003,0.0,1.0
26034,75422,2883,0,2883,0.0,1.0
26035,75423,2982,0,2982,0.0,1.0
26036,75424,3297,0,3297,0.0,1.0
26037,75426,5301,3121,2180,0.589,0.411
26038,75428,10089,7717,2372,0.765,0.235
26039,75431,2052,0,2052,0.0,1.0
26040,75432,3323,0,3323,0.0,1.0
26041,75433,2773,0,2773,0.0,1.0
26042,75435,1185,0,1185,0.0,1.0
26043,75436,1876,0,1876,0.0,1.0
26044,75437,1078,0,1078,0.0,1.0
26045,75438,972,0,972,0.0,1.0
26046,75439,868,0,868,0.0,1.0
26047,75440,6350,0,6350,0.0,1.0
26048,75441,142,0,142,0.0,1.0
26049,75442,8858,3138,5720,0.354,0.646
26050,75446,3180,0,3180,0.0,1.0
26051,75447,1080,0,1080,0.0,1.0
26052,75448,655,0,655,0.0,1.0
26053,75449,1186,0,1186,0.0,1.0
26054,75450,331,0,331,0.0,1.0
26055,75451,1211,0,1211,0.0,1.0
26056,75452,4090,0,4090,0.0,1.0
26057,75453,3255,377,2878,0.116,0.884
26058,75454,5699,4790,909,0.84,0.16
26059,75455,28293,15987,12306,0.565,0.435
26060,75457,6522,2585,3937,0.396,0.604
26061,75459,4326,0,4326,0.0,1.0
26062,75460,23592,20955,2637,0.888,0.112
26063,75462,11350,5394,5956,0.475,0.525
26064,75468,888,0,888,0.0,1.0
26065,75469,371,0,371,0.0,1.0
26066,75470,288,0,288,0.0,1.0
26067,75471,1424,0,1424,0.0,1.0
26068,75472,3548,594,2954,0.167,0.833
26069,75473,3855,0,3855,0.0,1.0
26070,75474,14882,5269,9613,0.354,0.646
26071,75475,129,0,129,0.0,1.0
26072,75476,1304,0,1304,0.0,1.0
26073,75477,977,0,977,0.0,1.0
26074,75478,932,0,932,0.0,1.0
26075,75479,1849,0,1849,0.0,1.0
26076,75480,1646,0,1646,0.0,1.0
26077,75481,395,0,395,0.0,1.0
26078,75482,24385,14196,10189,0.582,0.418
26079,75486,2346,0,2346,0.0,1.0
26080,75487,1541,0,1541,0.0,1.0
26081,75488,1161,0,1161,0.0,1.0
26082,75489,993,0,993,0.0,1.0
26083,75490,2211,0,2211,0.0,1.0
26084,75491,4801,0,4801,0.0,1.0
26085,75492,516,0,516,0.0,1.0
26086,75493,611,0,611,0.0,1.0
26087,75494,10862,3403,7459,0.313,0.687
26088,75495,7095,3038,4057,0.428,0.572
26089,75496,3351,0,3351,0.0,1.0
26090,75497,3350,0,3350,0.0,1.0
26091,75501,36298,26720,9578,0.736,0.264
26092,75503,24379,22500,1879,0.923,0.077
26093,75550,808,0,808,0.0,1.0
26094,75551,11007,4852,6155,0.441,0.559
26095,75554,1806,0,1806,0.0,1.0
26096,75555,1611,0,1611,0.0,1.0
26097,75556,1133,0,1133,0.0,1.0
26098,75558,1636,0,1636,0.0,1.0
26099,75559,5568,0,5568,0.0,1.0
26100,75560,1088,0,1088,0.0,1.0
26101,75561,5395,2930,2465,0.543,0.457
26102,75562,176,0,176,0.0,1.0
26103,75563,4282,0,4282,0.0,1.0
26104,75565,361,0,361,0.0,1.0
26105,75566,782,0,782,0.0,1.0
26106,75567,4225,0,4225,0.0,1.0
26107,75568,2876,0,2876,0.0,1.0
26108,75569,2874,2870,4,0.999,0.001
26109,75570,11518,4754,6764,0.413,0.587
26110,75571,2846,0,2846,0.0,1.0
26111,75572,3491,880,2611,0.252,0.748
26112,75573,181,0,181,0.0,1.0
26113,75574,1868,0,1868,0.0,1.0
26114,75601,15849,15849,0,1.0,0.0
26115,75602,23286,19357,3929,0.831,0.169
26116,75603,5456,701,4755,0.128,0.872
26117,75604,29934,28860,1074,0.964,0.036
26118,75605,27823,20380,7443,0.732,0.268
26119,75630,2588,0,2588,0.0,1.0
26120,75631,2787,0,2787,0.0,1.0
26121,75633,13977,6492,7485,0.464,0.536
26122,75638,6036,2600,3436,0.431,0.569
26123,75639,3460,0,3460,0.0,1.0
26124,75640,4652,0,4652,0.0,1.0
26125,75641,223,0,223,0.0,1.0
26126,75642,229,0,229,0.0,1.0
26127,75643,2074,0,2074,0.0,1.0
26128,75644,11444,4253,7191,0.372,0.628
26129,75645,9778,1698,8080,0.174,0.826
26130,75647,13196,7271,5925,0.551,0.449
26131,75650,8611,3658,4953,0.425,0.575
26132,75651,2189,0,2189,0.0,1.0
26133,75652,16638,9782,6856,0.588,0.412
26134,75654,12417,5405,7012,0.435,0.565
26135,75656,4804,2376,2428,0.495,0.505
26136,75657,8246,0,8246,0.0,1.0
26137,75661,2807,0,2807,0.0,1.0
26138,75662,24536,14996,9540,0.611,0.389
26139,75667,1021,0,1021,0.0,1.0
26140,75668,1993,0,1993,0.0,1.0
26141,75669,606,0,606,0.0,1.0
26142,75670,17290,13171,4119,0.762,0.238
26143,75672,17097,8808,8289,0.515,0.485
26144,75681,2562,0,2562,0.0,1.0
26145,75682,473,0,473,0.0,1.0
26146,75683,3914,0,3914,0.0,1.0
26147,75684,7548,0,7548,0.0,1.0
26148,75686,12985,4777,8208,0.368,0.632
26149,75691,4219,0,4219,0.0,1.0
26150,75692,5098,0,5098,0.0,1.0
26151,75693,6869,6454,415,0.94,0.06
26152,75701,34373,34373,0,1.0,0.0
26153,75702,27069,27032,37,0.999,0.001
26154,75703,37166,32332,4834,0.87,0.13
26155,75704,8684,3363,5321,0.387,0.613
26156,75705,2168,188,1980,0.087,0.913
26157,75706,8771,2203,6568,0.251,0.749
26158,75707,13711,6457,7254,0.471,0.529
26159,75708,7156,5058,2098,0.707,0.293
26160,75709,5062,2488,2574,0.492,0.508
26161,75750,3937,0,3937,0.0,1.0
26162,75751,17253,11616,5637,0.673,0.327
26163,75752,6986,553,6433,0.079,0.921
26164,75754,5783,0,5783,0.0,1.0
26165,75755,5719,0,5719,0.0,1.0
26166,75756,4002,0,4002,0.0,1.0
26167,75757,10022,3956,6066,0.395,0.605
26168,75758,9072,3475,5597,0.383,0.617
26169,75759,141,0,141,0.0,1.0
26170,75760,2614,0,2614,0.0,1.0
26171,75762,12466,6906,5560,0.554,0.446
26172,75763,6005,0,6005,0.0,1.0
26173,75764,233,0,233,0.0,1.0
26174,75765,7607,0,7607,0.0,1.0
26175,75766,26388,14075,12313,0.533,0.467
26176,75770,2776,39,2737,0.014,0.986
26177,75771,18361,9972,8389,0.543,0.457
26178,75773,12791,5608,7183,0.438,0.562
26179,75778,3254,0,3254,0.0,1.0
26180,75779,122,0,122,0.0,1.0
26181,75780,312,0,312,0.0,1.0
26182,75783,7219,2505,4714,0.347,0.653
26183,75784,658,0,658,0.0,1.0
26184,75785,11263,4691,6572,0.416,0.584
26185,75788,126,0,126,0.0,1.0
26186,75789,7593,0,7593,0.0,1.0
26187,75790,4203,2502,1701,0.595,0.405
26188,75791,13125,9122,4003,0.695,0.305
26189,75792,3518,0,3518,0.0,1.0
26190,75801,16799,11159,5640,0.664,0.336
26191,75803,22397,8095,14302,0.361,0.639
26192,75831,5386,0,5386,0.0,1.0
26193,75832,66,0,66,0.0,1.0
26194,75833,3324,0,3324,0.0,1.0
26195,75835,12012,6292,5720,0.524,0.476
26196,75838,666,0,666,0.0,1.0
26197,75839,5069,0,5069,0.0,1.0
26198,75840,7076,3280,3796,0.464,0.536
26199,75844,5718,0,5718,0.0,1.0
26200,75845,3259,0,3259,0.0,1.0
26201,75846,2718,0,2718,0.0,1.0
26202,75847,1859,0,1859,0.0,1.0
26203,75848,92,0,92,0.0,1.0
26204,75849,75,0,75,0.0,1.0
26205,75850,671,0,671,0.0,1.0
26206,75851,5050,0,5050,0.0,1.0
26207,75852,3762,0,3762,0.0,1.0
26208,75853,963,0,963,0.0,1.0
26209,75855,2369,0,2369,0.0,1.0
26210,75856,196,0,196,0.0,1.0
26211,75858,43,0,43,0.0,1.0
26212,75859,1923,0,1923,0.0,1.0
26213,75860,6644,3363,3281,0.506,0.494
26214,75861,9017,0,9017,0.0,1.0
26215,75862,10091,3320,6771,0.329,0.671
26216,75901,29036,19981,9055,0.688,0.312
26217,75904,34004,24946,9058,0.734,0.266
26218,75925,4179,0,4179,0.0,1.0
26219,75926,1070,0,1070,0.0,1.0
26220,75928,1411,0,1411,0.0,1.0
26221,75929,1599,0,1599,0.0,1.0
26222,75930,2023,0,2023,0.0,1.0
26223,75931,2631,0,2631,0.0,1.0
26224,75932,1437,0,1437,0.0,1.0
26225,75933,1599,0,1599,0.0,1.0
26226,75934,99,0,99,0.0,1.0
26227,75935,13685,5234,8451,0.382,0.618
26228,75936,889,0,889,0.0,1.0
26229,75937,994,0,994,0.0,1.0
26230,75938,2608,0,2608,0.0,1.0
26231,75939,3992,0,3992,0.0,1.0
26232,75941,9105,4461,4644,0.49,0.51
26233,75942,115,0,115,0.0,1.0
26234,75943,1262,0,1262,0.0,1.0
26235,75944,1301,0,1301,0.0,1.0
26236,75946,3578,0,3578,0.0,1.0
26237,75948,6281,0,6281,0.0,1.0
26238,75949,7976,0,7976,0.0,1.0
26239,75951,16134,7790,8344,0.483,0.517
26240,75954,3280,0,3280,0.0,1.0
26241,75956,7623,0,7623,0.0,1.0
26242,75959,923,0,923,0.0,1.0
26243,75960,913,0,913,0.0,1.0
26244,75961,14910,7800,7110,0.523,0.477
26245,75962,3029,3029,0,1.0,0.0
26246,75964,20097,11103,8994,0.552,0.448
26247,75965,17591,12614,4977,0.717,0.283
26248,75966,5371,0,5371,0.0,1.0
26249,75968,1766,0,1766,0.0,1.0
26250,75969,4116,0,4116,0.0,1.0
26251,75972,6620,0,6620,0.0,1.0
26252,75973,2599,0,2599,0.0,1.0
26253,75974,3126,0,3126,0.0,1.0
26254,75975,3699,0,3699,0.0,1.0
26255,75976,827,0,827,0.0,1.0
26256,75977,750,0,750,0.0,1.0
26257,75978,144,0,144,0.0,1.0
26258,75979,11423,4760,6663,0.417,0.583
26259,75980,2836,0,2836,0.0,1.0
26260,76001,30460,30452,8,1.0,0.0
26261,76002,30269,30269,0,1.0,0.0
26262,76006,22639,22639,0,1.0,0.0
26263,76008,13602,8406,5196,0.618,0.382
26264,76009,19759,9815,9944,0.497,0.503
26265,76010,55706,55706,0,1.0,0.0
26266,76011,21594,21594,0,1.0,0.0
26267,76012,25689,25689,0,1.0,0.0
26268,76013,30680,30680,0,1.0,0.0
26269,76014,34072,34072,0,1.0,0.0
26270,76015,16658,16658,0,1.0,0.0
26271,76016,30852,30852,0,1.0,0.0
26272,76017,44724,44724,0,1.0,0.0
26273,76018,26938,26938,0,1.0,0.0
26274,76020,27270,16189,11081,0.594,0.406
26275,76021,33673,33673,0,1.0,0.0
26276,76022,13212,13212,0,1.0,0.0
26277,76023,5832,0,5832,0.0,1.0
26278,76028,59744,52293,7451,0.875,0.125
26279,76031,17759,9307,8452,0.524,0.476
26280,76033,24819,20712,4107,0.835,0.165
26281,76034,22748,22748,0,1.0,0.0
26282,76035,1622,0,1622,0.0,1.0
26283,76036,22352,19635,2717,0.878,0.122
26284,76039,32925,32925,0,1.0,0.0
26285,76040,27524,27524,0,1.0,0.0
26286,76041,434,0,434,0.0,1.0
26287,76043,7071,0,7071,0.0,1.0
26288,76044,3866,0,3866,0.0,1.0
26289,76048,21989,16600,5389,0.755,0.245
26290,76049,25130,18016,7114,0.717,0.283
26291,76050,5875,0,5875,0.0,1.0
26292,76051,46320,46320,0,1.0,0.0
26293,76052,15995,13906,2089,0.869,0.131
26294,76053,28421,28421,0,1.0,0.0
26295,76054,11764,11764,0,1.0,0.0
26296,76055,3084,0,3084,0.0,1.0
26297,76058,17123,4982,12141,0.291,0.709
26298,76059,4881,4803,78,0.984,0.016
26299,76060,6764,6424,340,0.95,0.05
26300,76061,152,0,152,0.0,1.0
26301,76063,61361,57110,4251,0.931,0.069
26302,76064,1883,0,1883,0.0,1.0
26303,76065,28986,23636,5350,0.815,0.185
26304,76066,3142,0,3142,0.0,1.0
26305,76067,22117,16109,6008,0.728,0.272
26306,76070,752,0,752,0.0,1.0
26307,76071,3320,2902,418,0.874,0.126
26308,76073,5327,0,5327,0.0,1.0
26309,76077,590,0,590,0.0,1.0
26310,76078,8572,2017,6555,0.235,0.765
26311,76082,17748,5093,12655,0.287,0.713
26312,76084,8327,5164,3163,0.62,0.38
26313,76085,8787,2437,6350,0.277,0.723
26314,76086,20196,19481,715,0.965,0.035
26315,76087,24746,11346,13400,0.458,0.542
26316,76088,11499,503,10996,0.044,0.956
26317,76092,26669,26189,480,0.982,0.018
26318,76093,2095,0,2095,0.0,1.0
26319,76102,8111,8111,0,1.0,0.0
26320,76103,14572,14572,0,1.0,0.0
26321,76104,17446,17446,0,1.0,0.0
26322,76105,22194,22194,0,1.0,0.0
26323,76106,35389,35389,0,1.0,0.0
26324,76107,25917,25917,0,1.0,0.0
26325,76108,38227,34117,4110,0.892,0.108
26326,76109,21710,21710,0,1.0,0.0
26327,76110,30434,30434,0,1.0,0.0
26328,76111,21685,21685,0,1.0,0.0
26329,76112,38993,38993,0,1.0,0.0
26330,76114,24741,24741,0,1.0,0.0
26331,76115,20696,20696,0,1.0,0.0
26332,76116,46746,46746,0,1.0,0.0
26333,76117,30645,30645,0,1.0,0.0
26334,76118,13866,13866,0,1.0,0.0
26335,76119,42761,42761,0,1.0,0.0
26336,76120,15283,15283,0,1.0,0.0
26337,76123,29722,28906,816,0.973,0.027
26338,76126,19395,15524,3871,0.8,0.2
26339,76127,2003,2003,0,1.0,0.0
26340,76129,2833,2833,0,1.0,0.0
26341,76131,28374,28224,150,0.995,0.005
26342,76132,24709,24709,0,1.0,0.0
26343,76133,48394,48394,0,1.0,0.0
26344,76134,23704,23704,0,1.0,0.0
26345,76135,20684,19546,1138,0.945,0.055
26346,76137,54911,54911,0,1.0,0.0
26347,76140,26340,24789,1551,0.941,0.059
26348,76148,23331,23331,0,1.0,0.0
26349,76155,3115,3115,0,1.0,0.0
26350,76164,16748,16748,0,1.0,0.0
26351,76177,4891,4595,296,0.939,0.061
26352,76179,48058,44021,4037,0.916,0.084
26353,76180,33444,33444,0,1.0,0.0
26354,76182,28209,28209,0,1.0,0.0
26355,76201,27107,27107,0,1.0,0.0
26356,76205,18510,18510,0,1.0,0.0
26357,76207,10579,8472,2107,0.801,0.199
26358,76208,19782,18498,1284,0.935,0.065
26359,76209,24018,24018,0,1.0,0.0
26360,76210,39556,39365,191,0.995,0.005
26361,76225,3156,0,3156,0.0,1.0
26362,76226,18419,11566,6853,0.628,0.372
26363,76227,22141,17780,4361,0.803,0.197
26364,76228,1119,0,1119,0.0,1.0
26365,76230,9711,5143,4568,0.53,0.47
26366,76233,3235,0,3235,0.0,1.0
26367,76234,15587,5910,9677,0.379,0.621
26368,76238,431,0,431,0.0,1.0
26369,76239,1087,0,1087,0.0,1.0
26370,76240,26120,15746,10374,0.603,0.397
26371,76244,60388,60297,91,0.998,0.002
26372,76245,1780,0,1780,0.0,1.0
26373,76247,13098,8099,4999,0.618,0.382
26374,76248,34647,34647,0,1.0,0.0
26375,76249,7194,4173,3021,0.58,0.42
26376,76250,937,0,937,0.0,1.0
26377,76251,731,0,731,0.0,1.0
26378,76252,2863,0,2863,0.0,1.0
26379,76253,230,0,230,0.0,1.0
26380,76255,5411,2953,2458,0.546,0.454
26381,76258,6659,3579,3080,0.537,0.463
26382,76259,4618,0,4618,0.0,1.0
26383,76261,233,0,233,0.0,1.0
26384,76262,27648,25861,1787,0.935,0.065
26385,76263,44,0,44,0.0,1.0
26386,76264,1412,243,1169,0.172,0.828
26387,76265,1893,0,1893,0.0,1.0
26388,76266,13495,5972,7523,0.443,0.557
26389,76268,250,0,250,0.0,1.0
26390,76270,1853,0,1853,0.0,1.0
26391,76271,1352,0,1352,0.0,1.0
26392,76272,4745,0,4745,0.0,1.0
26393,76273,9135,3716,5419,0.407,0.593
26394,76301,16540,16237,303,0.982,0.018
26395,76302,13206,12776,430,0.967,0.033
26396,76305,4746,113,4633,0.024,0.976
26397,76306,15991,15437,554,0.965,0.035
26398,76308,19677,19518,159,0.992,0.008
26399,76309,13862,13518,344,0.975,0.025
26400,76310,17989,14303,3686,0.795,0.205
26401,76311,7535,7535,0,1.0,0.0
26402,76351,2035,0,2035,0.0,1.0
26403,76354,11270,10002,1268,0.887,0.113
26404,76357,712,0,712,0.0,1.0
26405,76360,3502,2746,756,0.784,0.216
26406,76363,256,0,256,0.0,1.0
26407,76364,193,0,193,0.0,1.0
26408,76365,4831,2731,2100,0.565,0.435
26409,76366,2317,0,2317,0.0,1.0
26410,76367,13045,6285,6760,0.482,0.518
26411,76370,299,0,299,0.0,1.0
26412,76371,1606,0,1606,0.0,1.0
26413,76372,974,0,974,0.0,1.0
26414,76373,162,0,162,0.0,1.0
26415,76374,4162,3282,880,0.789,0.211
26416,76377,802,0,802,0.0,1.0
26417,76379,591,0,591,0.0,1.0
26418,76380,3820,0,3820,0.0,1.0
26419,76384,12991,10572,2419,0.814,0.186
26420,76388,203,0,203,0.0,1.0
26421,76389,1329,0,1329,0.0,1.0
26422,76401,25702,15949,9753,0.621,0.379
26423,76402,847,847,0,1.0,0.0
26424,76424,8992,5839,3153,0.649,0.351
26425,76426,11302,5646,5656,0.5,0.5
26426,76427,804,0,804,0.0,1.0
26427,76429,258,0,258,0.0,1.0
26428,76430,2532,0,2532,0.0,1.0
26429,76431,3384,0,3384,0.0,1.0
26430,76432,1370,0,1370,0.0,1.0
26431,76433,1416,0,1416,0.0,1.0
26432,76435,612,0,612,0.0,1.0
26433,76436,212,0,212,0.0,1.0
26434,76437,5721,3658,2063,0.639,0.361
26435,76442,7545,3988,3557,0.529,0.471
26436,76443,1897,0,1897,0.0,1.0
26437,76444,3635,0,3635,0.0,1.0
26438,76445,407,0,407,0.0,1.0
26439,76446,9000,3543,5457,0.394,0.606
26440,76448,5628,3711,1917,0.659,0.341
26441,76449,2434,0,2434,0.0,1.0
26442,76450,13258,9041,4217,0.682,0.318
26443,76452,75,0,75,0.0,1.0
26444,76453,1125,0,1125,0.0,1.0
26445,76454,1688,0,1688,0.0,1.0
26446,76455,1014,0,1014,0.0,1.0
26447,76457,3960,0,3960,0.0,1.0
26448,76458,6261,4231,2030,0.676,0.324
26449,76459,146,0,146,0.0,1.0
26450,76460,421,0,421,0.0,1.0
26451,76462,2982,0,2982,0.0,1.0
26452,76463,481,0,481,0.0,1.0
26453,76464,506,0,506,0.0,1.0
26454,76466,332,0,332,0.0,1.0
26455,76469,96,0,96,0.0,1.0
26456,76470,3238,0,3238,0.0,1.0
26457,76471,1906,0,1906,0.0,1.0
26458,76472,1499,0,1499,0.0,1.0
26459,76474,281,0,281,0.0,1.0
26460,76475,977,0,977,0.0,1.0
26461,76476,2637,0,2637,0.0,1.0
26462,76481,208,0,208,0.0,1.0
26463,76483,1063,0,1063,0.0,1.0
26464,76484,1147,0,1147,0.0,1.0
26465,76486,1375,0,1375,0.0,1.0
26466,76487,2507,0,2507,0.0,1.0
26467,76490,91,0,91,0.0,1.0
26468,76491,459,0,459,0.0,1.0
26469,76501,16897,12396,4501,0.734,0.266
26470,76502,31545,27125,4420,0.86,0.14
26471,76504,24268,23431,837,0.966,0.034
26472,76508,0,0,0,,
26473,76511,3317,2653,664,0.8,0.2
26474,76513,34172,27119,7053,0.794,0.206
26475,76518,1581,0,1581,0.0,1.0
26476,76519,626,0,626,0.0,1.0
26477,76520,8413,5389,3024,0.641,0.359
26478,76522,35534,30489,5045,0.858,0.142
26479,76523,18,0,18,0.0,1.0
26480,76524,2867,0,2867,0.0,1.0
26481,76525,1062,0,1062,0.0,1.0
26482,76527,4058,0,4058,0.0,1.0
26483,76528,16974,8675,8299,0.511,0.489
26484,76530,2540,0,2540,0.0,1.0
26485,76531,4978,3034,1944,0.609,0.391
26486,76534,2615,0,2615,0.0,1.0
26487,76537,3870,0,3870,0.0,1.0
26488,76538,761,0,761,0.0,1.0
26489,76539,7841,284,7557,0.036,0.964
26490,76541,19206,19206,0,1.0,0.0
26491,76542,40025,36332,3693,0.908,0.092
26492,76543,30430,29570,860,0.972,0.028
26493,76544,29943,29939,4,1.0,0.0
26494,76548,26344,25839,505,0.981,0.019
26495,76549,44490,41539,2951,0.934,0.066
26496,76550,11586,6080,5506,0.525,0.475
26497,76554,2104,0,2104,0.0,1.0
26498,76556,1461,0,1461,0.0,1.0
26499,76557,5178,0,5178,0.0,1.0
26500,76559,5051,4432,619,0.877,0.123
26501,76561,962,0,962,0.0,1.0
26502,76565,74,0,74,0.0,1.0
26503,76566,258,0,258,0.0,1.0
26504,76567,8984,5459,3525,0.608,0.392
26505,76569,2498,0,2498,0.0,1.0
26506,76570,2572,0,2572,0.0,1.0
26507,76571,6790,0,6790,0.0,1.0
26508,76573,26,0,26,0.0,1.0
26509,76574,17661,14436,3225,0.817,0.183
26510,76577,3046,0,3046,0.0,1.0
26511,76578,1766,0,1766,0.0,1.0
26512,76579,4258,319,3939,0.075,0.925
26513,76596,1274,1274,0,1.0,0.0
26514,76597,2882,2882,0,1.0,0.0
26515,76598,523,523,0,1.0,0.0
26516,76599,1956,1956,0,1.0,0.0
26517,76621,1037,0,1037,0.0,1.0
26518,76622,1015,0,1015,0.0,1.0
26519,76623,242,0,242,0.0,1.0
26520,76624,2231,0,2231,0.0,1.0
26521,76626,1563,0,1563,0.0,1.0
26522,76627,1601,0,1601,0.0,1.0
26523,76628,111,0,111,0.0,1.0
26524,76629,1989,0,1989,0.0,1.0
26525,76630,1840,0,1840,0.0,1.0
26526,76631,522,0,522,0.0,1.0
26527,76632,1778,0,1778,0.0,1.0
26528,76633,4973,0,4973,0.0,1.0
26529,76634,7093,3421,3672,0.482,0.518
26530,76635,1341,0,1341,0.0,1.0
26531,76636,1497,0,1497,0.0,1.0
26532,76637,536,0,536,0.0,1.0
26533,76638,2837,0,2837,0.0,1.0
26534,76639,1584,0,1584,0.0,1.0
26535,76640,3005,933,2072,0.31,0.69
26536,76641,1674,0,1674,0.0,1.0
26537,76642,7057,3948,3109,0.559,0.441
26538,76643,13554,13461,93,0.993,0.007
26539,76645,11039,8328,2711,0.754,0.246
26540,76648,2302,0,2302,0.0,1.0
26541,76649,790,0,790,0.0,1.0
26542,76650,104,0,104,0.0,1.0
26543,76651,3300,0,3300,0.0,1.0
26544,76652,1087,0,1087,0.0,1.0
26545,76653,1082,0,1082,0.0,1.0
26546,76654,151,0,151,0.0,1.0
26547,76655,7831,408,7423,0.052,0.948
26548,76656,2276,0,2276,0.0,1.0
26549,76657,9307,7625,1682,0.819,0.181
26550,76660,506,0,506,0.0,1.0
26551,76661,8708,5832,2876,0.67,0.33
26552,76664,3514,0,3514,0.0,1.0
26553,76665,2526,0,2526,0.0,1.0
26554,76666,244,0,244,0.0,1.0
26555,76667,11313,6898,4415,0.61,0.39
26556,76670,1377,0,1377,0.0,1.0
26557,76671,1777,0,1777,0.0,1.0
26558,76673,1187,0,1187,0.0,1.0
26559,76676,413,0,413,0.0,1.0
26560,76678,263,0,263,0.0,1.0
26561,76679,1432,0,1432,0.0,1.0
26562,76680,190,0,190,0.0,1.0
26563,76681,873,0,873,0.0,1.0
26564,76682,2660,0,2660,0.0,1.0
26565,76685,108,0,108,0.0,1.0
26566,76686,285,0,285,0.0,1.0
26567,76687,1466,0,1466,0.0,1.0
26568,76689,3996,0,3996,0.0,1.0
26569,76690,1197,0,1197,0.0,1.0
26570,76691,6454,2780,3674,0.431,0.569
26571,76692,10115,0,10115,0.0,1.0
26572,76693,1651,0,1651,0.0,1.0
26573,76701,1826,1826,0,1.0,0.0
26574,76704,8007,8007,0,1.0,0.0
26575,76705,29155,22625,6530,0.776,0.224
26576,76706,35015,30684,4331,0.876,0.124
26577,76707,16697,16697,0,1.0,0.0
26578,76708,24476,21384,3092,0.874,0.126
26579,76710,22686,22686,0,1.0,0.0
26580,76711,9042,9042,0,1.0,0.0
26581,76712,23506,20031,3475,0.852,0.148
26582,76798,1862,1862,0,1.0,0.0
26583,76801,25552,19681,5871,0.77,0.23
26584,76802,5075,3030,2045,0.597,0.403
26585,76820,125,0,125,0.0,1.0
26586,76821,4869,3705,1164,0.761,0.239
26587,76823,2945,0,2945,0.0,1.0
26588,76824,35,0,35,0.0,1.0
26589,76825,7091,5357,1734,0.755,0.245
26590,76827,433,0,433,0.0,1.0
26591,76828,199,0,199,0.0,1.0
26592,76831,63,0,63,0.0,1.0
26593,76832,559,0,559,0.0,1.0
26594,76834,5908,4310,1598,0.73,0.27
26595,76836,41,0,41,0.0,1.0
26596,76837,3188,0,3188,0.0,1.0
26597,76841,61,0,61,0.0,1.0
26598,76842,191,0,191,0.0,1.0
26599,76844,3550,0,3550,0.0,1.0
26600,76845,178,0,178,0.0,1.0
26601,76848,78,0,78,0.0,1.0
26602,76849,3944,2566,1378,0.651,0.349
26603,76852,212,0,212,0.0,1.0
26604,76853,1622,0,1622,0.0,1.0
26605,76854,401,0,401,0.0,1.0
26606,76856,3582,0,3582,0.0,1.0
26607,76857,1791,0,1791,0.0,1.0
26608,76858,254,0,254,0.0,1.0
26609,76859,1982,0,1982,0.0,1.0
26610,76861,1995,0,1995,0.0,1.0
26611,76862,198,0,198,0.0,1.0
26612,76864,890,0,890,0.0,1.0
26613,76865,160,0,160,0.0,1.0
26614,76866,623,0,623,0.0,1.0
26615,76869,125,0,125,0.0,1.0
26616,76870,251,0,251,0.0,1.0
26617,76871,784,0,784,0.0,1.0
26618,76872,717,0,717,0.0,1.0
26619,76873,55,0,55,0.0,1.0
26620,76874,68,0,68,0.0,1.0
26621,76875,668,0,668,0.0,1.0
26622,76877,4558,3105,1453,0.681,0.319
26623,76878,1685,0,1685,0.0,1.0
26624,76882,252,0,252,0.0,1.0
26625,76884,172,0,172,0.0,1.0
26626,76885,154,0,154,0.0,1.0
26627,76887,126,0,126,0.0,1.0
26628,76888,110,0,110,0.0,1.0
26629,76890,940,0,940,0.0,1.0
26630,76901,27969,22721,5248,0.812,0.188
26631,76903,31905,30923,982,0.969,0.031
26632,76904,32718,29623,3095,0.905,0.095
26633,76905,11335,7766,3569,0.685,0.315
26634,76908,1951,1951,0,1.0,0.0
26635,76930,156,0,156,0.0,1.0
26636,76932,3390,2919,471,0.861,0.139
26637,76933,1365,0,1365,0.0,1.0
26638,76934,1296,0,1296,0.0,1.0
26639,76935,1606,0,1606,0.0,1.0
26640,76936,3377,0,3377,0.0,1.0
26641,76937,37,0,37,0.0,1.0
26642,76939,51,0,51,0.0,1.0
26643,76940,176,0,176,0.0,1.0
26644,76941,1348,0,1348,0.0,1.0
26645,76943,3693,2873,820,0.778,0.222
26646,76945,1665,0,1665,0.0,1.0
26647,76949,7,0,7,0.0,1.0
26648,76950,4180,3352,828,0.802,0.198
26649,76951,1143,0,1143,0.0,1.0
26650,76953,74,0,74,0.0,1.0
26651,76955,133,0,133,0.0,1.0
26652,76957,59,0,59,0.0,1.0
26653,76958,310,0,310,0.0,1.0
26654,77002,16793,16793,0,1.0,0.0
26655,77003,10508,10508,0,1.0,0.0
26656,77004,32692,32692,0,1.0,0.0
26657,77005,25528,25528,0,1.0,0.0
26658,77006,19664,19664,0,1.0,0.0
26659,77007,30853,30853,0,1.0,0.0
26660,77008,30482,30482,0,1.0,0.0
26661,77009,38094,38094,0,1.0,0.0
26662,77010,366,366,0,1.0,0.0
26663,77011,19547,19547,0,1.0,0.0
26664,77012,20719,20719,0,1.0,0.0
26665,77013,17602,17602,0,1.0,0.0
26666,77014,28684,28684,0,1.0,0.0
26667,77015,53621,53621,0,1.0,0.0
26668,77016,26989,26989,0,1.0,0.0
26669,77017,32561,32561,0,1.0,0.0
26670,77018,25563,25563,0,1.0,0.0
26671,77019,18944,18944,0,1.0,0.0
26672,77020,25464,25464,0,1.0,0.0
26673,77021,26042,26042,0,1.0,0.0
26674,77022,29557,29557,0,1.0,0.0
26675,77023,28998,28998,0,1.0,0.0
26676,77024,34775,34775,0,1.0,0.0
26677,77025,26137,26137,0,1.0,0.0
26678,77026,23940,23940,0,1.0,0.0
26679,77027,14331,14331,0,1.0,0.0
26680,77028,16808,16808,0,1.0,0.0
26681,77029,17814,17814,0,1.0,0.0
26682,77030,10258,10258,0,1.0,0.0
26683,77031,15762,15762,0,1.0,0.0
26684,77032,12757,12757,0,1.0,0.0
26685,77033,27965,27965,0,1.0,0.0
26686,77034,33678,33678,0,1.0,0.0
26687,77035,35896,35896,0,1.0,0.0
26688,77036,71969,71969,0,1.0,0.0
26689,77037,19819,19819,0,1.0,0.0
26690,77038,26713,26713,0,1.0,0.0
26691,77039,27562,27562,0,1.0,0.0
26692,77040,45081,45081,0,1.0,0.0
26693,77041,37146,37146,0,1.0,0.0
26694,77042,36385,36385,0,1.0,0.0
26695,77043,23358,23358,0,1.0,0.0
26696,77044,30949,29789,1160,0.963,0.037
26697,77045,31255,31255,0,1.0,0.0
26698,77046,1196,1196,0,1.0,0.0
26699,77047,21077,21025,52,0.998,0.002
26700,77048,15294,15135,159,0.99,0.01
26701,77049,28521,28208,313,0.989,0.011
26702,77050,4611,4258,353,0.923,0.077
26703,77051,15085,15085,0,1.0,0.0
26704,77053,28954,28941,13,1.0,0.0
26705,77054,22290,22290,0,1.0,0.0
26706,77055,41989,41989,0,1.0,0.0
26707,77056,18673,18673,0,1.0,0.0
26708,77057,39208,39208,0,1.0,0.0
26709,77058,16406,16406,0,1.0,0.0
26710,77059,16949,16949,0,1.0,0.0
26711,77060,40830,40830,0,1.0,0.0
26712,77061,24457,24457,0,1.0,0.0
26713,77062,25152,25152,0,1.0,0.0
26714,77063,34299,34299,0,1.0,0.0
26715,77064,45847,45847,0,1.0,0.0
26716,77065,35326,35326,0,1.0,0.0
26717,77066,31366,31366,0,1.0,0.0
26718,77067,30559,30559,0,1.0,0.0
26719,77068,10064,10064,0,1.0,0.0
26720,77069,16541,16541,0,1.0,0.0
26721,77070,46017,46017,0,1.0,0.0
26722,77071,25671,25671,0,1.0,0.0
26723,77072,56526,56526,0,1.0,0.0
26724,77073,34790,34790,0,1.0,0.0
26725,77074,37267,37267,0,1.0,0.0
26726,77075,37388,37388,0,1.0,0.0
26727,77076,33803,33803,0,1.0,0.0
26728,77077,52151,52151,0,1.0,0.0
26729,77078,14777,14717,60,0.996,0.004
26730,77079,31280,31280,0,1.0,0.0
26731,77080,45275,45275,0,1.0,0.0
26732,77081,47860,47860,0,1.0,0.0
26733,77082,49900,49900,0,1.0,0.0
26734,77083,70837,70837,0,1.0,0.0
26735,77084,95137,95137,0,1.0,0.0
26736,77085,16074,16074,0,1.0,0.0
26737,77086,28009,28009,0,1.0,0.0
26738,77087,36399,36399,0,1.0,0.0
26739,77088,49660,49660,0,1.0,0.0
26740,77089,48685,48685,0,1.0,0.0
26741,77090,32930,32930,0,1.0,0.0
26742,77091,23472,23472,0,1.0,0.0
26743,77092,33745,33745,0,1.0,0.0
26744,77093,46929,46929,0,1.0,0.0
26745,77094,8498,8496,2,1.0,0.0
26746,77095,66502,66502,0,1.0,0.0
26747,77096,32628,32628,0,1.0,0.0
26748,77098,13076,13076,0,1.0,0.0
26749,77099,47091,47091,0,1.0,0.0
26750,77201,0,0,0,,
26751,77301,30769,29643,1126,0.963,0.037
26752,77302,18118,10668,7450,0.589,0.411
26753,77303,16710,6009,10701,0.36,0.64
26754,77304,21314,18255,3059,0.856,0.144
26755,77306,11931,5880,6051,0.493,0.507
26756,77316,16036,3862,12174,0.241,0.759
26757,77318,14281,11546,2735,0.808,0.192
26758,77320,33678,13693,19985,0.407,0.593
26759,77326,69,0,69,0.0,1.0
26760,77327,20160,7268,12892,0.361,0.639
26761,77328,13993,1888,12105,0.135,0.865
26762,77331,6824,0,6824,0.0,1.0
26763,77334,141,0,141,0.0,1.0
26764,77335,2350,0,2350,0.0,1.0
26765,77336,12471,5138,7333,0.412,0.588
26766,77338,33971,33511,460,0.986,0.014
26767,77339,37512,37512,0,1.0,0.0
26768,77340,29809,23212,6597,0.779,0.221
26769,77342,23,23,0,1.0,0.0
26770,77345,26122,26122,0,1.0,0.0
26771,77346,53578,53021,557,0.99,0.01
26772,77350,66,0,66,0.0,1.0
26773,77351,32517,5728,26789,0.176,0.824
26774,77354,30215,19887,10328,0.658,0.342
26775,77355,24010,10129,13881,0.422,0.578
26776,77356,24498,18676,5822,0.762,0.238
26777,77357,19987,13588,6399,0.68,0.32
26778,77358,4993,0,4993,0.0,1.0
26779,77359,721,0,721,0.0,1.0
26780,77360,5280,4427,853,0.838,0.162
26781,77362,4600,4002,598,0.87,0.13
26782,77363,3269,0,3269,0.0,1.0
26783,77364,2223,0,2223,0.0,1.0
26784,77365,25769,24918,851,0.967,0.033
26785,77367,143,0,143,0.0,1.0
26786,77368,152,0,152,0.0,1.0
26787,77369,1018,0,1018,0.0,1.0
26788,77371,7665,0,7665,0.0,1.0
26789,77372,12164,6115,6049,0.503,0.497
26790,77373,54609,53714,895,0.984,0.016
26791,77374,510,0,510,0.0,1.0
26792,77375,39351,36811,2540,0.935,0.065
26793,77376,617,0,617,0.0,1.0
26794,77377,28708,22314,6394,0.777,0.223
26795,77378,14685,7489,7196,0.51,0.49
26796,77379,70544,70544,0,1.0,0.0
26797,77380,23136,22608,528,0.977,0.023
26798,77381,34961,34961,0,1.0,0.0
26799,77382,35369,35366,3,1.0,0.0
26800,77384,11857,8081,3776,0.682,0.318
26801,77385,19534,17816,1718,0.912,0.088
26802,77386,36407,34937,1470,0.96,0.04
26803,77388,40384,40384,0,1.0,0.0
26804,77389,21255,21079,176,0.992,0.008
26805,77396,43317,43156,161,0.996,0.004
26806,77401,17491,17491,0,1.0,0.0
26807,77406,33682,28462,5220,0.845,0.155
26808,77407,28595,28499,96,0.997,0.003
26809,77412,106,0,106,0.0,1.0
26810,77414,23047,17911,5136,0.777,0.223
26811,77415,46,0,46,0.0,1.0
26812,77417,2457,0,2457,0.0,1.0
26813,77418,9585,4002,5583,0.418,0.582
26814,77419,1512,0,1512,0.0,1.0
26815,77420,2205,0,2205,0.0,1.0
26816,77422,13933,5129,8804,0.368,0.632
26817,77423,9483,4486,4997,0.473,0.527
26818,77426,2100,0,2100,0.0,1.0
26819,77428,61,0,61,0.0,1.0
26820,77429,72264,70802,1462,0.98,0.02
26821,77430,2283,0,2283,0.0,1.0
26822,77432,173,0,173,0.0,1.0
26823,77433,50539,44143,6396,0.873,0.127
26824,77434,4816,3628,1188,0.753,0.247
26825,77435,4539,0,4539,0.0,1.0
26826,77436,73,0,73,0.0,1.0
26827,77437,17054,11719,5335,0.687,0.313
26828,77440,37,0,37,0.0,1.0
26829,77441,4809,2874,1935,0.598,0.402
26830,77442,1137,0,1137,0.0,1.0
26831,77443,84,0,84,0.0,1.0
26832,77444,784,0,784,0.0,1.0
26833,77445,11977,6180,5797,0.516,0.484
26834,77446,5217,4961,256,0.951,0.049
26835,77447,11872,3223,8649,0.271,0.729
26836,77448,341,0,341,0.0,1.0
26837,77449,94382,93409,973,0.99,0.01
26838,77450,71889,71837,52,0.999,0.001
26839,77451,77,0,77,0.0,1.0
26840,77453,301,0,301,0.0,1.0
26841,77454,217,0,217,0.0,1.0
26842,77455,2045,0,2045,0.0,1.0
26843,77456,1303,0,1303,0.0,1.0
26844,77457,651,0,651,0.0,1.0
26845,77458,468,0,468,0.0,1.0
26846,77459,56274,55748,526,0.991,0.009
26847,77460,73,0,73,0.0,1.0
26848,77461,10679,2867,7812,0.268,0.732
26849,77464,221,0,221,0.0,1.0
26850,77465,7161,4591,2570,0.641,0.359
26851,77466,690,0,690,0.0,1.0
26852,77467,57,0,57,0.0,1.0
26853,77468,131,0,131,0.0,1.0
26854,77469,35321,31520,3801,0.892,0.108
26855,77470,338,0,338,0.0,1.0
26856,77471,35241,30869,4372,0.876,0.124
26857,77473,97,0,97,0.0,1.0
26858,77474,12782,5562,7220,0.435,0.565
26859,77475,773,0,773,0.0,1.0
26860,77476,313,32,281,0.102,0.898
26861,77477,35897,35897,0,1.0,0.0
26862,77478,24739,24739,0,1.0,0.0
26863,77479,74514,74034,480,0.994,0.006
26864,77480,8097,3584,4513,0.443,0.557
26865,77481,35,0,35,0.0,1.0
26866,77482,2307,834,1473,0.362,0.638
26867,77483,311,0,311,0.0,1.0
26868,77484,11068,28,11040,0.003,0.997
26869,77485,4054,22,4032,0.005,0.995
26870,77486,6851,4976,1875,0.726,0.274
26871,77488,14148,8964,5184,0.634,0.366
26872,77489,35554,35554,0,1.0,0.0
26873,77493,23104,20397,2707,0.883,0.117
26874,77494,61600,61345,255,0.996,0.004
26875,77498,49906,49906,0,1.0,0.0
26876,77502,37995,37995,0,1.0,0.0
26877,77503,24251,24251,0,1.0,0.0
26878,77504,24529,24529,0,1.0,0.0
26879,77505,23223,23223,0,1.0,0.0
26880,77506,35977,35977,0,1.0,0.0
26881,77507,0,0,0,,
26882,77510,13731,11952,1779,0.87,0.13
26883,77511,46627,31237,15390,0.67,0.33
26884,77514,4942,0,4942,0.0,1.0
26885,77515,30309,19443,10866,0.641,0.359
26886,77517,5315,3324,1991,0.625,0.375
26887,77518,8673,8673,0,1.0,0.0
26888,77519,1191,0,1191,0.0,1.0
26889,77520,36489,35981,508,0.986,0.014
26890,77521,49507,48051,1456,0.971,0.029
26891,77523,17031,10916,6115,0.641,0.359
26892,77530,31086,31026,60,0.998,0.002
26893,77531,15639,15109,530,0.966,0.034
26894,77532,26236,16817,9419,0.641,0.359
26895,77533,1022,0,1022,0.0,1.0
26896,77534,2863,0,2863,0.0,1.0
26897,77535,31295,13863,17432,0.443,0.557
26898,77536,30690,30690,0,1.0,0.0
26899,77538,934,0,934,0.0,1.0
26900,77539,38806,36418,2388,0.938,0.062
26901,77541,17412,14505,2907,0.833,0.167
26902,77545,19431,19369,62,0.997,0.003
26903,77546,47636,46929,707,0.985,0.015
26904,77547,9735,9735,0,1.0,0.0
26905,77550,23043,22958,85,0.996,0.004
26906,77551,17753,17753,0,1.0,0.0
26907,77554,8863,4228,4635,0.477,0.523
26908,77560,1005,0,1005,0.0,1.0
26909,77561,53,0,53,0.0,1.0
26910,77562,10459,9783,676,0.935,0.065
26911,77563,9103,8409,694,0.924,0.076
26912,77564,1988,0,1988,0.0,1.0
26913,77565,5790,5790,0,1.0,0.0
26914,77566,28739,27734,1005,0.965,0.035
26915,77568,14308,13850,458,0.968,0.032
26916,77571,35666,35658,8,1.0,0.0
26917,77573,71580,71418,162,0.998,0.002
26918,77575,15949,5801,10148,0.364,0.636
26919,77577,1368,0,1368,0.0,1.0
26920,77578,12672,7581,5091,0.598,0.402
26921,77580,312,253,59,0.811,0.189
26922,77581,42383,42040,343,0.992,0.008
26923,77583,28531,12570,15961,0.441,0.559
26924,77584,70228,69855,373,0.995,0.005
26925,77585,1014,0,1014,0.0,1.0
26926,77586,20970,20944,26,0.999,0.001
26927,77587,16568,16568,0,1.0,0.0
26928,77590,30374,29779,595,0.98,0.02
26929,77591,13131,12900,231,0.982,0.018
26930,77597,777,0,777,0.0,1.0
26931,77598,23059,23059,0,1.0,0.0
26932,77611,8219,7906,313,0.962,0.038
26933,77612,8901,0,8901,0.0,1.0
26934,77613,1218,0,1218,0.0,1.0
26935,77614,603,0,603,0.0,1.0
26936,77615,1012,0,1012,0.0,1.0
26937,77616,1136,0,1136,0.0,1.0
26938,77617,73,0,73,0.0,1.0
26939,77619,16147,16147,0,1.0,0.0
26940,77622,1390,0,1390,0.0,1.0
26941,77623,448,0,448,0.0,1.0
26942,77624,856,0,856,0.0,1.0
26943,77625,8489,394,8095,0.046,0.954
26944,77627,21454,21411,43,0.998,0.002
26945,77629,877,0,877,0.0,1.0
26946,77630,26796,20148,6648,0.752,0.248
26947,77632,22776,7955,14821,0.349,0.651
26948,77640,16875,16450,425,0.975,0.025
26949,77642,37111,37048,63,0.998,0.002
26950,77650,1896,0,1896,0.0,1.0
26951,77651,13043,13022,21,0.998,0.002
26952,77655,356,0,356,0.0,1.0
26953,77656,17110,9531,7579,0.557,0.443
26954,77657,20003,16547,3456,0.827,0.173
26955,77659,4910,0,4910,0.0,1.0
26956,77660,1437,0,1437,0.0,1.0
26957,77661,962,664,298,0.69,0.31
26958,77662,27035,17045,9990,0.63,0.37
26959,77663,1353,0,1353,0.0,1.0
26960,77664,2681,0,2681,0.0,1.0
26961,77665,6446,3237,3209,0.502,0.498
26962,77701,14674,14674,0,1.0,0.0
26963,77702,2893,2893,0,1.0,0.0
26964,77703,15006,13555,1451,0.903,0.097
26965,77705,40475,33216,7259,0.821,0.179
26966,77706,28258,28258,0,1.0,0.0
26967,77707,17080,16996,84,0.995,0.005
26968,77708,11518,11279,239,0.979,0.021
26969,77713,12788,6128,6660,0.479,0.521
26970,77801,15449,15449,0,1.0,0.0
26971,77802,23288,23288,0,1.0,0.0
26972,77803,30252,30249,3,1.0,0.0
26973,77807,9699,5113,4586,0.527,0.473
26974,77808,10634,1335,9299,0.126,0.874
26975,77830,2534,0,2534,0.0,1.0
26976,77831,3426,0,3426,0.0,1.0
26977,77833,27492,15682,11810,0.57,0.43
26978,77835,2351,0,2351,0.0,1.0
26979,77836,11896,4012,7884,0.337,0.663
26980,77837,1587,0,1587,0.0,1.0
26981,77840,56171,56171,0,1.0,0.0
26982,77845,48938,39740,9198,0.812,0.188
26983,77853,953,0,953,0.0,1.0
26984,77855,238,0,238,0.0,1.0
26985,77856,5096,0,5096,0.0,1.0
26986,77857,757,0,757,0.0,1.0
26987,77859,6981,4346,2635,0.623,0.377
26988,77861,2506,0,2506,0.0,1.0
26989,77864,7647,4454,3193,0.582,0.418
26990,77865,1798,0,1798,0.0,1.0
26991,77867,105,0,105,0.0,1.0
26992,77868,15511,8273,7238,0.533,0.467
26993,77871,3368,0,3368,0.0,1.0
26994,77872,1716,0,1716,0.0,1.0
26995,77873,1292,0,1292,0.0,1.0
26996,77876,197,0,197,0.0,1.0
26997,77878,475,0,475,0.0,1.0
26998,77879,4670,0,4670,0.0,1.0
26999,77880,1879,0,1879,0.0,1.0
27000,77901,41548,41109,439,0.989,0.011
27001,77904,25002,20648,4354,0.826,0.174
27002,77905,13981,1926,12055,0.138,0.862
27003,77950,197,0,197,0.0,1.0
27004,77951,2616,0,2616,0.0,1.0
27005,77954,11506,8099,3407,0.704,0.296
27006,77957,8187,5374,2813,0.656,0.344
27007,77960,121,0,121,0.0,1.0
27008,77961,183,0,183,0.0,1.0
27009,77962,3286,0,3286,0.0,1.0
27010,77963,5459,0,5459,0.0,1.0
27011,77964,7569,0,7569,0.0,1.0
27012,77968,2774,0,2774,0.0,1.0
27013,77969,154,0,154,0.0,1.0
27014,77970,295,0,295,0.0,1.0
27015,77971,911,0,911,0.0,1.0
27016,77973,50,0,50,0.0,1.0
27017,77974,455,0,455,0.0,1.0
27018,77975,1860,0,1860,0.0,1.0
27019,77976,126,0,126,0.0,1.0
27020,77977,718,0,718,0.0,1.0
27021,77978,743,0,743,0.0,1.0
27022,77979,17144,11817,5327,0.689,0.311
27023,77982,1253,0,1253,0.0,1.0
27024,77983,2209,0,2209,0.0,1.0
27025,77984,4295,0,4295,0.0,1.0
27026,77987,161,0,161,0.0,1.0
27027,77988,326,0,326,0.0,1.0
27028,77990,699,0,699,0.0,1.0
27029,77991,357,0,357,0.0,1.0
27030,77993,148,0,148,0.0,1.0
27031,77994,321,0,321,0.0,1.0
27032,77995,9567,5624,3943,0.588,0.412
27033,78001,33,0,33,0.0,1.0
27034,78002,8255,56,8199,0.007,0.993
27035,78003,8689,0,8689,0.0,1.0
27036,78004,1183,0,1183,0.0,1.0
27037,78005,817,0,817,0.0,1.0
27038,78006,27558,12673,14885,0.46,0.54
27039,78007,151,0,151,0.0,1.0
27040,78008,345,0,345,0.0,1.0
27041,78009,7255,4040,3215,0.557,0.443
27042,78010,3386,0,3386,0.0,1.0
27043,78011,2082,0,2082,0.0,1.0
27044,78012,436,0,436,0.0,1.0
27045,78013,5930,2653,3277,0.447,0.553
27046,78014,4987,3694,1293,0.741,0.259
27047,78015,9602,6434,3168,0.67,0.33
27048,78016,9630,4481,5149,0.465,0.535
27049,78017,4787,3938,849,0.823,0.177
27050,78019,1855,0,1855,0.0,1.0
27051,78021,126,0,126,0.0,1.0
27052,78022,4627,0,4627,0.0,1.0
27053,78023,24334,20668,3666,0.849,0.151
27054,78024,1436,0,1436,0.0,1.0
27055,78025,4956,2521,2435,0.509,0.491
27056,78026,5861,3601,2260,0.614,0.386
27057,78027,459,0,459,0.0,1.0
27058,78028,37620,26289,11331,0.699,0.301
27059,78029,0,0,0,,
27060,78039,1657,0,1657,0.0,1.0
27061,78040,42083,42083,0,1.0,0.0
27062,78041,44153,44152,1,1.0,0.0
27063,78043,42713,41422,1291,0.97,0.03
27064,78044,648,0,648,0.0,1.0
27065,78045,54713,53396,1317,0.976,0.024
27066,78046,64548,62744,1804,0.972,0.028
27067,78050,767,0,767,0.0,1.0
27068,78052,6388,3323,3065,0.52,0.48
27069,78055,1774,0,1774,0.0,1.0
27070,78056,1917,0,1917,0.0,1.0
27071,78057,871,0,871,0.0,1.0
27072,78058,1256,0,1256,0.0,1.0
27073,78059,5387,1413,3974,0.262,0.738
27074,78060,37,0,37,0.0,1.0
27075,78061,11031,9460,1571,0.858,0.142
27076,78063,9227,0,9227,0.0,1.0
27077,78064,14102,8867,5235,0.629,0.371
27078,78065,10831,3199,7632,0.295,0.705
27079,78066,591,0,591,0.0,1.0
27080,78067,916,0,916,0.0,1.0
27081,78069,5137,0,5137,0.0,1.0
27082,78070,14618,0,14618,0.0,1.0
27083,78071,4248,0,4248,0.0,1.0
27084,78072,505,0,505,0.0,1.0
27085,78073,8171,555,7616,0.068,0.932
27086,78075,123,0,123,0.0,1.0
27087,78076,12612,10719,1893,0.85,0.15
27088,78101,7898,0,7898,0.0,1.0
27089,78102,27593,18168,9425,0.658,0.342
27090,78104,175,0,175,0.0,1.0
27091,78107,360,0,360,0.0,1.0
27092,78108,27770,25527,2243,0.919,0.081
27093,78109,34603,33910,693,0.98,0.02
27094,78112,7941,0,7941,0.0,1.0
27095,78113,2435,0,2435,0.0,1.0
27096,78114,20103,6068,14035,0.302,0.698
27097,78116,390,0,390,0.0,1.0
27098,78117,545,0,545,0.0,1.0
27099,78118,3976,3015,961,0.758,0.242
27100,78119,7680,6118,1562,0.797,0.203
27101,78121,11381,0,11381,0.0,1.0
27102,78122,418,0,418,0.0,1.0
27103,78123,2397,2345,52,0.978,0.022
27104,78124,5609,1674,3935,0.298,0.702
27105,78125,96,0,96,0.0,1.0
27106,78130,59546,56445,3101,0.948,0.052
27107,78132,19139,7098,12041,0.371,0.629
27108,78133,16269,5277,10992,0.324,0.676
27109,78140,3380,0,3380,0.0,1.0
27110,78141,596,0,596,0.0,1.0
27111,78142,119,0,119,0.0,1.0
27112,78143,85,0,85,0.0,1.0
27113,78144,45,0,45,0.0,1.0
27114,78145,103,0,103,0.0,1.0
27115,78146,771,0,771,0.0,1.0
27116,78147,1919,0,1919,0.0,1.0
27117,78148,20139,20139,0,1.0,0.0
27118,78150,11,11,0,1.0,0.0
27119,78151,1347,0,1347,0.0,1.0
27120,78152,2294,0,2294,0.0,1.0
27121,78154,30347,29174,1173,0.961,0.039
27122,78155,45341,25704,19637,0.567,0.433
27123,78159,1023,0,1023,0.0,1.0
27124,78160,4273,0,4273,0.0,1.0
27125,78161,864,0,864,0.0,1.0
27126,78162,375,0,375,0.0,1.0
27127,78163,9838,987,8851,0.1,0.9
27128,78164,3796,0,3796,0.0,1.0
27129,78201,45307,45307,0,1.0,0.0
27130,78202,11691,11691,0,1.0,0.0
27131,78203,6099,6099,0,1.0,0.0
27132,78204,11125,11125,0,1.0,0.0
27133,78205,1453,1453,0,1.0,0.0
27134,78207,55514,55514,0,1.0,0.0
27135,78208,3736,3736,0,1.0,0.0
27136,78209,39197,39197,0,1.0,0.0
27137,78210,36865,36865,0,1.0,0.0
27138,78211,31944,31933,11,1.0,0.0
27139,78212,28415,28415,0,1.0,0.0
27140,78213,40396,40396,0,1.0,0.0
27141,78214,23341,23341,0,1.0,0.0
27142,78215,1150,1150,0,1.0,0.0
27143,78216,40267,40267,0,1.0,0.0
27144,78217,32165,32165,0,1.0,0.0
27145,78218,31917,31917,0,1.0,0.0
27146,78219,15225,15067,158,0.99,0.01
27147,78220,15965,15609,356,0.978,0.022
27148,78221,35990,32103,3887,0.892,0.108
27149,78222,19408,18758,650,0.967,0.033
27150,78223,50637,47146,3491,0.931,0.069
27151,78224,17601,17295,306,0.983,0.017
27152,78225,13025,13025,0,1.0,0.0
27153,78226,6648,6648,0,1.0,0.0
27154,78227,46077,46072,5,1.0,0.0
27155,78228,58811,58811,0,1.0,0.0
27156,78229,28804,28804,0,1.0,0.0
27157,78230,39089,39089,0,1.0,0.0
27158,78231,7906,7726,180,0.977,0.023
27159,78232,35120,35120,0,1.0,0.0
27160,78233,43710,43710,0,1.0,0.0
27161,78234,7126,7126,0,1.0,0.0
27162,78235,357,357,0,1.0,0.0
27163,78236,10392,10392,0,1.0,0.0
27164,78237,36929,36929,0,1.0,0.0
27165,78238,23514,23514,0,1.0,0.0
27166,78239,28736,28736,0,1.0,0.0
27167,78240,51111,51111,0,1.0,0.0
27168,78242,31395,31395,0,1.0,0.0
27169,78243,235,235,0,1.0,0.0
27170,78244,30757,30753,4,1.0,0.0
27171,78245,56511,54691,1820,0.968,0.032
27172,78247,49176,49174,2,1.0,0.0
27173,78248,13638,13638,0,1.0,0.0
27174,78249,49951,49951,0,1.0,0.0
27175,78250,54903,54903,0,1.0,0.0
27176,78251,49435,49435,0,1.0,0.0
27177,78252,7372,5373,1999,0.729,0.271
27178,78253,29007,23285,5722,0.803,0.197
27179,78254,44817,42939,1878,0.958,0.042
27180,78255,10826,8700,2126,0.804,0.196
27181,78256,6855,6814,41,0.994,0.006
27182,78257,3950,3112,838,0.788,0.212
27183,78258,40586,40586,0,1.0,0.0
27184,78259,22660,21546,1114,0.951,0.049
27185,78260,24844,23564,1280,0.948,0.052
27186,78261,13513,11162,2351,0.826,0.174
27187,78263,4673,646,4027,0.138,0.862
27188,78264,12339,2855,9484,0.231,0.769
27189,78266,5591,3834,1757,0.686,0.314
27190,78330,878,0,878,0.0,1.0
27191,78332,28710,20974,7736,0.731,0.269
27192,78335,4,0,4,0.0,1.0
27193,78336,11949,7991,3958,0.669,0.331
27194,78338,37,0,37,0.0,1.0
27195,78339,632,0,632,0.0,1.0
27196,78340,379,0,379,0.0,1.0
27197,78341,1760,0,1760,0.0,1.0
27198,78342,386,0,386,0.0,1.0
27199,78343,4525,3116,1409,0.689,0.311
27200,78344,474,0,474,0.0,1.0
27201,78349,505,0,505,0.0,1.0
27202,78351,621,0,621,0.0,1.0
27203,78352,179,0,179,0.0,1.0
27204,78353,433,0,433,0.0,1.0
27205,78355,7081,4929,2152,0.696,0.304
27206,78357,3161,0,3161,0.0,1.0
27207,78358,709,709,0,1.0,0.0
27208,78359,1944,1748,196,0.899,0.101
27209,78361,5350,4378,972,0.818,0.182
27210,78362,9447,7795,1652,0.825,0.175
27211,78363,30463,26011,4452,0.854,0.146
27212,78368,9227,5936,3291,0.643,0.357
27213,78369,444,0,444,0.0,1.0
27214,78370,4877,2775,2102,0.569,0.431
27215,78371,404,0,404,0.0,1.0
27216,78372,5452,0,5452,0.0,1.0
27217,78373,3585,0,3585,0.0,1.0
27218,78374,16620,15876,744,0.955,0.045
27219,78375,3352,2620,732,0.782,0.218
27220,78376,554,0,554,0.0,1.0
27221,78377,3821,2903,918,0.76,0.24
27222,78379,1585,0,1585,0.0,1.0
27223,78380,23141,13277,9864,0.574,0.426
27224,78382,19364,15613,3751,0.806,0.194
27225,78383,3539,0,3539,0.0,1.0
27226,78384,6640,4757,1883,0.716,0.284
27227,78385,277,0,277,0.0,1.0
27228,78387,9574,6071,3503,0.634,0.366
27229,78389,1541,0,1541,0.0,1.0
27230,78390,5616,4401,1215,0.784,0.216
27231,78391,325,0,325,0.0,1.0
27232,78393,2379,0,2379,0.0,1.0
27233,78401,5391,5391,0,1.0,0.0
27234,78402,536,536,0,1.0,0.0
27235,78404,17236,17236,0,1.0,0.0
27236,78405,16867,16867,0,1.0,0.0
27237,78406,1413,457,956,0.323,0.677
27238,78407,2955,2955,0,1.0,0.0
27239,78408,12061,12061,0,1.0,0.0
27240,78409,2939,2540,399,0.864,0.136
27241,78410,26387,26044,343,0.987,0.013
27242,78411,28024,28024,0,1.0,0.0
27243,78412,36003,36003,0,1.0,0.0
27244,78413,36953,36721,232,0.994,0.006
27245,78414,30165,29803,362,0.988,0.012
27246,78415,39271,38142,1129,0.971,0.029
27247,78416,15508,15508,0,1.0,0.0
27248,78417,4176,3675,501,0.88,0.12
27249,78418,29854,29232,622,0.979,0.021
27250,78419,694,694,0,1.0,0.0
27251,78501,61219,61219,0,1.0,0.0
27252,78503,21706,21628,78,0.996,0.004
27253,78504,48703,48338,365,0.993,0.007
27254,78516,33722,33044,678,0.98,0.02
27255,78520,59408,57462,1946,0.967,0.033
27256,78521,93818,93031,787,0.992,0.008
27257,78526,42460,42317,143,0.997,0.003
27258,78535,581,527,54,0.907,0.093
27259,78536,451,0,451,0.0,1.0
27260,78537,39454,36912,2542,0.936,0.064
27261,78538,10657,5143,5514,0.483,0.517
27262,78539,30783,30783,0,1.0,0.0
27263,78541,42431,38324,4107,0.903,0.097
27264,78542,63293,57609,5684,0.91,0.09
27265,78543,8447,8077,370,0.956,0.044
27266,78545,555,0,555,0.0,1.0
27267,78548,675,0,675,0.0,1.0
27268,78549,990,0,990,0.0,1.0
27269,78550,53152,51237,1915,0.964,0.036
27270,78552,34111,32138,1973,0.942,0.058
27271,78557,12547,12249,298,0.976,0.024
27272,78558,882,856,26,0.971,0.029
27273,78559,12751,9186,3565,0.72,0.28
27274,78560,4368,4232,136,0.969,0.031
27275,78561,779,0,779,0.0,1.0
27276,78562,2868,2629,239,0.917,0.083
27277,78563,376,0,376,0.0,1.0
27278,78564,270,0,270,0.0,1.0
27279,78565,402,315,87,0.784,0.216
27280,78566,16230,12138,4092,0.748,0.252
27281,78567,533,1,532,0.002,0.998
27282,78569,4039,2556,1483,0.633,0.367
27283,78570,32525,27525,5000,0.846,0.154
27284,78572,75221,72979,2242,0.97,0.03
27285,78573,34890,33611,1279,0.963,0.037
27286,78574,57071,54051,3020,0.947,0.053
27287,78575,8056,7480,576,0.929,0.071
27288,78576,8775,6246,2529,0.712,0.288
27289,78577,70840,70488,352,0.995,0.005
27290,78578,12516,12137,379,0.97,0.03
27291,78579,4580,4401,179,0.961,0.039
27292,78580,14963,11925,3038,0.797,0.203
27293,78582,40455,30471,9984,0.753,0.247
27294,78583,6623,2990,3633,0.451,0.549
27295,78584,18128,16044,2084,0.885,0.115
27296,78585,396,0,396,0.0,1.0
27297,78586,55878,44644,11234,0.799,0.201
27298,78588,238,0,238,0.0,1.0
27299,78589,38004,37587,417,0.989,0.011
27300,78590,289,0,289,0.0,1.0
27301,78591,265,0,265,0.0,1.0
27302,78592,836,0,836,0.0,1.0
27303,78593,6324,3912,2412,0.619,0.381
27304,78594,1990,0,1990,0.0,1.0
27305,78595,6082,5208,874,0.856,0.144
27306,78596,63844,61502,2342,0.963,0.037
27307,78597,2885,2813,72,0.975,0.025
27308,78598,226,0,226,0.0,1.0
27309,78602,25160,13371,11789,0.531,0.469
27310,78605,4952,0,4952,0.0,1.0
27311,78606,5205,0,5205,0.0,1.0
27312,78607,166,0,166,0.0,1.0
27313,78608,434,0,434,0.0,1.0
27314,78609,2012,0,2012,0.0,1.0
27315,78610,23502,17360,6142,0.739,0.261
27316,78611,12977,5428,7549,0.418,0.582
27317,78612,11457,0,11457,0.0,1.0
27318,78613,65099,64815,284,0.996,0.004
27319,78614,456,0,456,0.0,1.0
27320,78615,1290,0,1290,0.0,1.0
27321,78616,7092,0,7092,0.0,1.0
27322,78617,22210,16135,6075,0.726,0.274
27323,78618,324,0,324,0.0,1.0
27324,78619,3026,0,3026,0.0,1.0
27325,78620,14367,1010,13357,0.07,0.93
27326,78621,21659,10043,11616,0.464,0.536
27327,78622,296,0,296,0.0,1.0
27328,78623,813,0,813,0.0,1.0
27329,78624,21513,11511,10002,0.535,0.465
27330,78626,25996,19857,6139,0.764,0.236
27331,78628,23727,20428,3299,0.861,0.139
27332,78629,11887,6877,5010,0.579,0.421
27333,78631,2395,0,2395,0.0,1.0
27334,78632,910,0,910,0.0,1.0
27335,78633,19349,14465,4884,0.748,0.252
27336,78634,22791,18313,4478,0.804,0.196
27337,78635,149,0,149,0.0,1.0
27338,78636,3749,0,3749,0.0,1.0
27339,78638,2005,0,2005,0.0,1.0
27340,78639,7334,6433,901,0.877,0.123
27341,78640,42954,34793,8161,0.81,0.19
27342,78641,44295,33522,10773,0.757,0.243
27343,78642,9467,0,9467,0.0,1.0
27344,78643,6139,2832,3307,0.461,0.539
27345,78644,17081,12337,4744,0.722,0.278
27346,78645,9773,5281,4492,0.54,0.46
27347,78648,7683,5379,2304,0.7,0.3
27348,78650,1599,0,1599,0.0,1.0
27349,78652,4466,3560,906,0.797,0.203
27350,78653,16375,8635,7740,0.527,0.473
27351,78654,17553,11720,5833,0.668,0.332
27352,78655,2739,1174,1565,0.429,0.571
27353,78656,2271,552,1719,0.243,0.757
27354,78657,5509,3118,2391,0.566,0.434
27355,78659,2903,0,2903,0.0,1.0
27356,78660,68789,66979,1810,0.974,0.026
27357,78661,335,0,335,0.0,1.0
27358,78662,2268,0,2268,0.0,1.0
27359,78663,746,0,746,0.0,1.0
27360,78664,52932,52909,23,1.0,0.0
27361,78665,35985,35188,797,0.978,0.022
27362,78666,63836,51516,12320,0.807,0.193
27363,78669,8731,0,8731,0.0,1.0
27364,78670,168,0,168,0.0,1.0
27365,78671,654,0,654,0.0,1.0
27366,78672,931,0,931,0.0,1.0
27367,78675,188,0,188,0.0,1.0
27368,78676,12602,5032,7570,0.399,0.601
27369,78677,92,0,92,0.0,1.0
27370,78681,50606,49278,1328,0.974,0.026
27371,78701,6841,6841,0,1.0,0.0
27372,78702,21334,21334,0,1.0,0.0
27373,78703,19690,19690,0,1.0,0.0
27374,78704,42117,42117,0,1.0,0.0
27375,78705,31340,31340,0,1.0,0.0
27376,78712,860,860,0,1.0,0.0
27377,78717,22538,22453,85,0.996,0.004
27378,78719,1764,176,1588,0.1,0.9
27379,78721,11425,11425,0,1.0,0.0
27380,78722,5901,5901,0,1.0,0.0
27381,78723,28330,28330,0,1.0,0.0
27382,78724,21696,21476,220,0.99,0.01
27383,78725,6083,5288,795,0.869,0.131
27384,78726,13122,13000,122,0.991,0.009
27385,78727,26689,26689,0,1.0,0.0
27386,78728,20299,20299,0,1.0,0.0
27387,78729,27108,27108,0,1.0,0.0
27388,78730,7955,7849,106,0.987,0.013
27389,78731,24614,24614,0,1.0,0.0
27390,78732,14060,13668,392,0.972,0.028
27391,78733,8762,8762,0,1.0,0.0
27392,78734,17655,16796,859,0.951,0.049
27393,78735,16131,14567,1564,0.903,0.097
27394,78736,6946,5158,1788,0.743,0.257
27395,78737,12081,3721,8360,0.308,0.692
27396,78738,12134,10642,1492,0.877,0.123
27397,78739,16792,16078,714,0.957,0.043
27398,78741,44935,44935,0,1.0,0.0
27399,78742,820,581,239,0.709,0.291
27400,78744,42820,42134,686,0.984,0.016
27401,78745,55614,55614,0,1.0,0.0
27402,78746,26928,26926,2,1.0,0.0
27403,78747,14808,11948,2860,0.807,0.193
27404,78748,40651,40651,0,1.0,0.0
27405,78749,34449,34449,0,1.0,0.0
27406,78750,26814,26329,485,0.982,0.018
27407,78751,14385,14385,0,1.0,0.0
27408,78752,18064,18064,0,1.0,0.0
27409,78753,49301,49301,0,1.0,0.0
27410,78754,15036,14559,477,0.968,0.032
27411,78756,7194,7194,0,1.0,0.0
27412,78757,21310,21310,0,1.0,0.0
27413,78758,44072,44072,0,1.0,0.0
27414,78759,38891,38878,13,1.0,0.0
27415,78801,21780,17965,3815,0.825,0.175
27416,78802,242,153,89,0.632,0.368
27417,78827,1219,0,1219,0.0,1.0
27418,78828,258,0,258,0.0,1.0
27419,78829,1207,0,1207,0.0,1.0
27420,78830,786,0,786,0.0,1.0
27421,78832,3598,2862,736,0.795,0.205
27422,78833,1299,0,1299,0.0,1.0
27423,78834,7829,6050,1779,0.773,0.227
27424,78836,128,0,128,0.0,1.0
27425,78837,281,0,281,0.0,1.0
27426,78838,275,0,275,0.0,1.0
27427,78839,8578,7236,1342,0.844,0.156
27428,78840,48149,43602,4547,0.906,0.094
27429,78843,336,312,24,0.929,0.071
27430,78850,1145,0,1145,0.0,1.0
27431,78851,23,0,23,0.0,1.0
27432,78852,53040,49236,3804,0.928,0.072
27433,78860,229,0,229,0.0,1.0
27434,78861,13701,6427,7274,0.469,0.531
27435,78870,984,0,984,0.0,1.0
27436,78871,45,0,45,0.0,1.0
27437,78872,1905,0,1905,0.0,1.0
27438,78873,1788,0,1788,0.0,1.0
27439,78877,989,0,989,0.0,1.0
27440,78879,264,0,264,0.0,1.0
27441,78880,1682,0,1682,0.0,1.0
27442,78881,2335,0,2335,0.0,1.0
27443,78883,353,0,353,0.0,1.0
27444,78884,1158,0,1158,0.0,1.0
27445,78885,120,0,120,0.0,1.0
27446,78886,647,0,647,0.0,1.0
27447,78931,323,0,323,0.0,1.0
27448,78932,757,0,757,0.0,1.0
27449,78933,1433,0,1433,0.0,1.0
27450,78934,6712,3902,2810,0.581,0.419
27451,78935,978,0,978,0.0,1.0
27452,78938,471,0,471,0.0,1.0
27453,78940,2098,0,2098,0.0,1.0
27454,78941,2962,0,2962,0.0,1.0
27455,78942,8989,5030,3959,0.56,0.44
27456,78943,352,274,78,0.778,0.222
27457,78944,562,0,562,0.0,1.0
27458,78945,10494,5343,5151,0.509,0.491
27459,78946,960,0,960,0.0,1.0
27460,78947,4475,0,4475,0.0,1.0
27461,78948,850,0,850,0.0,1.0
27462,78949,517,0,517,0.0,1.0
27463,78950,2038,0,2038,0.0,1.0
27464,78951,26,0,26,0.0,1.0
27465,78953,934,0,934,0.0,1.0
27466,78954,1071,0,1071,0.0,1.0
27467,78956,5381,2726,2655,0.507,0.493
27468,78957,9067,3750,5317,0.414,0.586
27469,78959,1837,0,1837,0.0,1.0
27470,78962,4733,0,4733,0.0,1.0
27471,78963,909,0,909,0.0,1.0
27472,79001,249,0,249,0.0,1.0
27473,79003,162,0,162,0.0,1.0
27474,79005,1735,0,1735,0.0,1.0
27475,79007,14542,13574,968,0.933,0.067
27476,79009,2166,0,2166,0.0,1.0
27477,79010,802,0,802,0.0,1.0
27478,79011,236,0,236,0.0,1.0
27479,79012,976,0,976,0.0,1.0
27480,79013,3423,3292,131,0.962,0.038
27481,79014,3771,2781,990,0.737,0.263
27482,79015,19277,14075,5202,0.73,0.27
27483,79016,94,94,0,1.0,0.0
27484,79018,548,0,548,0.0,1.0
27485,79019,1707,0,1707,0.0,1.0
27486,79021,138,0,138,0.0,1.0
27487,79022,10741,7716,3025,0.718,0.282
27488,79024,405,0,405,0.0,1.0
27489,79025,69,0,69,0.0,1.0
27490,79027,5223,4373,850,0.837,0.163
27491,79029,16177,14836,1341,0.917,0.083
27492,79031,1425,0,1425,0.0,1.0
27493,79032,157,0,157,0.0,1.0
27494,79033,109,0,109,0.0,1.0
27495,79034,637,0,637,0.0,1.0
27496,79035,5309,4106,1203,0.773,0.227
27497,79036,5128,3968,1160,0.774,0.226
27498,79039,779,0,779,0.0,1.0
27499,79040,1839,0,1839,0.0,1.0
27500,79041,3194,0,3194,0.0,1.0
27501,79042,1169,0,1169,0.0,1.0
27502,79043,1487,0,1487,0.0,1.0
27503,79044,766,0,766,0.0,1.0
27504,79045,19473,15941,3532,0.819,0.181
27505,79046,489,0,489,0.0,1.0
27506,79051,29,0,29,0.0,1.0
27507,79052,1259,0,1259,0.0,1.0
27508,79053,137,0,137,0.0,1.0
27509,79054,594,0,594,0.0,1.0
27510,79056,63,0,63,0.0,1.0
27511,79057,1206,0,1206,0.0,1.0
27512,79058,10,0,10,0.0,1.0
27513,79059,837,0,837,0.0,1.0
27514,79061,316,0,316,0.0,1.0
27515,79062,218,0,218,0.0,1.0
27516,79063,686,0,686,0.0,1.0
27517,79064,2739,0,2739,0.0,1.0
27518,79065,20840,18166,2674,0.872,0.128
27519,79068,3197,0,3197,0.0,1.0
27520,79070,9919,8801,1118,0.887,0.113
27521,79072,28849,25810,3039,0.895,0.105
27522,79078,377,0,377,0.0,1.0
27523,79079,2646,0,2646,0.0,1.0
27524,79080,605,0,605,0.0,1.0
27525,79081,3912,3349,563,0.856,0.144
27526,79082,315,0,315,0.0,1.0
27527,79083,2661,0,2661,0.0,1.0
27528,79084,2366,0,2366,0.0,1.0
27529,79085,53,0,53,0.0,1.0
27530,79086,2105,0,2105,0.0,1.0
27531,79087,751,0,751,0.0,1.0
27532,79088,5945,4903,1042,0.825,0.175
27533,79091,147,0,147,0.0,1.0
27534,79092,1106,0,1106,0.0,1.0
27535,79093,69,0,69,0.0,1.0
27536,79094,75,0,75,0.0,1.0
27537,79095,2686,0,2686,0.0,1.0
27538,79096,2229,0,2229,0.0,1.0
27539,79097,1150,0,1150,0.0,1.0
27540,79098,517,0,517,0.0,1.0
27541,79101,2817,2817,0,1.0,0.0
27542,79102,9963,9963,0,1.0,0.0
27543,79103,10594,10385,209,0.98,0.02
27544,79104,7869,7649,220,0.972,0.028
27545,79105,6,0,6,0.0,1.0
27546,79106,27967,27934,33,0.999,0.001
27547,79107,33844,33700,144,0.996,0.004
27548,79108,17726,13063,4663,0.737,0.263
27549,79109,43516,43516,0,1.0,0.0
27550,79110,18811,18811,0,1.0,0.0
27551,79111,1808,0,1808,0.0,1.0
27552,79118,19726,10734,8992,0.544,0.456
27553,79119,11539,9219,2320,0.799,0.201
27554,79121,6575,6575,0,1.0,0.0
27555,79124,7819,5016,2803,0.642,0.358
27556,79201,7040,4707,2333,0.669,0.331
27557,79220,197,0,197,0.0,1.0
27558,79225,976,0,976,0.0,1.0
27559,79226,3153,0,3153,0.0,1.0
27560,79227,1406,0,1406,0.0,1.0
27561,79229,424,0,424,0.0,1.0
27562,79230,158,0,158,0.0,1.0
27563,79231,45,0,45,0.0,1.0
27564,79233,180,0,180,0.0,1.0
27565,79234,110,0,110,0.0,1.0
27566,79235,3833,3009,824,0.785,0.215
27567,79236,262,0,262,0.0,1.0
27568,79237,513,0,513,0.0,1.0
27569,79239,211,0,211,0.0,1.0
27570,79240,60,0,60,0.0,1.0
27571,79241,2480,0,2480,0.0,1.0
27572,79243,90,0,90,0.0,1.0
27573,79244,720,0,720,0.0,1.0
27574,79245,2476,0,2476,0.0,1.0
27575,79247,64,0,64,0.0,1.0
27576,79248,1493,0,1493,0.0,1.0
27577,79250,1508,0,1508,0.0,1.0
27578,79251,45,0,45,0.0,1.0
27579,79252,3202,0,3202,0.0,1.0
27580,79255,571,0,571,0.0,1.0
27581,79256,319,0,319,0.0,1.0
27582,79257,1067,0,1067,0.0,1.0
27583,79258,67,0,67,0.0,1.0
27584,79259,48,0,48,0.0,1.0
27585,79261,527,0,527,0.0,1.0
27586,79311,3445,2785,660,0.808,0.192
27587,79312,971,0,971,0.0,1.0
27588,79313,1571,0,1571,0.0,1.0
27589,79314,56,0,56,0.0,1.0
27590,79316,11451,9530,1921,0.832,0.168
27591,79322,2049,0,2049,0.0,1.0
27592,79323,6559,4938,1621,0.753,0.247
27593,79324,61,0,61,0.0,1.0
27594,79325,2319,0,2319,0.0,1.0
27595,79326,40,0,40,0.0,1.0
27596,79329,3300,0,3300,0.0,1.0
27597,79330,114,0,114,0.0,1.0
27598,79331,13258,11579,1679,0.873,0.127
27599,79336,16972,13796,3176,0.813,0.187
27600,79339,7230,5914,1316,0.818,0.182
27601,79342,352,0,352,0.0,1.0
27602,79343,1571,0,1571,0.0,1.0
27603,79344,56,0,56,0.0,1.0
27604,79345,920,0,920,0.0,1.0
27605,79346,2427,0,2427,0.0,1.0
27606,79347,7462,5105,2357,0.684,0.316
27607,79350,392,0,392,0.0,1.0
27608,79351,1326,0,1326,0.0,1.0
27609,79353,10,0,10,0.0,1.0
27610,79355,1942,0,1942,0.0,1.0
27611,79356,6363,5018,1345,0.789,0.211
27612,79357,2303,0,2303,0.0,1.0
27613,79358,1116,0,1116,0.0,1.0
27614,79359,2899,0,2899,0.0,1.0
27615,79360,13574,6477,7097,0.477,0.523
27616,79363,5369,3229,2140,0.601,0.399
27617,79364,8172,5938,2234,0.727,0.273
27618,79366,1096,0,1096,0.0,1.0
27619,79367,645,0,645,0.0,1.0
27620,79369,88,0,88,0.0,1.0
27621,79370,1889,0,1889,0.0,1.0
27622,79371,1317,0,1317,0.0,1.0
27623,79372,1434,0,1434,0.0,1.0
27624,79373,3307,2560,747,0.774,0.226
27625,79376,95,0,95,0.0,1.0
27626,79377,277,0,277,0.0,1.0
27627,79378,236,0,236,0.0,1.0
27628,79379,666,0,666,0.0,1.0
27629,79380,197,0,197,0.0,1.0
27630,79381,1263,0,1263,0.0,1.0
27631,79382,6291,3899,2392,0.62,0.38
27632,79401,8408,8408,0,1.0,0.0
27633,79403,16869,11705,5164,0.694,0.306
27634,79404,11289,10273,1016,0.91,0.09
27635,79406,6025,6025,0,1.0,0.0
27636,79407,19068,16275,2793,0.854,0.146
27637,79410,9429,9429,0,1.0,0.0
27638,79411,7951,7951,0,1.0,0.0
27639,79412,15650,15650,0,1.0,0.0
27640,79413,21187,21187,0,1.0,0.0
27641,79414,17121,17121,0,1.0,0.0
27642,79415,17689,14287,3402,0.808,0.192
27643,79416,32296,29771,2525,0.922,0.078
27644,79423,32277,28031,4246,0.868,0.132
27645,79424,39023,37344,1679,0.957,0.043
27646,79501,3528,0,3528,0.0,1.0
27647,79502,1350,0,1350,0.0,1.0
27648,79503,175,0,175,0.0,1.0
27649,79504,2787,51,2736,0.018,0.982
27650,79505,296,0,296,0.0,1.0
27651,79506,730,0,730,0.0,1.0
27652,79508,1242,0,1242,0.0,1.0
27653,79510,7982,3717,4265,0.466,0.534
27654,79511,1338,0,1338,0.0,1.0
27655,79512,8197,5948,2249,0.726,0.274
27656,79517,200,0,200,0.0,1.0
27657,79518,124,0,124,0.0,1.0
27658,79519,74,0,74,0.0,1.0
27659,79520,2449,0,2449,0.0,1.0
27660,79521,3980,3090,890,0.776,0.224
27661,79525,2842,0,2842,0.0,1.0
27662,79526,979,0,979,0.0,1.0
27663,79527,251,0,251,0.0,1.0
27664,79528,619,0,619,0.0,1.0
27665,79529,1383,0,1383,0.0,1.0
27666,79530,480,0,480,0.0,1.0
27667,79532,940,0,940,0.0,1.0
27668,79533,472,0,472,0.0,1.0
27669,79534,181,0,181,0.0,1.0
27670,79535,183,0,183,0.0,1.0
27671,79536,4988,0,4988,0.0,1.0
27672,79537,111,0,111,0.0,1.0
27673,79538,271,0,271,0.0,1.0
27674,79539,178,0,178,0.0,1.0
27675,79540,89,0,89,0.0,1.0
27676,79541,791,0,791,0.0,1.0
27677,79543,1186,0,1186,0.0,1.0
27678,79544,512,0,512,0.0,1.0
27679,79545,1788,0,1788,0.0,1.0
27680,79546,2006,0,2006,0.0,1.0
27681,79547,758,0,758,0.0,1.0
27682,79548,174,0,174,0.0,1.0
27683,79549,15652,11557,4095,0.738,0.262
27684,79553,3469,3000,469,0.865,0.135
27685,79556,12995,10247,2748,0.789,0.211
27686,79560,137,0,137,0.0,1.0
27687,79561,662,0,662,0.0,1.0
27688,79562,3669,0,3669,0.0,1.0
27689,79563,1161,384,777,0.331,0.669
27690,79565,295,0,295,0.0,1.0
27691,79566,333,0,333,0.0,1.0
27692,79567,3373,2516,857,0.746,0.254
27693,79601,25085,16421,8664,0.655,0.345
27694,79602,21519,17856,3663,0.83,0.17
27695,79603,24288,23558,730,0.97,0.03
27696,79605,30098,29755,343,0.989,0.011
27697,79606,22885,19884,3001,0.869,0.131
27698,79607,2865,2242,623,0.783,0.217
27699,79699,321,321,0,1.0,0.0
27700,79701,27728,27728,0,1.0,0.0
27701,79703,20592,20592,0,1.0,0.0
27702,79705,33536,30443,3093,0.908,0.092
27703,79706,19571,8383,11188,0.428,0.572
27704,79707,32854,30661,2193,0.933,0.067
27705,79713,592,0,592,0.0,1.0
27706,79714,14786,12346,2440,0.835,0.165
27707,79718,721,0,721,0.0,1.0
27708,79719,397,0,397,0.0,1.0
27709,79720,33640,27987,5653,0.832,0.168
27710,79730,250,0,250,0.0,1.0
27711,79731,4193,3907,286,0.932,0.068
27712,79733,210,0,210,0.0,1.0
27713,79734,2137,0,2137,0.0,1.0
27714,79735,13315,9339,3976,0.701,0.299
27715,79738,275,0,275,0.0,1.0
27716,79739,963,0,963,0.0,1.0
27717,79741,288,0,288,0.0,1.0
27718,79742,490,0,490,0.0,1.0
27719,79743,339,0,339,0.0,1.0
27720,79744,1362,0,1362,0.0,1.0
27721,79745,6125,5821,304,0.95,0.05
27722,79748,173,0,173,0.0,1.0
27723,79749,255,0,255,0.0,1.0
27724,79752,2245,0,2245,0.0,1.0
27725,79754,80,0,80,0.0,1.0
27726,79755,230,0,230,0.0,1.0
27727,79756,9066,7686,1380,0.848,0.152
27728,79758,2197,0,2197,0.0,1.0
27729,79759,23,0,23,0.0,1.0
27730,79761,30488,30481,7,1.0,0.0
27731,79762,39056,38791,265,0.993,0.007
27732,79763,34079,30540,3539,0.896,0.104
27733,79764,20725,19209,1516,0.927,0.073
27734,79765,6927,6309,618,0.911,0.089
27735,79766,6115,1075,5040,0.176,0.824
27736,79770,33,0,33,0.0,1.0
27737,79772,12747,11785,962,0.925,0.075
27738,79777,170,0,170,0.0,1.0
27739,79778,878,0,878,0.0,1.0
27740,79780,224,0,224,0.0,1.0
27741,79781,303,0,303,0.0,1.0
27742,79782,3976,0,3976,0.0,1.0
27743,79783,201,0,201,0.0,1.0
27744,79785,91,0,91,0.0,1.0
27745,79788,506,0,506,0.0,1.0
27746,79789,974,0,974,0.0,1.0
27747,79821,7142,6656,486,0.932,0.068
27748,79830,7682,6013,1669,0.783,0.217
27749,79831,29,0,29,0.0,1.0
27750,79834,200,0,200,0.0,1.0
27751,79835,12690,12175,515,0.959,0.041
27752,79836,5772,4135,1637,0.716,0.284
27753,79837,579,0,579,0.0,1.0
27754,79838,8699,8042,657,0.924,0.076
27755,79839,1938,0,1938,0.0,1.0
27756,79842,498,0,498,0.0,1.0
27757,79843,2503,0,2503,0.0,1.0
27758,79845,5138,4654,484,0.906,0.094
27759,79846,104,0,104,0.0,1.0
27760,79847,167,0,167,0.0,1.0
27761,79848,927,0,927,0.0,1.0
27762,79849,13208,12965,243,0.982,0.018
27763,79851,641,0,641,0.0,1.0
27764,79852,799,0,799,0.0,1.0
27765,79853,3729,2822,907,0.757,0.243
27766,79854,213,0,213,0.0,1.0
27767,79855,2336,0,2336,0.0,1.0
27768,79901,11328,11328,0,1.0,0.0
27769,79902,21236,21236,0,1.0,0.0
27770,79903,18451,18451,0,1.0,0.0
27771,79904,35060,34841,219,0.994,0.006
27772,79905,26036,26036,0,1.0,0.0
27773,79906,4374,4374,0,1.0,0.0
27774,79907,55132,55132,0,1.0,0.0
27775,79908,3673,3673,0,1.0,0.0
27776,79911,1565,476,1089,0.304,0.696
27777,79912,77161,76672,489,0.994,0.006
27778,79915,40057,40057,0,1.0,0.0
27779,79916,2995,2995,0,1.0,0.0
27780,79920,153,153,0,1.0,0.0
27781,79922,8935,8935,0,1.0,0.0
27782,79924,59058,59058,0,1.0,0.0
27783,79925,40641,40639,2,1.0,0.0
27784,79927,39016,38919,97,0.998,0.002
27785,79928,49544,46307,3237,0.935,0.065
27786,79930,28410,27000,1410,0.95,0.05
27787,79932,24986,24530,456,0.982,0.018
27788,79934,19174,17215,1959,0.898,0.102
27789,79935,18042,18042,0,1.0,0.0
27790,79936,111086,111086,0,1.0,0.0
27791,79938,53520,49261,4259,0.92,0.08
27792,79942,2,0,2,0.0,1.0
27793,80002,18020,18020,0,1.0,0.0
27794,80003,35384,35384,0,1.0,0.0
27795,80004,35892,35892,0,1.0,0.0
27796,80005,25553,25478,75,0.997,0.003
27797,80007,7262,6817,445,0.939,0.061
27798,80010,39728,39728,0,1.0,0.0
27799,80011,47461,47421,40,0.999,0.001
27800,80012,46665,46665,0,1.0,0.0
27801,80013,69588,69342,246,0.996,0.004
27802,80014,36710,36710,0,1.0,0.0
27803,80015,62432,62432,0,1.0,0.0
27804,80016,41219,40879,340,0.992,0.008
27805,80017,34270,34270,0,1.0,0.0
27806,80018,9206,7930,1276,0.861,0.139
27807,80019,1690,1637,53,0.969,0.031
27808,80020,46871,46785,86,0.998,0.002
27809,80021,30051,30039,12,1.0,0.0
27810,80022,42699,41249,1450,0.966,0.034
27811,80023,15415,14948,467,0.97,0.03
27812,80024,228,228,0,1.0,0.0
27813,80025,253,118,135,0.466,0.534
27814,80026,26378,25574,804,0.97,0.03
27815,80027,31034,30862,172,0.994,0.006
27816,80030,15329,15329,0,1.0,0.0
27817,80031,33932,33932,0,1.0,0.0
27818,80033,23969,23969,0,1.0,0.0
27819,80045,277,277,0,1.0,0.0
27820,80101,392,0,392,0.0,1.0
27821,80102,5514,0,5514,0.0,1.0
27822,80103,2458,0,2458,0.0,1.0
27823,80104,27588,24896,2692,0.902,0.098
27824,80105,1171,0,1171,0.0,1.0
27825,80106,4232,29,4203,0.007,0.993
27826,80107,12042,0,12042,0.0,1.0
27827,80108,22612,20997,1615,0.929,0.071
27828,80109,17219,15467,1752,0.898,0.102
27829,80110,20867,20867,0,1.0,0.0
27830,80111,28948,28948,0,1.0,0.0
27831,80112,29217,29214,3,1.0,0.0
27832,80113,20562,20562,0,1.0,0.0
27833,80116,3942,0,3942,0.0,1.0
27834,80117,2587,0,2587,0.0,1.0
27835,80118,5308,49,5259,0.009,0.991
27836,80120,28435,28435,0,1.0,0.0
27837,80121,17853,17853,0,1.0,0.0
27838,80122,29783,29783,0,1.0,0.0
27839,80123,44795,44795,0,1.0,0.0
27840,80124,18020,17743,277,0.985,0.015
27841,80125,10190,8530,1660,0.837,0.163
27842,80126,39698,39623,75,0.998,0.002
27843,80127,42597,41364,1233,0.971,0.029
27844,80128,34988,34988,0,1.0,0.0
27845,80129,27007,26901,106,0.996,0.004
27846,80130,27054,27054,0,1.0,0.0
27847,80131,243,0,243,0.0,1.0
27848,80132,19637,14807,4830,0.754,0.246
27849,80133,2042,1925,117,0.943,0.057
27850,80134,55075,51888,3187,0.942,0.058
27851,80135,3833,12,3821,0.003,0.997
27852,80136,4834,0,4834,0.0,1.0
27853,80137,1323,0,1323,0.0,1.0
27854,80138,29786,20872,8914,0.701,0.299
27855,80202,10148,10148,0,1.0,0.0
27856,80203,18839,18839,0,1.0,0.0
27857,80204,31493,31493,0,1.0,0.0
27858,80205,29221,29221,0,1.0,0.0
27859,80206,21521,21521,0,1.0,0.0
27860,80207,21216,21216,0,1.0,0.0
27861,80209,21526,21526,0,1.0,0.0
27862,80210,33946,33946,0,1.0,0.0
27863,80211,31583,31583,0,1.0,0.0
27864,80212,18051,18051,0,1.0,0.0
27865,80214,24821,24821,0,1.0,0.0
27866,80215,17843,17843,0,1.0,0.0
27867,80216,10924,10924,0,1.0,0.0
27868,80218,17928,17928,0,1.0,0.0
27869,80219,61296,61296,0,1.0,0.0
27870,80220,33529,33529,0,1.0,0.0
27871,80221,37779,37779,0,1.0,0.0
27872,80222,20073,20073,0,1.0,0.0
27873,80223,17987,17987,0,1.0,0.0
27874,80224,17256,17256,0,1.0,0.0
27875,80226,30930,30930,0,1.0,0.0
27876,80227,33667,33667,0,1.0,0.0
27877,80228,30138,29709,429,0.986,0.014
27878,80229,49598,49598,0,1.0,0.0
27879,80230,7559,7559,0,1.0,0.0
27880,80231,32127,32127,0,1.0,0.0
27881,80232,21411,21411,0,1.0,0.0
27882,80233,45386,45380,6,1.0,0.0
27883,80234,25937,25937,0,1.0,0.0
27884,80235,7571,7571,0,1.0,0.0
27885,80236,16123,16123,0,1.0,0.0
27886,80237,17569,17569,0,1.0,0.0
27887,80238,10058,10058,0,1.0,0.0
27888,80239,40512,40512,0,1.0,0.0
27889,80241,31746,31746,0,1.0,0.0
27890,80246,12875,12875,0,1.0,0.0
27891,80247,25449,25449,0,1.0,0.0
27892,80249,23404,23404,0,1.0,0.0
27893,80260,31412,31412,0,1.0,0.0
27894,80264,0,0,0,,
27895,80290,0,0,0,,
27896,80293,0,0,0,,
27897,80294,0,0,0,,
27898,80301,22555,20674,1881,0.917,0.083
27899,80302,26941,21785,5156,0.809,0.191
27900,80303,22361,21317,1044,0.953,0.047
27901,80304,25623,24524,1099,0.957,0.043
27902,80305,16874,16564,310,0.982,0.018
27903,80310,6578,6578,0,1.0,0.0
27904,80401,39378,35588,3790,0.904,0.096
27905,80403,18211,13282,4929,0.729,0.271
27906,80419,0,0,0,,
27907,80420,933,0,933,0.0,1.0
27908,80421,8042,0,8042,0.0,1.0
27909,80422,4326,0,4326,0.0,1.0
27910,80423,169,0,169,0.0,1.0
27911,80424,9627,7179,2448,0.746,0.254
27912,80425,184,0,184,0.0,1.0
27913,80426,104,0,104,0.0,1.0
27914,80427,822,0,822,0.0,1.0
27915,80428,706,0,706,0.0,1.0
27916,80432,439,0,439,0.0,1.0
27917,80433,8354,0,8354,0.0,1.0
27918,80434,43,0,43,0.0,1.0
27919,80435,7278,5993,1285,0.823,0.177
27920,80436,565,0,565,0.0,1.0
27921,80438,486,0,486,0.0,1.0
27922,80439,23778,10064,13714,0.423,0.577
27923,80440,2422,0,2422,0.0,1.0
27924,80442,2309,1723,586,0.746,0.254
27925,80443,3676,3255,421,0.885,0.115
27926,80444,1080,0,1080,0.0,1.0
27927,80446,3715,0,3715,0.0,1.0
27928,80447,1964,0,1964,0.0,1.0
27929,80448,193,0,193,0.0,1.0
27930,80449,909,0,909,0.0,1.0
27931,80451,753,0,753,0.0,1.0
27932,80452,3097,0,3097,0.0,1.0
27933,80453,197,0,197,0.0,1.0
27934,80454,1224,0,1224,0.0,1.0
27935,80455,497,0,497,0.0,1.0
27936,80456,620,0,620,0.0,1.0
27937,80457,612,598,14,0.977,0.023
27938,80459,2450,0,2450,0.0,1.0
27939,80461,7090,5039,2051,0.711,0.289
27940,80463,136,0,136,0.0,1.0
27941,80465,15147,10325,4822,0.682,0.318
27942,80466,3338,0,3338,0.0,1.0
27943,80467,2224,0,2224,0.0,1.0
27944,80468,391,0,391,0.0,1.0
27945,80469,337,0,337,0.0,1.0
27946,80470,3287,0,3287,0.0,1.0
27947,80471,23,0,23,0.0,1.0
27948,80473,51,0,51,0.0,1.0
27949,80475,57,0,57,0.0,1.0
27950,80476,194,0,194,0.0,1.0
27951,80477,155,155,0,1.0,0.0
27952,80478,1606,0,1606,0.0,1.0
27953,80479,48,0,48,0.0,1.0
27954,80480,1300,0,1300,0.0,1.0
27955,80481,572,0,572,0.0,1.0
27956,80482,1630,860,770,0.528,0.472
27957,80483,585,0,585,0.0,1.0
27958,80487,16745,12576,4169,0.751,0.249
27959,80488,157,157,0,1.0,0.0
27960,80497,411,371,40,0.903,0.097
27961,80498,7002,5732,1270,0.819,0.181
27962,80501,39521,39459,62,0.998,0.002
27963,80503,31064,26110,4954,0.841,0.159
27964,80504,46876,42666,4210,0.91,0.09
27965,80510,420,0,420,0.0,1.0
27966,80511,76,76,0,1.0,0.0
27967,80512,2185,0,2185,0.0,1.0
27968,80513,10296,5068,5228,0.492,0.508
27969,80514,4106,3623,483,0.882,0.118
27970,80515,1010,0,1010,0.0,1.0
27971,80516,20254,18060,2194,0.892,0.108
27972,80517,9313,7006,2307,0.752,0.248
27973,80520,1498,1498,0,1.0,0.0
27974,80521,33409,33072,337,0.99,0.01
27975,80524,31668,26643,5025,0.841,0.159
27976,80525,48419,47830,589,0.988,0.012
27977,80526,44183,42115,2068,0.953,0.047
27978,80528,17946,17568,378,0.979,0.021
27979,80530,3790,3738,52,0.986,0.014
27980,80532,165,0,165,0.0,1.0
27981,80534,11301,9501,1800,0.841,0.159
27982,80535,2636,1575,1061,0.597,0.403
27983,80536,1759,0,1759,0.0,1.0
27984,80537,38821,34173,4648,0.88,0.12
27985,80538,43930,40805,3125,0.929,0.071
27986,80540,4461,0,4461,0.0,1.0
27987,80542,3631,0,3631,0.0,1.0
27988,80543,5887,4651,1236,0.79,0.21
27989,80544,111,111,0,1.0,0.0
27990,80545,851,0,851,0.0,1.0
27991,80546,149,149,0,1.0,0.0
27992,80547,624,168,456,0.269,0.731
27993,80549,8642,6224,2418,0.72,0.28
27994,80550,20675,17285,3390,0.836,0.164
27995,80601,33833,32866,967,0.971,0.029
27996,80602,27665,26315,1350,0.951,0.049
27997,80603,11973,7589,4384,0.634,0.366
27998,80610,2791,0,2791,0.0,1.0
27999,80611,659,0,659,0.0,1.0
28000,80612,430,0,430,0.0,1.0
28001,80615,7482,4671,2811,0.624,0.376
28002,80620,17775,17684,91,0.995,0.005
28003,80621,12079,8812,3267,0.73,0.27
28004,80622,268,0,268,0.0,1.0
28005,80623,1028,0,1028,0.0,1.0
28006,80624,946,0,946,0.0,1.0
28007,80631,48603,45790,2813,0.942,0.058
28008,80634,52861,52322,539,0.99,0.01
28009,80640,11054,10936,118,0.989,0.011
28010,80642,4309,0,4309,0.0,1.0
28011,80643,3011,0,3011,0.0,1.0
28012,80644,2989,0,2989,0.0,1.0
28013,80645,3905,1975,1930,0.506,0.494
28014,80648,1001,0,1001,0.0,1.0
28015,80649,299,0,299,0.0,1.0
28016,80650,1432,0,1432,0.0,1.0
28017,80651,4176,0,4176,0.0,1.0
28018,80652,574,0,574,0.0,1.0
28019,80653,791,0,791,0.0,1.0
28020,80654,2359,0,2359,0.0,1.0
28021,80701,16042,12295,3747,0.766,0.234
28022,80705,884,883,1,0.999,0.001
28023,80720,2558,0,2558,0.0,1.0
28024,80721,154,0,154,0.0,1.0
28025,80722,349,0,349,0.0,1.0
28026,80723,7179,5816,1363,0.81,0.19
28027,80726,381,0,381,0.0,1.0
28028,80727,425,0,425,0.0,1.0
28029,80728,878,0,878,0.0,1.0
28030,80729,540,0,540,0.0,1.0
28031,80731,1494,0,1494,0.0,1.0
28032,80733,529,0,529,0.0,1.0
28033,80734,3045,0,3045,0.0,1.0
28034,80735,405,0,405,0.0,1.0
28035,80736,648,0,648,0.0,1.0
28036,80737,1537,0,1537,0.0,1.0
28037,80740,108,0,108,0.0,1.0
28038,80741,935,0,935,0.0,1.0
28039,80742,225,0,225,0.0,1.0
28040,80743,1074,0,1074,0.0,1.0
28041,80744,488,0,488,0.0,1.0
28042,80745,156,0,156,0.0,1.0
28043,80746,29,0,29,0.0,1.0
28044,80747,462,0,462,0.0,1.0
28045,80749,341,0,341,0.0,1.0
28046,80750,412,0,412,0.0,1.0
28047,80751,18857,16088,2769,0.853,0.147
28048,80754,164,0,164,0.0,1.0
28049,80755,163,0,163,0.0,1.0
28050,80757,255,0,255,0.0,1.0
28051,80758,3795,0,3795,0.0,1.0
28052,80759,4698,3524,1174,0.75,0.25
28053,80801,154,0,154,0.0,1.0
28054,80802,238,0,238,0.0,1.0
28055,80804,327,0,327,0.0,1.0
28056,80805,453,0,453,0.0,1.0
28057,80807,5304,4243,1061,0.8,0.2
28058,80808,6351,0,6351,0.0,1.0
28059,80809,1519,1189,330,0.783,0.217
28060,80810,1127,0,1127,0.0,1.0
28061,80812,275,0,275,0.0,1.0
28062,80813,2055,0,2055,0.0,1.0
28063,80814,4023,0,4023,0.0,1.0
28064,80815,911,0,911,0.0,1.0
28065,80816,5180,0,5180,0.0,1.0
28066,80817,27311,25834,1477,0.946,0.054
28067,80818,343,0,343,0.0,1.0
28068,80819,921,607,314,0.659,0.341
28069,80820,806,0,806,0.0,1.0
28070,80821,1093,0,1093,0.0,1.0
28071,80822,260,0,260,0.0,1.0
28072,80823,203,0,203,0.0,1.0
28073,80824,207,0,207,0.0,1.0
28074,80825,422,0,422,0.0,1.0
28075,80827,549,0,549,0.0,1.0
28076,80828,3341,0,3341,0.0,1.0
28077,80829,5476,4977,499,0.909,0.091
28078,80830,254,0,254,0.0,1.0
28079,80831,21993,12061,9932,0.548,0.452
28080,80832,666,0,666,0.0,1.0
28081,80833,754,0,754,0.0,1.0
28082,80834,318,0,318,0.0,1.0
28083,80835,911,0,911,0.0,1.0
28084,80836,1157,0,1157,0.0,1.0
28085,80840,6682,5512,1170,0.825,0.175
28086,80860,594,0,594,0.0,1.0
28087,80861,255,0,255,0.0,1.0
28088,80862,31,0,31,0.0,1.0
28089,80863,11754,8732,3022,0.743,0.257
28090,80864,1325,0,1325,0.0,1.0
28091,80902,12289,10976,1313,0.893,0.107
28092,80903,15057,15057,0,1.0,0.0
28093,80904,19867,19419,448,0.977,0.023
28094,80905,16254,16254,0,1.0,0.0
28095,80906,37719,36496,1223,0.968,0.032
28096,80907,26758,26758,0,1.0,0.0
28097,80908,13827,1351,12476,0.098,0.902
28098,80909,35739,35739,0,1.0,0.0
28099,80910,28794,28794,0,1.0,0.0
28100,80911,30596,30573,23,0.999,0.001
28101,80913,2988,2804,184,0.938,0.062
28102,80914,386,386,0,1.0,0.0
28103,80915,19519,19519,0,1.0,0.0
28104,80916,34640,34640,0,1.0,0.0
28105,80917,29273,29273,0,1.0,0.0
28106,80918,45467,45467,0,1.0,0.0
28107,80919,27398,26752,646,0.976,0.024
28108,80920,38569,38451,118,0.997,0.003
28109,80921,18999,16302,2697,0.858,0.142
28110,80922,26549,26549,0,1.0,0.0
28111,80923,26105,26097,8,1.0,0.0
28112,80924,4534,3767,767,0.831,0.169
28113,80925,5906,3041,2865,0.515,0.485
28114,80926,1403,643,760,0.458,0.542
28115,80927,604,416,188,0.689,0.311
28116,80928,1202,0,1202,0.0,1.0
28117,80929,231,7,224,0.03,0.97
28118,80930,821,0,821,0.0,1.0
28119,80938,17,1,16,0.059,0.941
28120,80939,0,0,0,,
28121,80951,4202,4195,7,0.998,0.002
28122,81001,30498,29473,1025,0.966,0.034
28123,81003,14939,14874,65,0.996,0.004
28124,81004,25540,24096,1444,0.943,0.057
28125,81005,29975,28694,1281,0.957,0.043
28126,81006,11513,8488,3025,0.737,0.263
28127,81007,29709,22024,7685,0.741,0.259
28128,81008,9641,8901,740,0.923,0.077
28129,81019,1690,0,1690,0.0,1.0
28130,81020,954,0,954,0.0,1.0
28131,81021,14,0,14,0.0,1.0
28132,81022,1560,0,1560,0.0,1.0
28133,81023,1236,0,1236,0.0,1.0
28134,81024,134,0,134,0.0,1.0
28135,81025,1071,0,1071,0.0,1.0
28136,81027,125,0,125,0.0,1.0
28137,81029,326,0,326,0.0,1.0
28138,81030,193,0,193,0.0,1.0
28139,81033,155,0,155,0.0,1.0
28140,81036,962,0,962,0.0,1.0
28141,81038,486,0,486,0.0,1.0
28142,81039,1856,0,1856,0.0,1.0
28143,81040,536,0,536,0.0,1.0
28144,81041,760,0,760,0.0,1.0
28145,81043,61,0,61,0.0,1.0
28146,81044,224,0,224,0.0,1.0
28147,81045,88,0,88,0.0,1.0
28148,81047,1559,0,1559,0.0,1.0
28149,81049,289,0,289,0.0,1.0
28150,81050,9894,7668,2226,0.775,0.225
28151,81052,9534,7796,1738,0.818,0.182
28152,81054,5134,4032,1102,0.785,0.215
28153,81055,1339,0,1339,0.0,1.0
28154,81057,418,0,418,0.0,1.0
28155,81058,990,0,990,0.0,1.0
28156,81059,651,0,651,0.0,1.0
28157,81062,2439,0,2439,0.0,1.0
28158,81063,2726,0,2726,0.0,1.0
28159,81064,282,0,282,0.0,1.0
28160,81067,5670,4161,1509,0.734,0.266
28161,81069,1888,0,1888,0.0,1.0
28162,81071,334,0,334,0.0,1.0
28163,81073,1932,0,1932,0.0,1.0
28164,81076,418,0,418,0.0,1.0
28165,81077,532,523,9,0.983,0.017
28166,81081,70,0,70,0.0,1.0
28167,81082,12480,9181,3299,0.736,0.264
28168,81084,137,0,137,0.0,1.0
28169,81087,145,0,145,0.0,1.0
28170,81089,4602,2943,1659,0.64,0.36
28171,81090,981,0,981,0.0,1.0
28172,81091,812,0,812,0.0,1.0
28173,81092,865,0,865,0.0,1.0
28174,81101,14675,9751,4924,0.664,0.336
28175,81120,2267,0,2267,0.0,1.0
28176,81121,270,0,270,0.0,1.0
28177,81122,8228,2578,5650,0.313,0.687
28178,81123,805,0,805,0.0,1.0
28179,81124,303,0,303,0.0,1.0
28180,81125,3447,0,3447,0.0,1.0
28181,81126,276,0,276,0.0,1.0
28182,81128,115,0,115,0.0,1.0
28183,81129,156,0,156,0.0,1.0
28184,81130,671,0,671,0.0,1.0
28185,81131,1189,0,1189,0.0,1.0
28186,81132,3231,0,3231,0.0,1.0
28187,81133,840,0,840,0.0,1.0
28188,81136,261,0,261,0.0,1.0
28189,81137,5225,0,5225,0.0,1.0
28190,81138,56,0,56,0.0,1.0
28191,81140,2341,0,2341,0.0,1.0
28192,81141,1318,0,1318,0.0,1.0
28193,81143,672,0,672,0.0,1.0
28194,81144,7344,4489,2855,0.611,0.389
28195,81146,531,0,531,0.0,1.0
28196,81147,11446,4909,6537,0.429,0.571
28197,81148,404,0,404,0.0,1.0
28198,81149,838,0,838,0.0,1.0
28199,81151,1470,0,1470,0.0,1.0
28200,81152,1434,0,1434,0.0,1.0
28201,81154,1148,0,1148,0.0,1.0
28202,81155,225,0,225,0.0,1.0
28203,81201,8645,6141,2504,0.71,0.29
28204,81210,275,0,275,0.0,1.0
28205,81211,7623,4483,3140,0.588,0.412
28206,81212,29742,27139,2603,0.912,0.088
28207,81220,141,0,141,0.0,1.0
28208,81221,310,0,310,0.0,1.0
28209,81222,263,0,263,0.0,1.0
28210,81223,1639,0,1639,0.0,1.0
28211,81224,3446,0,3446,0.0,1.0
28212,81225,952,0,952,0.0,1.0
28213,81226,9066,7297,1769,0.805,0.195
28214,81227,10,0,10,0.0,1.0
28215,81230,9075,5628,3447,0.62,0.38
28216,81231,715,715,0,1.0,0.0
28217,81232,23,0,23,0.0,1.0
28218,81233,823,0,823,0.0,1.0
28219,81235,802,0,802,0.0,1.0
28220,81236,1017,0,1017,0.0,1.0
28221,81237,82,0,82,0.0,1.0
28222,81239,79,0,79,0.0,1.0
28223,81240,4323,0,4323,0.0,1.0
28224,81241,78,0,78,0.0,1.0
28225,81242,606,522,84,0.861,0.139
28226,81243,93,0,93,0.0,1.0
28227,81244,398,17,381,0.043,0.957
28228,81248,48,0,48,0.0,1.0
28229,81251,220,0,220,0.0,1.0
28230,81252,3830,0,3830,0.0,1.0
28231,81253,410,0,410,0.0,1.0
28232,81301,28308,17571,10737,0.621,0.379
28233,81303,7743,411,7332,0.053,0.947
28234,81320,388,0,388,0.0,1.0
28235,81321,14459,8380,6079,0.58,0.42
28236,81323,4409,0,4409,0.0,1.0
28237,81324,1387,0,1387,0.0,1.0
28238,81325,121,0,121,0.0,1.0
28239,81326,2193,0,2193,0.0,1.0
28240,81327,639,0,639,0.0,1.0
28241,81328,4069,0,4069,0.0,1.0
28242,81330,26,0,26,0.0,1.0
28243,81331,476,0,476,0.0,1.0
28244,81332,282,0,282,0.0,1.0
28245,81334,1493,0,1493,0.0,1.0
28246,81335,131,0,131,0.0,1.0
28247,81401,22437,18936,3501,0.844,0.156
28248,81403,10534,3746,6788,0.356,0.644
28249,81410,1655,141,1514,0.085,0.915
28250,81411,55,0,55,0.0,1.0
28251,81413,5243,2236,3007,0.426,0.574
28252,81415,1612,0,1612,0.0,1.0
28253,81416,13874,7849,6025,0.566,0.434
28254,81418,1714,1173,541,0.684,0.316
28255,81419,3883,0,3883,0.0,1.0
28256,81422,692,0,692,0.0,1.0
28257,81423,1480,0,1480,0.0,1.0
28258,81424,1239,0,1239,0.0,1.0
28259,81425,5424,24,5400,0.004,0.996
28260,81426,181,0,181,0.0,1.0
28261,81427,1124,0,1124,0.0,1.0
28262,81428,3701,0,3701,0.0,1.0
28263,81429,181,0,181,0.0,1.0
28264,81430,727,0,727,0.0,1.0
28265,81431,460,0,460,0.0,1.0
28266,81432,2682,0,2682,0.0,1.0
28267,81433,659,0,659,0.0,1.0
28268,81434,158,0,158,0.0,1.0
28269,81435,4965,0,4965,0.0,1.0
28270,81501,23465,23465,0,1.0,0.0
28271,81503,15250,14423,827,0.946,0.054
28272,81504,28481,28481,0,1.0,0.0
28273,81505,9779,7274,2505,0.744,0.256
28274,81506,10961,10779,182,0.983,0.017
28275,81507,15081,14246,835,0.945,0.055
28276,81520,13447,13344,103,0.992,0.008
28277,81521,15397,12905,2492,0.838,0.162
28278,81522,139,0,139,0.0,1.0
28279,81523,763,0,763,0.0,1.0
28280,81524,2300,0,2300,0.0,1.0
28281,81525,871,0,871,0.0,1.0
28282,81526,5321,3207,2114,0.603,0.397
28283,81527,2073,0,2073,0.0,1.0
28284,81601,15442,11581,3861,0.75,0.25
28285,81610,446,0,446,0.0,1.0
28286,81611,9921,7710,2211,0.777,0.223
28287,81612,20,0,20,0.0,1.0
28288,81615,2839,0,2839,0.0,1.0
28289,81620,10450,8175,2275,0.782,0.218
28290,81621,5914,4692,1222,0.793,0.207
28291,81623,15235,10384,4851,0.682,0.318
28292,81624,1537,0,1537,0.0,1.0
28293,81625,12921,10021,2900,0.776,0.224
28294,81630,979,0,979,0.0,1.0
28295,81631,8215,6073,2142,0.739,0.261
28296,81632,10276,9151,1125,0.891,0.109
28297,81633,19,0,19,0.0,1.0
28298,81635,5957,5071,886,0.851,0.149
28299,81637,7721,5963,1758,0.772,0.228
28300,81638,112,0,112,0.0,1.0
28301,81639,2463,0,2463,0.0,1.0
28302,81640,249,0,249,0.0,1.0
28303,81641,3834,0,3834,0.0,1.0
28304,81642,61,0,61,0.0,1.0
28305,81643,793,0,793,0.0,1.0
28306,81645,1121,857,264,0.764,0.236
28307,81646,184,0,184,0.0,1.0
28308,81647,7104,5449,1655,0.767,0.233
28309,81648,2808,0,2808,0.0,1.0
28310,81649,277,0,277,0.0,1.0
28311,81650,13006,10479,2527,0.806,0.194
28312,81652,4904,2966,1938,0.605,0.395
28313,81653,31,0,31,0.0,1.0
28314,81654,1391,614,777,0.441,0.559
28315,81655,65,0,65,0.0,1.0
28316,81656,242,0,242,0.0,1.0
28317,81657,5581,4966,615,0.89,0.11
28318,82001,35484,35204,280,0.992,0.008
28319,82005,417,417,0,1.0,0.0
28320,82007,19096,17718,1378,0.928,0.072
28321,82009,31703,20249,11454,0.639,0.361
28322,82050,401,0,401,0.0,1.0
28323,82051,60,0,60,0.0,1.0
28324,82052,23,0,23,0.0,1.0
28325,82053,1524,0,1524,0.0,1.0
28326,82054,920,0,920,0.0,1.0
28327,82055,285,0,285,0.0,1.0
28328,82058,52,0,52,0.0,1.0
28329,82059,135,0,135,0.0,1.0
28330,82060,372,0,372,0.0,1.0
28331,82061,39,0,39,0.0,1.0
28332,82063,100,0,100,0.0,1.0
28333,82070,19766,16897,2869,0.855,0.145
28334,82072,15533,14996,537,0.965,0.035
28335,82073,72,72,0,1.0,0.0
28336,82081,60,0,60,0.0,1.0
28337,82082,1606,0,1606,0.0,1.0
28338,82083,373,0,373,0.0,1.0
28339,82084,16,0,16,0.0,1.0
28340,82190,369,0,369,0.0,1.0
28341,82201,6467,3584,2883,0.554,0.446
28342,82210,399,0,399,0.0,1.0
28343,82212,474,0,474,0.0,1.0
28344,82213,513,0,513,0.0,1.0
28345,82214,1302,0,1302,0.0,1.0
28346,82215,132,0,132,0.0,1.0
28347,82217,107,0,107,0.0,1.0
28348,82219,48,0,48,0.0,1.0
28349,82221,635,0,635,0.0,1.0
28350,82222,107,0,107,0.0,1.0
28351,82223,996,0,996,0.0,1.0
28352,82224,23,0,23,0.0,1.0
28353,82225,2067,0,2067,0.0,1.0
28354,82227,241,0,241,0.0,1.0
28355,82229,74,0,74,0.0,1.0
28356,82240,10235,7155,3080,0.699,0.301
28357,82242,39,0,39,0.0,1.0
28358,82243,187,0,187,0.0,1.0
28359,82244,478,0,478,0.0,1.0
28360,82301,9584,9272,312,0.967,0.033
28361,82321,717,0,717,0.0,1.0
28362,82322,106,0,106,0.0,1.0
28363,82323,186,0,186,0.0,1.0
28364,82324,268,0,268,0.0,1.0
28365,82325,878,0,878,0.0,1.0
28366,82327,929,0,929,0.0,1.0
28367,82329,359,0,359,0.0,1.0
28368,82331,2286,0,2286,0.0,1.0
28369,82332,97,0,97,0.0,1.0
28370,82334,501,0,501,0.0,1.0
28371,82335,21,0,21,0.0,1.0
28372,82336,498,0,498,0.0,1.0
28373,82401,7866,5465,2401,0.695,0.305
28374,82410,1760,0,1760,0.0,1.0
28375,82411,664,0,664,0.0,1.0
28376,82412,626,0,626,0.0,1.0
28377,82414,15011,9338,5673,0.622,0.378
28378,82420,783,0,783,0.0,1.0
28379,82421,448,0,448,0.0,1.0
28380,82422,105,0,105,0.0,1.0
28381,82423,233,0,233,0.0,1.0
28382,82426,2644,0,2644,0.0,1.0
28383,82428,139,0,139,0.0,1.0
28384,82430,100,0,100,0.0,1.0
28385,82431,3552,0,3552,0.0,1.0
28386,82432,315,0,315,0.0,1.0
28387,82433,789,0,789,0.0,1.0
28388,82434,156,0,156,0.0,1.0
28389,82435,11738,6389,5349,0.544,0.456
28390,82440,145,0,145,0.0,1.0
28391,82441,250,0,250,0.0,1.0
28392,82442,732,0,732,0.0,1.0
28393,82443,4697,3297,1400,0.702,0.298
28394,82450,177,0,177,0.0,1.0
28395,82501,19408,12265,7143,0.632,0.368
28396,82510,423,0,423,0.0,1.0
28397,82512,210,0,210,0.0,1.0
28398,82513,1879,0,1879,0.0,1.0
28399,82514,1645,0,1645,0.0,1.0
28400,82515,446,0,446,0.0,1.0
28401,82516,496,0,496,0.0,1.0
28402,82520,13535,7225,6310,0.534,0.466
28403,82523,868,0,868,0.0,1.0
28404,82601,27400,22991,4409,0.839,0.161
28405,82604,25882,22379,3503,0.865,0.135
28406,82609,15730,15503,227,0.986,0.014
28407,82620,210,0,210,0.0,1.0
28408,82630,10,0,10,0.0,1.0
28409,82633,9592,6175,3417,0.644,0.356
28410,82635,207,0,207,0.0,1.0
28411,82636,3981,2220,1761,0.558,0.442
28412,82637,4136,0,4136,0.0,1.0
28413,82638,17,0,17,0.0,1.0
28414,82639,805,0,805,0.0,1.0
28415,82640,29,0,29,0.0,1.0
28416,82642,94,0,94,0.0,1.0
28417,82643,469,0,469,0.0,1.0
28418,82644,1480,1455,25,0.983,0.017
28419,82646,20,0,20,0.0,1.0
28420,82648,56,0,56,0.0,1.0
28421,82649,1120,0,1120,0.0,1.0
28422,82701,5455,3277,2178,0.601,0.399
28423,82710,243,0,243,0.0,1.0
28424,82711,110,0,110,0.0,1.0
28425,82712,264,0,264,0.0,1.0
28426,82714,95,0,95,0.0,1.0
28427,82715,0,0,0,,
28428,82716,18747,14613,4134,0.779,0.221
28429,82718,23003,18108,4895,0.787,0.213
28430,82720,955,0,955,0.0,1.0
28431,82721,3078,0,3078,0.0,1.0
28432,82723,278,0,278,0.0,1.0
28433,82725,207,0,207,0.0,1.0
28434,82727,1838,0,1838,0.0,1.0
28435,82729,2251,0,2251,0.0,1.0
28436,82730,1566,0,1566,0.0,1.0
28437,82731,135,0,135,0.0,1.0
28438,82732,2154,0,2154,0.0,1.0
28439,82801,24558,18786,5772,0.765,0.235
28440,82831,216,0,216,0.0,1.0
28441,82832,618,0,618,0.0,1.0
28442,82833,225,0,225,0.0,1.0
28443,82834,7585,4368,3217,0.576,0.424
28444,82835,318,0,318,0.0,1.0
28445,82836,1073,0,1073,0.0,1.0
28446,82837,29,0,29,0.0,1.0
28447,82838,268,0,268,0.0,1.0
28448,82839,1153,0,1153,0.0,1.0
28449,82842,843,0,843,0.0,1.0
28450,82844,35,0,35,0.0,1.0
28451,82845,37,0,37,0.0,1.0
28452,82901,27971,26352,1619,0.942,0.058
28453,82922,257,0,257,0.0,1.0
28454,82923,558,0,558,0.0,1.0
28455,82925,304,0,304,0.0,1.0
28456,82929,70,0,70,0.0,1.0
28457,82930,14614,12017,2597,0.822,0.178
28458,82932,836,0,836,0.0,1.0
28459,82933,759,0,759,0.0,1.0
28460,82934,185,0,185,0.0,1.0
28461,82935,13121,12672,449,0.966,0.034
28462,82936,49,0,49,0.0,1.0
28463,82937,3654,0,3654,0.0,1.0
28464,82938,227,0,227,0.0,1.0
28465,82939,1861,0,1861,0.0,1.0
28466,82941,5028,0,5028,0.0,1.0
28467,82942,123,0,123,0.0,1.0
28468,82943,301,0,301,0.0,1.0
28469,82944,216,0,216,0.0,1.0
28470,82945,351,0,351,0.0,1.0
28471,83001,15851,11407,4444,0.72,0.28
28472,83011,240,0,240,0.0,1.0
28473,83012,180,0,180,0.0,1.0
28474,83013,395,0,395,0.0,1.0
28475,83014,3595,0,3595,0.0,1.0
28476,83025,400,0,400,0.0,1.0
28477,83101,3104,2407,697,0.775,0.225
28478,83110,4307,0,4307,0.0,1.0
28479,83111,519,0,519,0.0,1.0
28480,83112,666,0,666,0.0,1.0
28481,83113,3278,0,3278,0.0,1.0
28482,83114,828,0,828,0.0,1.0
28483,83115,830,0,830,0.0,1.0
28484,83116,728,720,8,0.989,0.011
28485,83118,1139,0,1139,0.0,1.0
28486,83119,172,0,172,0.0,1.0
28487,83120,471,0,471,0.0,1.0
28488,83121,14,0,14,0.0,1.0
28489,83122,494,0,494,0.0,1.0
28490,83123,711,0,711,0.0,1.0
28491,83124,137,0,137,0.0,1.0
28492,83126,334,0,334,0.0,1.0
28493,83127,3041,0,3041,0.0,1.0
28494,83128,1601,0,1601,0.0,1.0
28495,83201,37199,36405,794,0.979,0.021
28496,83202,21608,16683,4925,0.772,0.228
28497,83203,309,0,309,0.0,1.0
28498,83204,18026,15546,2480,0.862,0.138
28499,83209,1175,1175,0,1.0,0.0
28500,83210,3449,0,3449,0.0,1.0
28501,83211,6374,4488,1886,0.704,0.296
28502,83212,137,0,137,0.0,1.0
28503,83213,1644,0,1644,0.0,1.0
28504,83214,671,0,671,0.0,1.0
28505,83215,26,0,26,0.0,1.0
28506,83217,843,0,843,0.0,1.0
28507,83218,338,0,338,0.0,1.0
28508,83220,137,0,137,0.0,1.0
28509,83221,27021,15352,11669,0.568,0.432
28510,83223,139,0,139,0.0,1.0
28511,83226,2504,0,2504,0.0,1.0
28512,83227,142,0,142,0.0,1.0
28513,83228,522,0,522,0.0,1.0
28514,83232,467,0,467,0.0,1.0
28515,83233,109,0,109,0.0,1.0
28516,83234,1213,0,1213,0.0,1.0
28517,83235,99,0,99,0.0,1.0
28518,83236,2275,0,2275,0.0,1.0
28519,83237,1146,0,1146,0.0,1.0
28520,83238,109,0,109,0.0,1.0
28521,83239,572,0,572,0.0,1.0
28522,83241,1980,0,1980,0.0,1.0
28523,83243,80,0,80,0.0,1.0
28524,83244,358,0,358,0.0,1.0
28525,83245,2257,0,2257,0.0,1.0
28526,83246,1069,0,1069,0.0,1.0
28527,83250,1637,0,1637,0.0,1.0
28528,83251,1097,0,1097,0.0,1.0
28529,83252,4154,0,4154,0.0,1.0
28530,83253,165,0,165,0.0,1.0
28531,83254,3617,0,3617,0.0,1.0
28532,83255,1213,0,1213,0.0,1.0
28533,83261,536,0,536,0.0,1.0
28534,83262,1386,0,1386,0.0,1.0
28535,83263,9258,4323,4935,0.467,0.533
28536,83271,531,0,531,0.0,1.0
28537,83272,313,0,313,0.0,1.0
28538,83274,9246,4701,4545,0.508,0.492
28539,83276,4097,2793,1304,0.682,0.318
28540,83277,111,0,111,0.0,1.0
28541,83278,186,0,186,0.0,1.0
28542,83281,93,0,93,0.0,1.0
28543,83283,147,0,147,0.0,1.0
28544,83285,131,0,131,0.0,1.0
28545,83286,1241,0,1241,0.0,1.0
28546,83287,299,0,299,0.0,1.0
28547,83301,52010,45519,6491,0.875,0.125
28548,83302,196,0,196,0.0,1.0
28549,83311,562,0,562,0.0,1.0
28550,83312,168,0,168,0.0,1.0
28551,83313,3625,2147,1478,0.592,0.408
28552,83314,898,0,898,0.0,1.0
28553,83316,9626,4138,5488,0.43,0.57
28554,83318,17226,11467,5759,0.666,0.334
28555,83320,1006,0,1006,0.0,1.0
28556,83321,550,0,550,0.0,1.0
28557,83322,42,0,42,0.0,1.0
28558,83323,1951,0,1951,0.0,1.0
28559,83324,788,0,788,0.0,1.0
28560,83325,918,0,918,0.0,1.0
28561,83327,970,0,970,0.0,1.0
28562,83328,5347,2639,2708,0.494,0.506
28563,83330,6599,3726,2873,0.565,0.435
28564,83332,2361,0,2361,0.0,1.0
28565,83333,10472,8338,2134,0.796,0.204
28566,83334,2060,0,2060,0.0,1.0
28567,83335,1840,0,1840,0.0,1.0
28568,83336,4951,3261,1690,0.659,0.341
28569,83337,33,0,33,0.0,1.0
28570,83338,19782,10892,8890,0.551,0.449
28571,83340,4682,3655,1027,0.781,0.219
28572,83341,6491,3317,3174,0.511,0.489
28573,83342,1371,0,1371,0.0,1.0
28574,83344,1128,0,1128,0.0,1.0
28575,83346,1442,0,1442,0.0,1.0
28576,83347,3258,1249,2009,0.383,0.617
28577,83348,132,0,132,0.0,1.0
28578,83349,1062,0,1062,0.0,1.0
28579,83350,12268,6346,5922,0.517,0.483
28580,83352,3330,0,3330,0.0,1.0
28581,83353,1335,232,1103,0.174,0.826
28582,83354,18,0,18,0.0,1.0
28583,83355,5405,2756,2649,0.51,0.49
28584,83401,37966,31861,6105,0.839,0.161
28585,83402,26069,22339,3730,0.857,0.143
28586,83404,21606,19940,1666,0.923,0.077
28587,83406,15902,14707,1195,0.925,0.075
28588,83414,544,0,544,0.0,1.0
28589,83420,2539,0,2539,0.0,1.0
28590,83421,319,0,319,0.0,1.0
28591,83422,3392,0,3392,0.0,1.0
28592,83423,860,0,860,0.0,1.0
28593,83424,290,0,290,0.0,1.0
28594,83425,581,0,581,0.0,1.0
28595,83427,1372,1356,16,0.988,0.012
28596,83428,416,0,416,0.0,1.0
28597,83429,1048,0,1048,0.0,1.0
28598,83431,876,0,876,0.0,1.0
28599,83433,44,0,44,0.0,1.0
28600,83434,1741,0,1741,0.0,1.0
28601,83435,653,0,653,0.0,1.0
28602,83436,491,0,491,0.0,1.0
28603,83440,34610,24487,10123,0.708,0.292
28604,83442,19250,8728,10522,0.453,0.547
28605,83443,1107,0,1107,0.0,1.0
28606,83444,1381,0,1381,0.0,1.0
28607,83445,7406,3702,3704,0.5,0.5
28608,83446,48,0,48,0.0,1.0
28609,83448,2451,1505,946,0.614,0.386
28610,83449,249,0,249,0.0,1.0
28611,83450,1104,0,1104,0.0,1.0
28612,83451,791,0,791,0.0,1.0
28613,83452,1484,0,1484,0.0,1.0
28614,83454,531,531,0,1.0,0.0
28615,83455,4970,0,4970,0.0,1.0
28616,83460,860,860,0,1.0,0.0
28617,83462,464,0,464,0.0,1.0
28618,83463,130,0,130,0.0,1.0
28619,83464,345,0,345,0.0,1.0
28620,83465,109,0,109,0.0,1.0
28621,83466,273,0,273,0.0,1.0
28622,83467,6270,3084,3186,0.492,0.508
28623,83468,170,0,170,0.0,1.0
28624,83469,32,0,32,0.0,1.0
28625,83501,34230,31740,2490,0.927,0.073
28626,83520,194,106,88,0.546,0.454
28627,83522,2215,0,2215,0.0,1.0
28628,83523,759,0,759,0.0,1.0
28629,83524,989,0,989,0.0,1.0
28630,83525,376,0,376,0.0,1.0
28631,83526,278,0,278,0.0,1.0
28632,83530,5404,3150,2254,0.583,0.417
28633,83533,178,0,178,0.0,1.0
28634,83535,1089,0,1089,0.0,1.0
28635,83536,4230,0,4230,0.0,1.0
28636,83537,1044,0,1044,0.0,1.0
28637,83539,2001,0,2001,0.0,1.0
28638,83540,2190,0,2190,0.0,1.0
28639,83541,1076,0,1076,0.0,1.0
28640,83542,129,0,129,0.0,1.0
28641,83543,717,0,717,0.0,1.0
28642,83544,6092,3520,2572,0.578,0.422
28643,83545,484,0,484,0.0,1.0
28644,83546,587,0,587,0.0,1.0
28645,83547,219,0,219,0.0,1.0
28646,83548,117,0,117,0.0,1.0
28647,83549,908,0,908,0.0,1.0
28648,83552,1225,0,1225,0.0,1.0
28649,83553,1100,0,1100,0.0,1.0
28650,83554,638,0,638,0.0,1.0
28651,83555,564,0,564,0.0,1.0
28652,83601,41,0,41,0.0,1.0
28653,83602,24,0,24,0.0,1.0
28654,83604,762,0,762,0.0,1.0
28655,83605,39649,39147,502,0.987,0.013
28656,83607,21732,10824,10908,0.498,0.502
28657,83610,946,0,946,0.0,1.0
28658,83611,2453,0,2453,0.0,1.0
28659,83612,1925,0,1925,0.0,1.0
28660,83615,1571,0,1571,0.0,1.0
28661,83616,22780,19945,2835,0.876,0.124
28662,83617,15422,9192,6230,0.596,0.404
28663,83619,7201,4935,2266,0.685,0.315
28664,83622,1737,0,1737,0.0,1.0
28665,83623,1517,0,1517,0.0,1.0
28666,83624,1195,0,1195,0.0,1.0
28667,83626,1192,0,1192,0.0,1.0
28668,83627,620,0,620,0.0,1.0
28669,83628,4329,2617,1712,0.605,0.395
28670,83629,1721,0,1721,0.0,1.0
28671,83631,1333,0,1333,0.0,1.0
28672,83632,214,0,214,0.0,1.0
28673,83633,540,0,540,0.0,1.0
28674,83634,24494,15018,9476,0.613,0.387
28675,83636,153,0,153,0.0,1.0
28676,83637,206,0,206,0.0,1.0
28677,83638,5903,0,5903,0.0,1.0
28678,83639,3300,0,3300,0.0,1.0
28679,83641,3438,0,3438,0.0,1.0
28680,83642,37008,33353,3655,0.901,0.099
28681,83643,129,0,129,0.0,1.0
28682,83644,9976,5594,4382,0.561,0.439
28683,83645,636,0,636,0.0,1.0
28684,83646,47098,45898,1200,0.975,0.025
28685,83647,20789,16531,4258,0.795,0.205
28686,83648,3238,3238,0,1.0,0.0
28687,83650,552,0,552,0.0,1.0
28688,83651,28611,28349,262,0.991,0.009
28689,83654,1672,0,1672,0.0,1.0
28690,83655,4397,0,4397,0.0,1.0
28691,83656,582,0,582,0.0,1.0
28692,83657,174,0,174,0.0,1.0
28693,83660,5890,0,5890,0.0,1.0
28694,83661,9881,8035,1846,0.813,0.187
28695,83666,52,0,52,0.0,1.0
28696,83669,7365,5751,1614,0.781,0.219
28697,83670,553,0,553,0.0,1.0
28698,83671,33,0,33,0.0,1.0
28699,83672,8583,5551,3032,0.647,0.353
28700,83676,4347,114,4233,0.026,0.974
28701,83677,44,0,44,0.0,1.0
28702,83686,46224,40669,5555,0.88,0.12
28703,83687,29697,26695,3002,0.899,0.101
28704,83702,22293,22194,99,0.996,0.004
28705,83703,16565,16333,232,0.986,0.014
28706,83704,39628,39628,0,1.0,0.0
28707,83705,26631,26625,6,1.0,0.0
28708,83706,29732,29732,0,1.0,0.0
28709,83709,50034,49526,508,0.99,0.01
28710,83712,8148,7414,734,0.91,0.09
28711,83713,28103,28103,0,1.0,0.0
28712,83714,20290,19573,717,0.965,0.035
28713,83716,14523,11797,2726,0.812,0.188
28714,83801,6150,0,6150,0.0,1.0
28715,83802,68,0,68,0.0,1.0
28716,83803,744,0,744,0.0,1.0
28717,83804,1254,0,1254,0.0,1.0
28718,83805,7437,2613,4824,0.351,0.649
28719,83806,220,0,220,0.0,1.0
28720,83808,147,0,147,0.0,1.0
28721,83809,401,0,401,0.0,1.0
28722,83810,1189,0,1189,0.0,1.0
28723,83811,1411,0,1411,0.0,1.0
28724,83812,66,0,66,0.0,1.0
28725,83813,1158,0,1158,0.0,1.0
28726,83814,23371,18323,5048,0.784,0.216
28727,83815,31015,30274,741,0.976,0.024
28728,83821,210,0,210,0.0,1.0
28729,83822,2006,423,1583,0.211,0.789
28730,83823,1318,0,1318,0.0,1.0
28731,83824,348,0,348,0.0,1.0
28732,83825,190,38,152,0.2,0.8
28733,83826,45,0,45,0.0,1.0
28734,83827,143,0,143,0.0,1.0
28735,83830,733,0,733,0.0,1.0
28736,83832,1524,0,1524,0.0,1.0
28737,83833,1164,0,1164,0.0,1.0
28738,83834,254,0,254,0.0,1.0
28739,83835,19990,17245,2745,0.863,0.137
28740,83836,1033,0,1033,0.0,1.0
28741,83837,3063,2464,599,0.804,0.196
28742,83839,1417,0,1417,0.0,1.0
28743,83840,227,227,0,1.0,0.0
28744,83841,338,0,338,0.0,1.0
28745,83842,148,0,148,0.0,1.0
28746,83843,25866,22859,3007,0.884,0.116
28747,83844,1353,1353,0,1.0,0.0
28748,83845,1742,0,1742,0.0,1.0
28749,83846,770,0,770,0.0,1.0
28750,83847,1719,0,1719,0.0,1.0
28751,83848,137,0,137,0.0,1.0
28752,83849,1925,1527,398,0.793,0.207
28753,83850,2129,0,2129,0.0,1.0
28754,83851,1691,0,1691,0.0,1.0
28755,83852,884,726,158,0.821,0.179
28756,83854,37245,32536,4709,0.874,0.126
28757,83855,2111,0,2111,0.0,1.0
28758,83856,6340,0,6340,0.0,1.0
28759,83857,691,0,691,0.0,1.0
28760,83858,13656,6539,7117,0.479,0.521
28761,83860,6119,1278,4841,0.209,0.791
28762,83861,6360,2608,3752,0.41,0.59
28763,83864,17076,8571,8505,0.502,0.498
28764,83866,320,0,320,0.0,1.0
28765,83867,616,310,306,0.503,0.497
28766,83868,769,627,142,0.815,0.185
28767,83869,4161,0,4161,0.0,1.0
28768,83870,312,0,312,0.0,1.0
28769,83871,1938,0,1938,0.0,1.0
28770,83872,705,0,705,0.0,1.0
28771,83873,1591,684,907,0.43,0.57
28772,83874,64,0,64,0.0,1.0
28773,83876,1442,0,1442,0.0,1.0
28774,84001,725,0,725,0.0,1.0
28775,84002,302,0,302,0.0,1.0
28776,84003,42384,42021,363,0.991,0.009
28777,84004,9818,9513,305,0.969,0.031
28778,84005,21410,19873,1537,0.928,0.072
28779,84006,826,0,826,0.0,1.0
28780,84007,740,0,740,0.0,1.0
28781,84010,44821,44319,502,0.989,0.011
28782,84013,1011,0,1011,0.0,1.0
28783,84014,15268,15266,2,1.0,0.0
28784,84015,62494,62058,436,0.993,0.007
28785,84017,3556,0,3556,0.0,1.0
28786,84018,179,0,179,0.0,1.0
28787,84020,39765,38087,1678,0.958,0.042
28788,84021,3323,0,3323,0.0,1.0
28789,84022,896,0,896,0.0,1.0
28790,84023,266,0,266,0.0,1.0
28791,84024,63,0,63,0.0,1.0
28792,84025,18255,17944,311,0.983,0.017
28793,84026,1668,0,1668,0.0,1.0
28794,84027,452,0,452,0.0,1.0
28795,84028,824,0,824,0.0,1.0
28796,84029,9473,6673,2800,0.704,0.296
28797,84031,259,0,259,0.0,1.0
28798,84032,17249,13607,3642,0.789,0.211
28799,84033,1032,0,1032,0.0,1.0
28800,84034,209,0,209,0.0,1.0
28801,84035,748,0,748,0.0,1.0
28802,84036,6045,2645,3400,0.438,0.562
28803,84037,33369,33120,249,0.993,0.007
28804,84038,347,0,347,0.0,1.0
28805,84039,1102,0,1102,0.0,1.0
28806,84040,23026,22928,98,0.996,0.004
28807,84041,44625,44440,185,0.996,0.004
28808,84042,10094,10094,0,1.0,0.0
28809,84043,49030,47857,1173,0.976,0.024
28810,84044,26524,26489,35,0.999,0.001
28811,84045,16875,16564,311,0.982,0.018
28812,84046,793,0,793,0.0,1.0
28813,84047,28936,28936,0,1.0,0.0
28814,84049,4372,3605,767,0.825,0.175
28815,84050,9290,3518,5772,0.379,0.621
28816,84051,402,0,402,0.0,1.0
28817,84052,1403,0,1403,0.0,1.0
28818,84053,1115,0,1115,0.0,1.0
28819,84054,16196,16196,0,1.0,0.0
28820,84055,1406,0,1406,0.0,1.0
28821,84056,3310,3310,0,1.0,0.0
28822,84057,36666,36666,0,1.0,0.0
28823,84058,30540,30458,82,0.997,0.003
28824,84060,7596,6724,872,0.885,0.115
28825,84061,391,0,391,0.0,1.0
28826,84062,43269,43228,41,0.999,0.001
28827,84063,334,0,334,0.0,1.0
28828,84064,692,0,692,0.0,1.0
28829,84065,38168,37703,465,0.988,0.012
28830,84066,11283,5915,5368,0.524,0.476
28831,84067,37444,37444,0,1.0,0.0
28832,84069,505,0,505,0.0,1.0
28833,84070,24861,24861,0,1.0,0.0
28834,84071,1175,0,1175,0.0,1.0
28835,84072,372,0,372,0.0,1.0
28836,84073,191,0,191,0.0,1.0
28837,84074,44310,40119,4191,0.905,0.095
28838,84075,24506,24336,170,0.993,0.007
28839,84076,390,0,390,0.0,1.0
28840,84078,25851,17321,8530,0.67,0.33
28841,84080,304,0,304,0.0,1.0
28842,84081,40732,40473,259,0.994,0.006
28843,84082,743,0,743,0.0,1.0
28844,84083,1516,1121,395,0.739,0.261
28845,84084,37247,37247,0,1.0,0.0
28846,84085,531,0,531,0.0,1.0
28847,84086,401,0,401,0.0,1.0
28848,84087,13983,13885,98,0.993,0.007
28849,84088,35603,35603,0,1.0,0.0
28850,84092,29525,28650,875,0.97,0.03
28851,84093,23130,23130,0,1.0,0.0
28852,84094,28069,28069,0,1.0,0.0
28853,84095,50566,49980,586,0.988,0.012
28854,84096,33396,31313,2083,0.938,0.062
28855,84097,21322,21322,0,1.0,0.0
28856,84098,17282,12716,4566,0.736,0.264
28857,84101,5277,5277,0,1.0,0.0
28858,84102,17421,17421,0,1.0,0.0
28859,84103,21084,20121,963,0.954,0.046
28860,84104,24869,24854,15,0.999,0.001
28861,84105,22140,22140,0,1.0,0.0
28862,84106,33384,33384,0,1.0,0.0
28863,84107,30863,30863,0,1.0,0.0
28864,84108,20738,19171,1567,0.924,0.076
28865,84109,23858,23575,283,0.988,0.012
28866,84111,10744,10744,0,1.0,0.0
28867,84112,1942,1942,0,1.0,0.0
28868,84113,245,245,0,1.0,0.0
28869,84115,24668,24668,0,1.0,0.0
28870,84116,33297,33114,183,0.995,0.005
28871,84117,24305,24305,0,1.0,0.0
28872,84118,68295,68285,10,1.0,0.0
28873,84119,53077,53077,0,1.0,0.0
28874,84120,48956,48956,0,1.0,0.0
28875,84121,41702,41392,310,0.993,0.007
28876,84123,37900,37900,0,1.0,0.0
28877,84124,21295,21291,4,1.0,0.0
28878,84128,27983,27977,6,1.0,0.0
28879,84144,0,0,0,,
28880,84180,0,0,0,,
28881,84301,883,0,883,0.0,1.0
28882,84302,23703,21610,2093,0.912,0.088
28883,84304,40,0,40,0.0,1.0
28884,84305,751,0,751,0.0,1.0
28885,84306,318,0,318,0.0,1.0
28886,84307,1375,0,1375,0.0,1.0
28887,84308,325,0,325,0.0,1.0
28888,84309,535,0,535,0.0,1.0
28889,84310,4111,0,4111,0.0,1.0
28890,84311,714,0,714,0.0,1.0
28891,84312,4028,2366,1662,0.587,0.413
28892,84313,68,0,68,0.0,1.0
28893,84314,1031,0,1031,0.0,1.0
28894,84315,7581,6081,1500,0.802,0.198
28895,84316,254,0,254,0.0,1.0
28896,84317,2304,0,2304,0.0,1.0
28897,84318,3918,3589,329,0.916,0.084
28898,84319,7905,7427,478,0.94,0.06
28899,84320,2237,0,2237,0.0,1.0
28900,84321,44074,42998,1076,0.976,0.024
28901,84324,701,0,701,0.0,1.0
28902,84325,2078,0,2078,0.0,1.0
28903,84326,1763,1662,101,0.943,0.057
28904,84327,951,0,951,0.0,1.0
28905,84328,1666,0,1666,0.0,1.0
28906,84329,202,0,202,0.0,1.0
28907,84330,502,0,502,0.0,1.0
28908,84331,272,0,272,0.0,1.0
28909,84332,7218,7199,19,0.997,0.003
28910,84333,2722,0,2722,0.0,1.0
28911,84334,230,0,230,0.0,1.0
28912,84335,11372,9336,2036,0.821,0.179
28913,84336,281,0,281,0.0,1.0
28914,84337,11393,7524,3869,0.66,0.34
28915,84338,481,0,481,0.0,1.0
28916,84339,5046,3312,1734,0.656,0.344
28917,84340,3369,2933,436,0.871,0.129
28918,84341,20109,19460,649,0.968,0.032
28919,84401,35622,33966,1656,0.954,0.046
28920,84403,36582,36210,372,0.99,0.01
28921,84404,56363,52869,3494,0.938,0.062
28922,84405,31348,30897,451,0.986,0.014
28923,84414,26507,26214,293,0.989,0.011
28924,84501,13612,10735,2877,0.789,0.211
28925,84511,4672,3264,1408,0.699,0.301
28926,84512,1093,0,1093,0.0,1.0
28927,84513,1710,1585,125,0.927,0.073
28928,84515,15,0,15,0.0,1.0
28929,84516,227,0,227,0.0,1.0
28930,84518,702,0,702,0.0,1.0
28931,84520,1302,0,1302,0.0,1.0
28932,84521,840,0,840,0.0,1.0
28933,84522,321,0,321,0.0,1.0
28934,84523,1797,0,1797,0.0,1.0
28935,84525,1183,0,1183,0.0,1.0
28936,84526,4134,3452,682,0.835,0.165
28937,84528,2742,0,2742,0.0,1.0
28938,84529,180,0,180,0.0,1.0
28939,84530,460,0,460,0.0,1.0
28940,84531,642,0,642,0.0,1.0
28941,84532,9772,6883,2889,0.704,0.296
28942,84533,267,0,267,0.0,1.0
28943,84534,2654,0,2654,0.0,1.0
28944,84535,2601,0,2601,0.0,1.0
28945,84536,1454,0,1454,0.0,1.0
28946,84537,1505,1308,197,0.869,0.131
28947,84539,379,0,379,0.0,1.0
28948,84540,46,0,46,0.0,1.0
28949,84542,1806,0,1806,0.0,1.0
28950,84601,31486,30892,594,0.981,0.019
28951,84604,49145,48792,353,0.993,0.007
28952,84606,32291,32246,45,0.999,0.001
28953,84620,1151,0,1151,0.0,1.0
28954,84621,240,0,240,0.0,1.0
28955,84622,1517,1263,254,0.833,0.167
28956,84623,405,0,405,0.0,1.0
28957,84624,5668,3258,2410,0.575,0.425
28958,84626,410,0,410,0.0,1.0
28959,84627,6310,5781,529,0.916,0.084
28960,84628,721,0,721,0.0,1.0
28961,84629,2531,0,2531,0.0,1.0
28962,84630,294,0,294,0.0,1.0
28963,84631,3067,0,3067,0.0,1.0
28964,84632,1148,0,1148,0.0,1.0
28965,84633,1048,0,1048,0.0,1.0
28966,84634,3395,2894,501,0.852,0.148
28967,84635,863,0,863,0.0,1.0
28968,84636,474,0,474,0.0,1.0
28969,84637,729,0,729,0.0,1.0
28970,84638,294,0,294,0.0,1.0
28971,84639,963,0,963,0.0,1.0
28972,84640,121,0,121,0.0,1.0
28973,84642,3548,3201,347,0.902,0.098
28974,84643,605,0,605,0.0,1.0
28975,84645,2620,543,2077,0.207,0.793
28976,84646,1657,0,1657,0.0,1.0
28977,84647,4019,3207,812,0.798,0.202
28978,84648,5776,5249,527,0.909,0.091
28979,84649,760,0,760,0.0,1.0
28980,84651,23457,20922,2535,0.892,0.108
28981,84652,872,0,872,0.0,1.0
28982,84653,7947,7068,879,0.889,0.111
28983,84654,2689,0,2689,0.0,1.0
28984,84655,10547,9393,1154,0.891,0.109
28985,84656,345,0,345,0.0,1.0
28986,84657,505,0,505,0.0,1.0
28987,84660,37995,34554,3441,0.909,0.091
28988,84662,1371,0,1371,0.0,1.0
28989,84663,29975,29432,543,0.982,0.018
28990,84664,8033,7594,439,0.945,0.055
28991,84665,528,89,439,0.169,0.831
28992,84667,405,0,405,0.0,1.0
28993,84701,8692,7340,1352,0.844,0.156
28994,84710,131,0,131,0.0,1.0
28995,84711,735,0,735,0.0,1.0
28996,84712,201,0,201,0.0,1.0
28997,84713,3792,2882,910,0.76,0.24
28998,84714,835,0,835,0.0,1.0
28999,84715,459,0,459,0.0,1.0
29000,84716,297,0,297,0.0,1.0
29001,84718,189,0,189,0.0,1.0
29002,84719,90,0,90,0.0,1.0
29003,84720,19705,16705,3000,0.848,0.152
29004,84721,20961,16495,4466,0.787,0.213
29005,84722,615,0,615,0.0,1.0
29006,84723,687,0,687,0.0,1.0
29007,84724,1214,0,1214,0.0,1.0
29008,84725,1964,0,1964,0.0,1.0
29009,84726,961,0,961,0.0,1.0
29010,84728,158,0,158,0.0,1.0
29011,84729,396,0,396,0.0,1.0
29012,84730,268,0,268,0.0,1.0
29013,84731,194,0,194,0.0,1.0
29014,84732,77,0,77,0.0,1.0
29015,84733,202,0,202,0.0,1.0
29016,84734,261,0,261,0.0,1.0
29017,84735,258,0,258,0.0,1.0
29018,84736,246,0,246,0.0,1.0
29019,84737,14838,12390,2448,0.835,0.165
29020,84738,6878,5719,1159,0.831,0.169
29021,84739,507,0,507,0.0,1.0
29022,84740,191,0,191,0.0,1.0
29023,84741,5556,3212,2344,0.578,0.422
29024,84742,260,0,260,0.0,1.0
29025,84743,34,0,34,0.0,1.0
29026,84744,411,0,411,0.0,1.0
29027,84745,4066,3743,323,0.921,0.079
29028,84746,1149,0,1149,0.0,1.0
29029,84747,1097,0,1097,0.0,1.0
29030,84749,218,0,218,0.0,1.0
29031,84750,469,0,469,0.0,1.0
29032,84751,1680,0,1680,0.0,1.0
29033,84752,994,0,994,0.0,1.0
29034,84753,26,0,26,0.0,1.0
29035,84754,3652,0,3652,0.0,1.0
29036,84755,112,0,112,0.0,1.0
29037,84756,366,0,366,0.0,1.0
29038,84757,1167,0,1167,0.0,1.0
29039,84758,533,0,533,0.0,1.0
29040,84759,2112,0,2112,0.0,1.0
29041,84760,559,0,559,0.0,1.0
29042,84761,3131,2551,580,0.815,0.185
29043,84762,248,0,248,0.0,1.0
29044,84763,245,0,245,0.0,1.0
29045,84764,331,0,331,0.0,1.0
29046,84765,6143,6099,44,0.993,0.007
29047,84766,147,0,147,0.0,1.0
29048,84767,679,0,679,0.0,1.0
29049,84770,39131,35616,3515,0.91,0.09
29050,84772,171,0,171,0.0,1.0
29051,84773,321,0,321,0.0,1.0
29052,84774,1399,203,1196,0.145,0.855
29053,84775,431,0,431,0.0,1.0
29054,84776,538,0,538,0.0,1.0
29055,84779,641,0,641,0.0,1.0
29056,84780,18756,17044,1712,0.909,0.091
29057,84781,188,0,188,0.0,1.0
29058,84782,794,0,794,0.0,1.0
29059,84783,805,0,805,0.0,1.0
29060,84784,2745,2397,348,0.873,0.127
29061,84790,35770,33892,1878,0.947,0.053
29062,85003,9369,9369,0,1.0,0.0
29063,85004,4965,4965,0,1.0,0.0
29064,85006,25742,25742,0,1.0,0.0
29065,85007,14040,14040,0,1.0,0.0
29066,85008,56145,56145,0,1.0,0.0
29067,85009,52520,52520,0,1.0,0.0
29068,85012,6390,6390,0,1.0,0.0
29069,85013,19314,19314,0,1.0,0.0
29070,85014,24782,24782,0,1.0,0.0
29071,85015,37644,37644,0,1.0,0.0
29072,85016,33896,33896,0,1.0,0.0
29073,85017,38872,38872,0,1.0,0.0
29074,85018,36065,36065,0,1.0,0.0
29075,85019,25042,25042,0,1.0,0.0
29076,85020,32850,32850,0,1.0,0.0
29077,85021,37743,37743,0,1.0,0.0
29078,85022,46395,46395,0,1.0,0.0
29079,85023,31274,31274,0,1.0,0.0
29080,85024,22898,22898,0,1.0,0.0
29081,85027,37140,37136,4,1.0,0.0
29082,85028,19157,19157,0,1.0,0.0
29083,85029,43233,43233,0,1.0,0.0
29084,85031,30493,30493,0,1.0,0.0
29085,85032,65485,65485,0,1.0,0.0
29086,85033,53037,53037,0,1.0,0.0
29087,85034,5582,5582,0,1.0,0.0
29088,85035,47486,47486,0,1.0,0.0
29089,85037,44771,44771,0,1.0,0.0
29090,85040,29352,29352,0,1.0,0.0
29091,85041,54947,54947,0,1.0,0.0
29092,85042,40962,40894,68,0.998,0.002
29093,85043,30560,30560,0,1.0,0.0
29094,85044,37993,37937,56,0.999,0.001
29095,85045,7238,7238,0,1.0,0.0
29096,85048,33449,33309,140,0.996,0.004
29097,85050,25736,25295,441,0.983,0.017
29098,85051,40375,40375,0,1.0,0.0
29099,85053,28480,28480,0,1.0,0.0
29100,85054,5384,5235,149,0.972,0.028
29101,85083,18104,18104,0,1.0,0.0
29102,85085,17517,15189,2328,0.867,0.133
29103,85086,40495,37653,2842,0.93,0.07
29104,85087,7708,1679,6029,0.218,0.782
29105,85118,12246,8976,3270,0.733,0.267
29106,85119,21219,20622,597,0.972,0.028
29107,85120,28168,28127,41,0.999,0.001
29108,85121,2178,0,2178,0.0,1.0
29109,85122,50942,49693,1249,0.975,0.025
29110,85123,10677,10410,267,0.975,0.025
29111,85128,14823,10919,3904,0.737,0.263
29112,85131,18017,6963,11054,0.386,0.614
29113,85132,33556,19808,13748,0.59,0.41
29114,85135,630,0,630,0.0,1.0
29115,85137,2329,0,2329,0.0,1.0
29116,85138,33633,30762,2871,0.915,0.085
29117,85139,17979,11575,6404,0.644,0.356
29118,85140,36711,35271,1440,0.961,0.039
29119,85141,515,0,515,0.0,1.0
29120,85142,48870,46512,2358,0.952,0.048
29121,85143,35015,33236,1779,0.949,0.051
29122,85145,2106,0,2106,0.0,1.0
29123,85147,4543,0,4543,0.0,1.0
29124,85172,1368,0,1368,0.0,1.0
29125,85173,2872,2782,90,0.969,0.031
29126,85192,2120,0,2120,0.0,1.0
29127,85193,4906,121,4785,0.025,0.975
29128,85194,6721,1638,5083,0.244,0.756
29129,85201,46092,46092,0,1.0,0.0
29130,85202,37275,37275,0,1.0,0.0
29131,85203,35541,35128,413,0.988,0.012
29132,85204,60885,60885,0,1.0,0.0
29133,85205,39858,39858,0,1.0,0.0
29134,85206,33154,33154,0,1.0,0.0
29135,85207,44744,44593,151,0.997,0.003
29136,85208,34762,34762,0,1.0,0.0
29137,85209,37377,37377,0,1.0,0.0
29138,85210,36464,36464,0,1.0,0.0
29139,85212,24492,24002,490,0.98,0.02
29140,85213,31797,31771,26,0.999,0.001
29141,85215,15963,15622,341,0.979,0.021
29142,85224,42796,42796,0,1.0,0.0
29143,85225,69810,69810,0,1.0,0.0
29144,85226,37376,37226,150,0.996,0.004
29145,85233,37564,37564,0,1.0,0.0
29146,85234,50014,50014,0,1.0,0.0
29147,85248,29821,29211,610,0.98,0.02
29148,85249,36908,36891,17,1.0,0.0
29149,85250,15906,15906,0,1.0,0.0
29150,85251,34390,34390,0,1.0,0.0
29151,85253,17047,17047,0,1.0,0.0
29152,85254,45801,45801,0,1.0,0.0
29153,85255,37270,34836,2434,0.935,0.065
29154,85256,4974,2380,2594,0.478,0.522
29155,85257,26755,26755,0,1.0,0.0
29156,85258,23342,23342,0,1.0,0.0
29157,85259,21422,20567,855,0.96,0.04
29158,85260,36056,36056,0,1.0,0.0
29159,85262,11275,5552,5723,0.492,0.508
29160,85263,2111,0,2111,0.0,1.0
29161,85264,1249,0,1249,0.0,1.0
29162,85266,11406,10600,806,0.929,0.071
29163,85268,22684,22278,406,0.982,0.018
29164,85281,57348,57348,0,1.0,0.0
29165,85282,48671,48671,0,1.0,0.0
29166,85283,44813,44813,0,1.0,0.0
29167,85284,16479,16479,0,1.0,0.0
29168,85286,38930,38910,20,0.999,0.001
29169,85295,38332,38332,0,1.0,0.0
29170,85296,36799,36799,0,1.0,0.0
29171,85297,26979,26900,79,0.997,0.003
29172,85298,21479,21409,70,0.997,0.003
29173,85301,60161,60161,0,1.0,0.0
29174,85302,36909,36909,0,1.0,0.0
29175,85303,30310,30310,0,1.0,0.0
29176,85304,25883,25883,0,1.0,0.0
29177,85305,10822,10822,0,1.0,0.0
29178,85306,24191,24191,0,1.0,0.0
29179,85307,9230,9176,54,0.994,0.006
29180,85308,63876,63876,0,1.0,0.0
29181,85309,1485,1485,0,1.0,0.0
29182,85310,19007,19007,0,1.0,0.0
29183,85320,1197,0,1197,0.0,1.0
29184,85321,4435,3076,1359,0.694,0.306
29185,85322,752,0,752,0.0,1.0
29186,85323,39507,39447,60,0.998,0.002
29187,85324,2886,0,2886,0.0,1.0
29188,85325,1212,0,1212,0.0,1.0
29189,85326,51705,41195,10510,0.797,0.203
29190,85328,259,0,259,0.0,1.0
29191,85331,26960,23454,3506,0.87,0.13
29192,85332,2146,0,2146,0.0,1.0
29193,85333,790,0,790,0.0,1.0
29194,85334,1482,931,551,0.628,0.372
29195,85335,31787,31763,24,0.999,0.001
29196,85336,700,0,700,0.0,1.0
29197,85337,2793,0,2793,0.0,1.0
29198,85338,41115,39395,1720,0.958,0.042
29199,85339,35586,32775,2811,0.921,0.079
29200,85340,26262,25790,472,0.982,0.018
29201,85341,39,0,39,0.0,1.0
29202,85342,1578,0,1578,0.0,1.0
29203,85343,196,0,196,0.0,1.0
29204,85344,9147,4675,4472,0.511,0.489
29205,85345,56208,56208,0,1.0,0.0
29206,85346,4423,3342,1081,0.756,0.244
29207,85347,716,0,716,0.0,1.0
29208,85348,2786,0,2786,0.0,1.0
29209,85349,25517,24091,1426,0.944,0.056
29210,85350,21214,16988,4226,0.801,0.199
29211,85351,27789,27789,0,1.0,0.0
29212,85352,461,0,461,0.0,1.0
29213,85353,31011,30609,402,0.987,0.013
29214,85354,6645,0,6645,0.0,1.0
29215,85355,8745,8268,477,0.945,0.055
29216,85356,4539,0,4539,0.0,1.0
29217,85357,761,0,761,0.0,1.0
29218,85360,222,0,222,0.0,1.0
29219,85361,6700,0,6700,0.0,1.0
29220,85362,663,0,663,0.0,1.0
29221,85363,6156,6156,0,1.0,0.0
29222,85364,74904,74231,673,0.991,0.009
29223,85365,46558,40179,6379,0.863,0.137
29224,85367,20429,19846,583,0.971,0.029
29225,85371,419,0,419,0.0,1.0
29226,85373,17356,17065,291,0.983,0.017
29227,85374,47146,47146,0,1.0,0.0
29228,85375,27703,26622,1081,0.961,0.039
29229,85377,3051,2548,503,0.835,0.165
29230,85379,39732,39540,192,0.995,0.005
29231,85381,24249,24249,0,1.0,0.0
29232,85382,40454,40454,0,1.0,0.0
29233,85383,37182,35329,1853,0.95,0.05
29234,85387,9573,4976,4597,0.52,0.48
29235,85388,23490,23450,40,0.998,0.002
29236,85390,8621,3624,4997,0.42,0.58
29237,85392,35310,35310,0,1.0,0.0
29238,85395,25922,25809,113,0.996,0.004
29239,85396,12163,5930,6233,0.488,0.512
29240,85501,13345,9383,3962,0.703,0.297
29241,85530,2069,0,2069,0.0,1.0
29242,85531,623,473,150,0.759,0.241
29243,85533,2943,1652,1291,0.561,0.439
29244,85534,2588,0,2588,0.0,1.0
29245,85535,21,0,21,0.0,1.0
29246,85536,408,0,408,0.0,1.0
29247,85539,4520,4132,388,0.914,0.086
29248,85540,2874,2856,18,0.994,0.006
29249,85541,21877,14210,7667,0.65,0.35
29250,85542,3196,952,2244,0.298,0.702
29251,85543,3822,2105,1717,0.551,0.449
29252,85544,2949,0,2949,0.0,1.0
29253,85545,583,0,583,0.0,1.0
29254,85546,19677,10467,9210,0.532,0.468
29255,85550,4790,3041,1749,0.635,0.365
29256,85551,405,399,6,0.985,0.015
29257,85552,6218,5707,511,0.918,0.082
29258,85553,1501,0,1501,0.0,1.0
29259,85554,778,0,778,0.0,1.0
29260,85601,698,0,698,0.0,1.0
29261,85602,9464,4036,5428,0.426,0.574
29262,85603,7155,5541,1614,0.774,0.226
29263,85605,597,0,597,0.0,1.0
29264,85606,1184,0,1184,0.0,1.0
29265,85607,18925,16689,2236,0.882,0.118
29266,85608,2305,0,2305,0.0,1.0
29267,85609,392,0,392,0.0,1.0
29268,85610,1333,0,1333,0.0,1.0
29269,85611,965,0,965,0.0,1.0
29270,85613,5601,5439,162,0.971,0.029
29271,85614,21895,18449,3446,0.843,0.157
29272,85615,9413,2386,7027,0.253,0.747
29273,85616,5566,0,5566,0.0,1.0
29274,85617,1277,0,1277,0.0,1.0
29275,85618,1725,0,1725,0.0,1.0
29276,85619,50,0,50,0.0,1.0
29277,85620,897,0,897,0.0,1.0
29278,85621,23054,20563,2491,0.892,0.108
29279,85622,6325,4580,1745,0.724,0.276
29280,85623,4073,0,4073,0.0,1.0
29281,85624,1426,0,1426,0.0,1.0
29282,85625,1983,0,1983,0.0,1.0
29283,85626,1021,984,37,0.964,0.036
29284,85627,968,0,968,0.0,1.0
29285,85629,23568,17662,5906,0.749,0.251
29286,85630,2819,0,2819,0.0,1.0
29287,85631,3630,3185,445,0.877,0.123
29288,85632,835,0,835,0.0,1.0
29289,85633,54,0,54,0.0,1.0
29290,85634,6490,0,6490,0.0,1.0
29291,85635,34727,32331,2396,0.931,0.069
29292,85637,1268,0,1268,0.0,1.0
29293,85638,1973,0,1973,0.0,1.0
29294,85640,441,0,441,0.0,1.0
29295,85641,21753,14356,7397,0.66,0.34
29296,85643,9810,3671,6139,0.374,0.626
29297,85645,2231,0,2231,0.0,1.0
29298,85646,1311,0,1311,0.0,1.0
29299,85648,19080,14109,4971,0.739,0.261
29300,85650,15279,12589,2690,0.824,0.176
29301,85653,15083,9456,5627,0.627,0.373
29302,85654,97,0,97,0.0,1.0
29303,85658,7790,3718,4072,0.477,0.523
29304,85701,4983,4983,0,1.0,0.0
29305,85704,30929,30929,0,1.0,0.0
29306,85705,57521,57521,0,1.0,0.0
29307,85706,55209,55209,0,1.0,0.0
29308,85707,658,658,0,1.0,0.0
29309,85708,2980,2980,0,1.0,0.0
29310,85710,54439,54439,0,1.0,0.0
29311,85711,41251,41251,0,1.0,0.0
29312,85712,32666,32666,0,1.0,0.0
29313,85713,50151,49863,288,0.994,0.006
29314,85714,15009,15009,0,1.0,0.0
29315,85715,17702,17702,0,1.0,0.0
29316,85716,32853,32853,0,1.0,0.0
29317,85718,27367,27163,204,0.993,0.007
29318,85719,43989,43989,0,1.0,0.0
29319,85723,0,0,0,,
29320,85724,0,0,0,,
29321,85726,0,0,0,,
29322,85730,38323,37357,966,0.975,0.025
29323,85735,11250,7997,3253,0.711,0.289
29324,85736,4975,0,4975,0.0,1.0
29325,85737,20727,20685,42,0.998,0.002
29326,85739,17848,15330,2518,0.859,0.141
29327,85741,32998,32998,0,1.0,0.0
29328,85742,25212,23908,1304,0.948,0.052
29329,85743,29144,23361,5783,0.802,0.198
29330,85745,37006,33102,3904,0.895,0.105
29331,85746,43057,41820,1237,0.971,0.029
29332,85747,23058,19558,3500,0.848,0.152
29333,85748,18087,16615,1472,0.919,0.081
29334,85749,19032,16359,2673,0.86,0.14
29335,85750,24161,23572,589,0.976,0.024
29336,85755,15107,13362,1745,0.884,0.116
29337,85756,35703,34069,1634,0.954,0.046
29338,85757,16988,16633,355,0.979,0.021
29339,85901,17207,9144,8063,0.531,0.469
29340,85911,1800,0,1800,0.0,1.0
29341,85912,178,0,178,0.0,1.0
29342,85920,464,0,464,0.0,1.0
29343,85922,41,0,41,0.0,1.0
29344,85923,621,0,621,0.0,1.0
29345,85924,2683,0,2683,0.0,1.0
29346,85925,4893,4163,730,0.851,0.149
29347,85926,265,118,147,0.445,0.555
29348,85927,176,0,176,0.0,1.0
29349,85928,1102,0,1102,0.0,1.0
29350,85929,8322,6795,1527,0.817,0.183
29351,85930,1086,0,1086,0.0,1.0
29352,85931,207,0,207,0.0,1.0
29353,85932,364,0,364,0.0,1.0
29354,85933,3033,0,3033,0.0,1.0
29355,85934,574,0,574,0.0,1.0
29356,85935,4735,3275,1460,0.692,0.308
29357,85936,4293,2550,1743,0.594,0.406
29358,85937,7638,3832,3806,0.502,0.498
29359,85938,2366,1932,434,0.817,0.183
29360,85939,4400,2447,1953,0.556,0.444
29361,85940,1443,0,1443,0.0,1.0
29362,85941,9941,6070,3871,0.611,0.389
29363,85942,80,0,80,0.0,1.0
29364,86001,40776,36157,4619,0.887,0.113
29365,86003,23,0,23,0.0,1.0
29366,86004,37338,29438,7900,0.788,0.212
29367,86011,6362,6362,0,1.0,0.0
29368,86015,385,0,385,0.0,1.0
29369,86016,62,0,62,0.0,1.0
29370,86017,667,0,667,0.0,1.0
29371,86018,759,0,759,0.0,1.0
29372,86020,1941,0,1941,0.0,1.0
29373,86021,6085,5836,249,0.959,0.041
29374,86022,2210,0,2210,0.0,1.0
29375,86023,2627,0,2627,0.0,1.0
29376,86024,703,0,703,0.0,1.0
29377,86025,5676,3800,1876,0.669,0.331
29378,86028,47,0,47,0.0,1.0
29379,86029,320,0,320,0.0,1.0
29380,86030,1374,0,1374,0.0,1.0
29381,86031,1856,0,1856,0.0,1.0
29382,86032,1509,0,1509,0.0,1.0
29383,86033,7844,4688,3156,0.598,0.402
29384,86034,2271,0,2271,0.0,1.0
29385,86035,1802,0,1802,0.0,1.0
29386,86036,388,0,388,0.0,1.0
29387,86038,77,0,77,0.0,1.0
29388,86039,1467,0,1467,0.0,1.0
29389,86040,10283,6665,3618,0.648,0.352
29390,86042,1778,0,1778,0.0,1.0
29391,86043,1798,0,1798,0.0,1.0
29392,86044,4251,0,4251,0.0,1.0
29393,86045,11354,8858,2496,0.78,0.22
29394,86046,6090,2639,3451,0.433,0.567
29395,86047,14970,9765,5205,0.652,0.348
29396,86052,28,0,28,0.0,1.0
29397,86053,2311,0,2311,0.0,1.0
29398,86054,1935,0,1935,0.0,1.0
29399,86301,20626,18485,2141,0.896,0.104
29400,86303,17082,14039,3043,0.822,0.178
29401,86305,17356,8958,8398,0.516,0.484
29402,86313,257,257,0,1.0,0.0
29403,86314,34401,33615,786,0.977,0.023
29404,86315,7234,4751,2483,0.657,0.343
29405,86320,1885,0,1885,0.0,1.0
29406,86321,2219,0,2219,0.0,1.0
29407,86322,11480,5305,6175,0.462,0.538
29408,86323,15822,10783,5039,0.682,0.318
29409,86324,4168,3197,971,0.767,0.233
29410,86325,5152,1059,4093,0.206,0.794
29411,86326,23344,22394,950,0.959,0.041
29412,86327,8858,4639,4219,0.524,0.476
29413,86329,1179,0,1179,0.0,1.0
29414,86331,477,0,477,0.0,1.0
29415,86332,1637,0,1637,0.0,1.0
29416,86333,5734,0,5734,0.0,1.0
29417,86334,4985,0,4985,0.0,1.0
29418,86335,4806,3429,1377,0.713,0.287
29419,86336,11320,6761,4559,0.597,0.403
29420,86337,1267,0,1267,0.0,1.0
29421,86338,743,0,743,0.0,1.0
29422,86343,177,0,177,0.0,1.0
29423,86351,6349,5309,1040,0.836,0.164
29424,86401,24289,18705,5584,0.77,0.23
29425,86403,15802,15440,362,0.977,0.023
29426,86404,16243,14915,1328,0.918,0.082
29427,86406,23763,23072,691,0.971,0.029
29428,86409,26471,23402,3069,0.884,0.116
29429,86411,224,0,224,0.0,1.0
29430,86413,12103,0,12103,0.0,1.0
29431,86426,13863,13477,386,0.972,0.028
29432,86429,7162,4277,2885,0.597,0.403
29433,86431,403,0,403,0.0,1.0
29434,86432,3933,413,3520,0.105,0.895
29435,86433,111,0,111,0.0,1.0
29436,86434,1490,0,1490,0.0,1.0
29437,86435,487,0,487,0.0,1.0
29438,86436,2104,0,2104,0.0,1.0
29439,86437,76,0,76,0.0,1.0
29440,86438,913,0,913,0.0,1.0
29441,86440,6906,3957,2949,0.573,0.427
29442,86441,2224,0,2224,0.0,1.0
29443,86442,33382,30722,2660,0.92,0.08
29444,86443,76,0,76,0.0,1.0
29445,86444,1289,0,1289,0.0,1.0
29446,86445,311,0,311,0.0,1.0
29447,86502,1464,0,1464,0.0,1.0
29448,86503,10714,3407,7307,0.318,0.682
29449,86504,6589,3602,2987,0.547,0.453
29450,86505,7682,0,7682,0.0,1.0
29451,86506,1321,0,1321,0.0,1.0
29452,86507,2340,0,2340,0.0,1.0
29453,86508,752,0,752,0.0,1.0
29454,86510,5358,0,5358,0.0,1.0
29455,86511,3694,942,2752,0.255,0.745
29456,86512,2439,0,2439,0.0,1.0
29457,86514,3317,0,3317,0.0,1.0
29458,86515,4479,2568,1911,0.573,0.427
29459,86520,1793,0,1793,0.0,1.0
29460,86535,1199,0,1199,0.0,1.0
29461,86538,2338,0,2338,0.0,1.0
29462,86540,1088,0,1088,0.0,1.0
29463,86544,1267,0,1267,0.0,1.0
29464,86545,1650,0,1650,0.0,1.0
29465,86547,1171,0,1171,0.0,1.0
29466,86556,2090,0,2090,0.0,1.0
29467,87001,3684,449,3235,0.122,0.878
29468,87002,22517,15903,6614,0.706,0.294
29469,87004,10136,9708,428,0.958,0.042
29470,87005,799,0,799,0.0,1.0
29471,87006,703,0,703,0.0,1.0
29472,87007,1080,0,1080,0.0,1.0
29473,87008,2552,0,2552,0.0,1.0
29474,87010,1139,0,1139,0.0,1.0
29475,87011,84,0,84,0.0,1.0
29476,87012,261,0,261,0.0,1.0
29477,87013,5200,0,5200,0.0,1.0
29478,87014,654,0,654,0.0,1.0
29479,87015,13105,3506,9599,0.268,0.732
29480,87016,3730,0,3730,0.0,1.0
29481,87017,429,0,429,0.0,1.0
29482,87018,522,0,522,0.0,1.0
29483,87020,11347,9040,2307,0.797,0.203
29484,87021,3472,3112,360,0.896,0.104
29485,87022,907,832,75,0.917,0.083
29486,87023,665,0,665,0.0,1.0
29487,87024,2214,0,2214,0.0,1.0
29488,87025,1237,0,1237,0.0,1.0
29489,87026,4063,0,4063,0.0,1.0
29490,87027,309,0,309,0.0,1.0
29491,87028,145,0,145,0.0,1.0
29492,87029,237,0,237,0.0,1.0
29493,87031,44075,40637,3438,0.922,0.078
29494,87032,291,0,291,0.0,1.0
29495,87034,2207,0,2207,0.0,1.0
29496,87035,7268,0,7268,0.0,1.0
29497,87036,1868,0,1868,0.0,1.0
29498,87037,677,0,677,0.0,1.0
29499,87038,616,0,616,0.0,1.0
29500,87040,496,0,496,0.0,1.0
29501,87041,881,0,881,0.0,1.0
29502,87042,3644,3465,179,0.951,0.049
29503,87043,5052,544,4508,0.108,0.892
29504,87044,387,0,387,0.0,1.0
29505,87045,1751,0,1751,0.0,1.0
29506,87046,186,0,186,0.0,1.0
29507,87047,4894,0,4894,0.0,1.0
29508,87048,8682,8682,0,1.0,0.0
29509,87049,973,0,973,0.0,1.0
29510,87051,969,0,969,0.0,1.0
29511,87052,3182,2567,615,0.807,0.193
29512,87053,998,0,998,0.0,1.0
29513,87056,954,0,954,0.0,1.0
29514,87059,9604,0,9604,0.0,1.0
29515,87061,371,0,371,0.0,1.0
29516,87062,1869,0,1869,0.0,1.0
29517,87063,323,0,323,0.0,1.0
29518,87064,161,0,161,0.0,1.0
29519,87068,4755,3753,1002,0.789,0.211
29520,87070,42,0,42,0.0,1.0
29521,87072,660,0,660,0.0,1.0
29522,87083,569,0,569,0.0,1.0
29523,87102,21204,21204,0,1.0,0.0
29524,87104,12123,12123,0,1.0,0.0
29525,87105,57680,56713,967,0.983,0.017
29526,87106,27013,27013,0,1.0,0.0
29527,87107,31183,31183,0,1.0,0.0
29528,87108,38647,38647,0,1.0,0.0
29529,87109,40432,40432,0,1.0,0.0
29530,87110,38587,38587,0,1.0,0.0
29531,87111,56490,56484,6,1.0,0.0
29532,87112,43584,43584,0,1.0,0.0
29533,87113,14477,14451,26,0.998,0.002
29534,87114,61623,61623,0,1.0,0.0
29535,87116,4117,4117,0,1.0,0.0
29536,87117,310,310,0,1.0,0.0
29537,87120,58023,57627,396,0.993,0.007
29538,87121,76721,71027,5694,0.926,0.074
29539,87122,17977,17651,326,0.982,0.018
29540,87123,41468,40790,678,0.984,0.016
29541,87124,51404,50733,671,0.987,0.013
29542,87144,37719,36804,915,0.976,0.024
29543,87301,23674,21461,2213,0.907,0.093
29544,87305,3350,0,3350,0.0,1.0
29545,87310,938,0,938,0.0,1.0
29546,87311,4208,290,3918,0.069,0.931
29547,87312,579,0,579,0.0,1.0
29548,87313,5662,0,5662,0.0,1.0
29549,87315,149,0,149,0.0,1.0
29550,87316,1304,0,1304,0.0,1.0
29551,87317,1956,1169,787,0.598,0.402
29552,87319,1832,0,1832,0.0,1.0
29553,87320,765,0,765,0.0,1.0
29554,87321,2226,0,2226,0.0,1.0
29555,87322,247,194,53,0.785,0.215
29556,87323,4558,0,4558,0.0,1.0
29557,87325,3034,0,3034,0.0,1.0
29558,87326,1688,0,1688,0.0,1.0
29559,87327,7883,6744,1139,0.856,0.144
29560,87328,2668,0,2668,0.0,1.0
29561,87347,309,0,309,0.0,1.0
29562,87357,604,0,604,0.0,1.0
29563,87364,1111,0,1111,0.0,1.0
29564,87375,3193,0,3193,0.0,1.0
29565,87401,46293,41478,4815,0.896,0.104
29566,87402,11034,10281,753,0.932,0.068
29567,87410,17603,8836,8767,0.502,0.498
29568,87412,966,0,966,0.0,1.0
29569,87413,16792,9840,6952,0.586,0.414
29570,87415,1791,1393,398,0.778,0.222
29571,87416,5454,1237,4217,0.227,0.773
29572,87417,6910,6532,378,0.945,0.055
29573,87418,1059,0,1059,0.0,1.0
29574,87419,464,0,464,0.0,1.0
29575,87420,11967,6643,5324,0.555,0.445
29576,87421,1871,26,1845,0.014,0.986
29577,87455,1750,0,1750,0.0,1.0
29578,87461,1315,0,1315,0.0,1.0
29579,87499,453,0,453,0.0,1.0
29580,87501,15147,13664,1483,0.902,0.098
29581,87505,31013,27821,3192,0.897,0.103
29582,87506,12580,4871,7709,0.387,0.613
29583,87507,45890,43945,1945,0.958,0.042
29584,87508,18183,8088,10095,0.445,0.555
29585,87510,1096,0,1096,0.0,1.0
29586,87511,2747,2488,259,0.906,0.094
29587,87512,199,0,199,0.0,1.0
29588,87513,1007,0,1007,0.0,1.0
29589,87514,1345,0,1345,0.0,1.0
29590,87515,311,0,311,0.0,1.0
29591,87516,130,0,130,0.0,1.0
29592,87517,356,0,356,0.0,1.0
29593,87518,91,0,91,0.0,1.0
29594,87519,460,0,460,0.0,1.0
29595,87520,1419,0,1419,0.0,1.0
29596,87521,1003,0,1003,0.0,1.0
29597,87522,3384,2486,898,0.735,0.265
29598,87523,405,0,405,0.0,1.0
29599,87524,260,0,260,0.0,1.0
29600,87525,72,0,72,0.0,1.0
29601,87527,880,0,880,0.0,1.0
29602,87528,3417,0,3417,0.0,1.0
29603,87529,3600,973,2627,0.27,0.73
29604,87530,974,0,974,0.0,1.0
29605,87531,368,0,368,0.0,1.0
29606,87532,18223,15970,2253,0.876,0.124
29607,87533,185,185,0,1.0,0.0
29608,87535,1270,0,1270,0.0,1.0
29609,87537,2957,1692,1265,0.572,0.428
29610,87538,493,0,493,0.0,1.0
29611,87539,269,0,269,0.0,1.0
29612,87540,923,0,923,0.0,1.0
29613,87543,247,0,247,0.0,1.0
29614,87544,17950,15932,2018,0.888,0.112
29615,87548,928,0,928,0.0,1.0
29616,87549,1118,0,1118,0.0,1.0
29617,87551,305,0,305,0.0,1.0
29618,87552,3325,0,3325,0.0,1.0
29619,87553,1209,0,1209,0.0,1.0
29620,87554,61,0,61,0.0,1.0
29621,87556,2417,0,2417,0.0,1.0
29622,87557,6359,4366,1993,0.687,0.313
29623,87558,606,0,606,0.0,1.0
29624,87560,1445,0,1445,0.0,1.0
29625,87562,576,0,576,0.0,1.0
29626,87564,332,0,332,0.0,1.0
29627,87565,478,0,478,0.0,1.0
29628,87566,3000,1797,1203,0.599,0.401
29629,87567,1634,1351,283,0.827,0.173
29630,87569,442,0,442,0.0,1.0
29631,87571,11706,8347,3359,0.713,0.287
29632,87573,36,0,36,0.0,1.0
29633,87574,187,0,187,0.0,1.0
29634,87575,789,0,789,0.0,1.0
29635,87577,454,0,454,0.0,1.0
29636,87578,611,0,611,0.0,1.0
29637,87579,890,0,890,0.0,1.0
29638,87580,449,0,449,0.0,1.0
29639,87581,141,0,141,0.0,1.0
29640,87582,1350,449,901,0.333,0.667
29641,87583,234,0,234,0.0,1.0
29642,87701,20081,15609,4472,0.777,0.223
29643,87710,1768,0,1768,0.0,1.0
29644,87711,753,0,753,0.0,1.0
29645,87712,283,0,283,0.0,1.0
29646,87713,283,0,283,0.0,1.0
29647,87714,1151,0,1151,0.0,1.0
29648,87715,532,0,532,0.0,1.0
29649,87718,467,0,467,0.0,1.0
29650,87722,376,0,376,0.0,1.0
29651,87723,408,0,408,0.0,1.0
29652,87724,88,0,88,0.0,1.0
29653,87728,417,0,417,0.0,1.0
29654,87729,126,0,126,0.0,1.0
29655,87730,27,0,27,0.0,1.0
29656,87731,223,0,223,0.0,1.0
29657,87732,1672,0,1672,0.0,1.0
29658,87733,158,0,158,0.0,1.0
29659,87734,181,0,181,0.0,1.0
29660,87735,90,0,90,0.0,1.0
29661,87736,233,0,233,0.0,1.0
29662,87740,8068,6551,1517,0.812,0.188
29663,87742,609,0,609,0.0,1.0
29664,87743,361,0,361,0.0,1.0
29665,87745,654,0,654,0.0,1.0
29666,87746,120,0,120,0.0,1.0
29667,87747,1624,0,1624,0.0,1.0
29668,87749,75,0,75,0.0,1.0
29669,87750,11,0,11,0.0,1.0
29670,87752,431,0,431,0.0,1.0
29671,87753,254,0,254,0.0,1.0
29672,87801,10221,8991,1230,0.88,0.12
29673,87820,161,0,161,0.0,1.0
29674,87821,672,0,672,0.0,1.0
29675,87823,884,0,884,0.0,1.0
29676,87824,194,0,194,0.0,1.0
29677,87825,2999,0,2999,0.0,1.0
29678,87827,276,0,276,0.0,1.0
29679,87828,429,0,429,0.0,1.0
29680,87829,922,0,922,0.0,1.0
29681,87830,999,0,999,0.0,1.0
29682,87831,195,0,195,0.0,1.0
29683,87832,600,0,600,0.0,1.0
29684,87901,7139,6244,895,0.875,0.125
29685,87930,829,0,829,0.0,1.0
29686,87931,634,0,634,0.0,1.0
29687,87933,106,0,106,0.0,1.0
29688,87935,1770,1334,436,0.754,0.246
29689,87936,515,0,515,0.0,1.0
29690,87937,3303,0,3303,0.0,1.0
29691,87939,125,0,125,0.0,1.0
29692,87940,669,0,669,0.0,1.0
29693,87941,1216,0,1216,0.0,1.0
29694,87942,898,340,558,0.379,0.621
29695,87943,228,0,228,0.0,1.0
29696,88001,37484,37355,129,0.997,0.003
29697,88002,1656,0,1656,0.0,1.0
29698,88003,894,894,0,1.0,0.0
29699,88004,699,0,699,0.0,1.0
29700,88005,27116,25330,1786,0.934,0.066
29701,88007,24048,18485,5563,0.769,0.231
29702,88008,5747,5237,510,0.911,0.089
29703,88009,88,0,88,0.0,1.0
29704,88011,27698,23466,4232,0.847,0.153
29705,88012,25961,21369,4592,0.823,0.177
29706,88020,882,0,882,0.0,1.0
29707,88021,18421,12172,6249,0.661,0.339
29708,88022,1343,475,868,0.354,0.646
29709,88023,2406,2344,62,0.974,0.026
29710,88024,236,174,62,0.737,0.263
29711,88025,256,0,256,0.0,1.0
29712,88026,1658,1557,101,0.939,0.061
29713,88027,493,0,493,0.0,1.0
29714,88028,492,0,492,0.0,1.0
29715,88029,1873,0,1873,0.0,1.0
29716,88030,23222,14903,8319,0.642,0.358
29717,88032,195,195,0,1.0,0.0
29718,88033,11,0,11,0.0,1.0
29719,88034,96,0,96,0.0,1.0
29720,88038,431,0,431,0.0,1.0
29721,88039,465,0,465,0.0,1.0
29722,88040,116,0,116,0.0,1.0
29723,88041,1243,0,1243,0.0,1.0
29724,88042,250,0,250,0.0,1.0
29725,88043,1621,179,1442,0.11,0.89
29726,88044,3896,0,3896,0.0,1.0
29727,88045,3662,0,3662,0.0,1.0
29728,88046,697,668,29,0.958,0.042
29729,88047,1967,652,1315,0.331,0.669
29730,88048,3862,2889,973,0.748,0.252
29731,88049,408,0,408,0.0,1.0
29732,88051,94,0,94,0.0,1.0
29733,88052,270,186,84,0.689,0.311
29734,88053,133,0,133,0.0,1.0
29735,88055,37,0,37,0.0,1.0
29736,88056,233,0,233,0.0,1.0
29737,88061,18585,12459,6126,0.67,0.33
29738,88063,12799,12722,77,0.994,0.006
29739,88065,624,0,624,0.0,1.0
29740,88072,2501,2042,459,0.816,0.184
29741,88081,15708,12328,3380,0.785,0.215
29742,88101,45006,41292,3714,0.917,0.083
29743,88103,278,278,0,1.0,0.0
29744,88112,123,0,123,0.0,1.0
29745,88113,103,0,103,0.0,1.0
29746,88114,35,0,35,0.0,1.0
29747,88115,44,0,44,0.0,1.0
29748,88116,455,0,455,0.0,1.0
29749,88118,180,0,180,0.0,1.0
29750,88119,1932,0,1932,0.0,1.0
29751,88120,239,0,239,0.0,1.0
29752,88121,152,0,152,0.0,1.0
29753,88124,1165,0,1165,0.0,1.0
29754,88125,90,0,90,0.0,1.0
29755,88126,30,0,30,0.0,1.0
29756,88130,18651,12610,6041,0.676,0.324
29757,88132,199,0,199,0.0,1.0
29758,88134,46,0,46,0.0,1.0
29759,88135,1804,0,1804,0.0,1.0
29760,88136,44,0,44,0.0,1.0
29761,88201,25490,20865,4625,0.819,0.181
29762,88203,31561,28862,2699,0.914,0.086
29763,88210,17217,12764,4453,0.741,0.259
29764,88220,33725,29839,3886,0.885,0.115
29765,88230,5179,0,5179,0.0,1.0
29766,88231,3238,2826,412,0.873,0.127
29767,88232,2525,0,2525,0.0,1.0
29768,88240,37149,33592,3557,0.904,0.096
29769,88242,6141,3104,3037,0.505,0.495
29770,88250,270,0,270,0.0,1.0
29771,88252,2160,0,2160,0.0,1.0
29772,88253,935,0,935,0.0,1.0
29773,88254,191,0,191,0.0,1.0
29774,88255,128,0,128,0.0,1.0
29775,88256,1925,0,1925,0.0,1.0
29776,88260,14343,11592,2751,0.808,0.192
29777,88262,30,0,30,0.0,1.0
29778,88263,175,0,175,0.0,1.0
29779,88264,39,0,39,0.0,1.0
29780,88265,243,0,243,0.0,1.0
29781,88267,1349,0,1349,0.0,1.0
29782,88268,7,0,7,0.0,1.0
29783,88301,1386,0,1386,0.0,1.0
29784,88310,35776,30887,4889,0.863,0.137
29785,88311,854,0,854,0.0,1.0
29786,88312,2586,0,2586,0.0,1.0
29787,88314,210,0,210,0.0,1.0
29788,88316,2351,0,2351,0.0,1.0
29789,88317,1751,0,1751,0.0,1.0
29790,88318,381,0,381,0.0,1.0
29791,88321,187,0,187,0.0,1.0
29792,88323,14,0,14,0.0,1.0
29793,88324,210,0,210,0.0,1.0
29794,88325,899,0,899,0.0,1.0
29795,88330,3054,3054,0,1.0,0.0
29796,88336,267,0,267,0.0,1.0
29797,88337,2295,975,1320,0.425,0.575
29798,88338,189,0,189,0.0,1.0
29799,88339,618,0,618,0.0,1.0
29800,88340,3616,0,3616,0.0,1.0
29801,88341,538,0,538,0.0,1.0
29802,88342,52,0,52,0.0,1.0
29803,88343,48,0,48,0.0,1.0
29804,88344,159,0,159,0.0,1.0
29805,88345,8845,7028,1817,0.795,0.205
29806,88346,3132,2539,593,0.811,0.189
29807,88347,100,0,100,0.0,1.0
29808,88348,314,0,314,0.0,1.0
29809,88349,70,0,70,0.0,1.0
29810,88350,368,0,368,0.0,1.0
29811,88351,256,0,256,0.0,1.0
29812,88352,5188,2735,2453,0.527,0.473
29813,88353,473,0,473,0.0,1.0
29814,88354,108,0,108,0.0,1.0
29815,88355,29,29,0,1.0,0.0
29816,88401,6944,5283,1661,0.761,0.239
29817,88410,129,0,129,0.0,1.0
29818,88411,82,0,82,0.0,1.0
29819,88414,39,0,39,0.0,1.0
29820,88415,3569,0,3569,0.0,1.0
29821,88416,189,0,189,0.0,1.0
29822,88417,25,0,25,0.0,1.0
29823,88418,294,0,294,0.0,1.0
29824,88419,229,0,229,0.0,1.0
29825,88421,19,0,19,0.0,1.0
29826,88422,68,0,68,0.0,1.0
29827,88424,128,0,128,0.0,1.0
29828,88426,1212,0,1212,0.0,1.0
29829,88427,119,0,119,0.0,1.0
29830,88430,162,0,162,0.0,1.0
29831,88431,49,0,49,0.0,1.0
29832,88434,369,0,369,0.0,1.0
29833,88435,3559,2621,938,0.736,0.264
29834,88436,185,0,185,0.0,1.0
29835,89001,1224,0,1224,0.0,1.0
29836,89002,31880,31880,0,1.0,0.0
29837,89003,1032,0,1032,0.0,1.0
29838,89004,313,0,313,0.0,1.0
29839,89005,15065,13866,1199,0.92,0.08
29840,89007,1351,2,1349,0.001,0.999
29841,89008,1508,0,1508,0.0,1.0
29842,89010,415,0,415,0.0,1.0
29843,89011,19550,18185,1365,0.93,0.07
29844,89012,29085,28327,758,0.974,0.026
29845,89013,285,0,285,0.0,1.0
29846,89014,36922,36922,0,1.0,0.0
29847,89015,38993,38958,35,0.999,0.001
29848,89017,176,0,176,0.0,1.0
29849,89018,1007,0,1007,0.0,1.0
29850,89019,2673,0,2673,0.0,1.0
29851,89020,1456,0,1456,0.0,1.0
29852,89021,3605,2894,711,0.803,0.197
29853,89022,69,0,69,0.0,1.0
29854,89025,1400,0,1400,0.0,1.0
29855,89026,150,0,150,0.0,1.0
29856,89027,15275,13869,1406,0.908,0.092
29857,89029,7546,6129,1417,0.812,0.188
29858,89030,53928,53928,0,1.0,0.0
29859,89031,60589,60589,0,1.0,0.0
29860,89032,40297,40297,0,1.0,0.0
29861,89039,316,0,316,0.0,1.0
29862,89040,3721,3013,708,0.81,0.19
29863,89042,1010,0,1010,0.0,1.0
29864,89043,1429,0,1429,0.0,1.0
29865,89044,14260,13979,281,0.98,0.02
29866,89045,1505,0,1505,0.0,1.0
29867,89046,660,0,660,0.0,1.0
29868,89047,107,0,107,0.0,1.0
29869,89048,21169,18900,2269,0.893,0.107
29870,89049,2727,0,2727,0.0,1.0
29871,89052,47214,47201,13,1.0,0.0
29872,89054,105,0,105,0.0,1.0
29873,89060,10227,6311,3916,0.617,0.383
29874,89061,5252,3235,2017,0.616,0.384
29875,89074,47095,47095,0,1.0,0.0
29876,89081,29774,29774,0,1.0,0.0
29877,89084,21837,21781,56,0.997,0.003
29878,89085,3367,3367,0,1.0,0.0
29879,89086,4726,4478,248,0.948,0.052
29880,89101,46055,46055,0,1.0,0.0
29881,89102,35759,35759,0,1.0,0.0
29882,89103,50519,50519,0,1.0,0.0
29883,89104,39909,39909,0,1.0,0.0
29884,89106,25759,25759,0,1.0,0.0
29885,89107,36282,36282,0,1.0,0.0
29886,89108,70123,70123,0,1.0,0.0
29887,89109,7770,7770,0,1.0,0.0
29888,89110,70994,70899,95,0.999,0.001
29889,89113,23800,23800,0,1.0,0.0
29890,89115,58794,58746,48,0.999,0.001
29891,89117,55416,55416,0,1.0,0.0
29892,89118,19318,19318,0,1.0,0.0
29893,89119,49445,49445,0,1.0,0.0
29894,89120,23311,23311,0,1.0,0.0
29895,89121,64096,64096,0,1.0,0.0
29896,89122,45720,45720,0,1.0,0.0
29897,89123,56300,56300,0,1.0,0.0
29898,89124,941,0,941,0.0,1.0
29899,89128,35669,35669,0,1.0,0.0
29900,89129,51252,51252,0,1.0,0.0
29901,89130,33015,33015,0,1.0,0.0
29902,89131,43072,43029,43,0.999,0.001
29903,89134,24040,24040,0,1.0,0.0
29904,89135,24144,24080,64,0.997,0.003
29905,89138,12118,12103,15,0.999,0.001
29906,89139,30477,30477,0,1.0,0.0
29907,89141,25150,23787,1363,0.946,0.054
29908,89142,33731,33731,0,1.0,0.0
29909,89143,12786,12786,0,1.0,0.0
29910,89144,18714,18714,0,1.0,0.0
29911,89145,23186,23186,0,1.0,0.0
29912,89146,19071,19071,0,1.0,0.0
29913,89147,49778,49778,0,1.0,0.0
29914,89148,39712,39692,20,0.999,0.001
29915,89149,31143,31143,0,1.0,0.0
29916,89156,27794,27125,669,0.976,0.024
29917,89161,184,0,184,0.0,1.0
29918,89166,13209,7749,5460,0.587,0.413
29919,89169,23304,23304,0,1.0,0.0
29920,89178,27588,27397,191,0.993,0.007
29921,89179,2340,2258,82,0.965,0.035
29922,89183,36005,36005,0,1.0,0.0
29923,89191,857,632,225,0.737,0.263
29924,89301,7606,4681,2925,0.615,0.385
29925,89310,550,0,550,0.0,1.0
29926,89311,235,0,235,0.0,1.0
29927,89314,158,0,158,0.0,1.0
29928,89316,1408,0,1408,0.0,1.0
29929,89317,477,0,477,0.0,1.0
29930,89318,1219,0,1219,0.0,1.0
29931,89319,450,0,450,0.0,1.0
29932,89402,71,71,0,1.0,0.0
29933,89403,14158,11127,3031,0.786,0.214
29934,89404,52,0,52,0.0,1.0
29935,89405,239,0,239,0.0,1.0
29936,89406,24772,16241,8531,0.656,0.344
29937,89408,19626,18283,1343,0.932,0.068
29938,89409,283,0,283,0.0,1.0
29939,89410,10557,6119,4438,0.58,0.42
29940,89411,929,0,929,0.0,1.0
29941,89412,288,0,288,0.0,1.0
29942,89413,655,0,655,0.0,1.0
29943,89414,349,0,349,0.0,1.0
29944,89415,3793,3249,544,0.857,0.143
29945,89418,388,0,388,0.0,1.0
29946,89419,5150,0,5150,0.0,1.0
29947,89420,48,0,48,0.0,1.0
29948,89421,634,0,634,0.0,1.0
29949,89422,165,0,165,0.0,1.0
29950,89423,10465,8474,1991,0.81,0.19
29951,89424,341,0,341,0.0,1.0
29952,89425,432,0,432,0.0,1.0
29953,89426,208,0,208,0.0,1.0
29954,89427,746,0,746,0.0,1.0
29955,89428,179,0,179,0.0,1.0
29956,89429,7627,0,7627,0.0,1.0
29957,89430,433,0,433,0.0,1.0
29958,89431,36189,36189,0,1.0,0.0
29959,89433,20188,19990,198,0.99,0.01
29960,89434,25416,24252,1164,0.954,0.046
29961,89436,36867,36000,867,0.976,0.024
29962,89438,48,0,48,0.0,1.0
29963,89439,1417,1205,212,0.85,0.15
29964,89440,947,0,947,0.0,1.0
29965,89441,11542,9159,2383,0.794,0.206
29966,89442,1118,696,422,0.623,0.377
29967,89444,2734,0,2734,0.0,1.0
29968,89445,16114,10268,5846,0.637,0.363
29969,89446,36,0,36,0.0,1.0
29970,89447,7931,2911,5020,0.367,0.633
29971,89448,1695,70,1625,0.041,0.959
29972,89449,2994,1928,1066,0.644,0.356
29973,89450,86,86,0,1.0,0.0
29974,89451,8930,7796,1134,0.873,0.127
29975,89460,13236,10992,2244,0.83,0.17
29976,89501,4252,4252,0,1.0,0.0
29977,89502,43566,42843,723,0.983,0.017
29978,89503,27891,27891,0,1.0,0.0
29979,89506,38379,36260,2119,0.945,0.055
29980,89508,11662,9000,2662,0.772,0.228
29981,89509,33395,33395,0,1.0,0.0
29982,89510,1685,0,1685,0.0,1.0
29983,89511,25011,23483,1528,0.939,0.061
29984,89512,25574,25574,0,1.0,0.0
29985,89519,8392,8359,33,0.996,0.004
29986,89521,25716,23386,2330,0.909,0.091
29987,89523,31373,30894,479,0.985,0.015
29988,89701,27625,26761,864,0.969,0.031
29989,89702,0,0,0,,
29990,89703,9714,8301,1413,0.855,0.145
29991,89704,4290,2645,1645,0.617,0.383
29992,89705,4969,4585,384,0.923,0.077
29993,89706,19510,18291,1219,0.938,0.062
29994,89801,23298,18948,4350,0.813,0.187
29995,89815,13346,7148,6198,0.536,0.464
29996,89820,5358,3520,1838,0.657,0.343
29997,89821,482,0,482,0.0,1.0
29998,89822,2513,0,2513,0.0,1.0
29999,89823,273,0,273,0.0,1.0
30000,89825,1228,0,1228,0.0,1.0
30001,89826,42,0,42,0.0,1.0
30002,89828,268,0,268,0.0,1.0
30003,89830,270,0,270,0.0,1.0
30004,89831,78,0,78,0.0,1.0
30005,89832,1304,0,1304,0.0,1.0
30006,89833,201,0,201,0.0,1.0
30007,89834,126,0,126,0.0,1.0
30008,89835,1822,0,1822,0.0,1.0
30009,89883,4488,4244,244,0.946,0.054
30010,90001,57110,57110,0,1.0,0.0
30011,90002,51223,51223,0,1.0,0.0
30012,90003,66266,66266,0,1.0,0.0
30013,90004,62180,62180,0,1.0,0.0
30014,90005,37681,37681,0,1.0,0.0
30015,90006,59185,59185,0,1.0,0.0
30016,90007,40920,40920,0,1.0,0.0
30017,90008,32327,32327,0,1.0,0.0
30018,90010,3800,3800,0,1.0,0.0
30019,90011,103892,103892,0,1.0,0.0
30020,90012,31103,31103,0,1.0,0.0
30021,90013,11772,11772,0,1.0,0.0
30022,90014,7005,7005,0,1.0,0.0
30023,90015,18986,18986,0,1.0,0.0
30024,90016,47596,47596,0,1.0,0.0
30025,90017,23768,23768,0,1.0,0.0
30026,90018,49310,49310,0,1.0,0.0
30027,90019,64458,64458,0,1.0,0.0
30028,90020,38967,38967,0,1.0,0.0
30029,90021,3951,3951,0,1.0,0.0
30030,90022,67179,67179,0,1.0,0.0
30031,90023,45903,45903,0,1.0,0.0
30032,90024,47452,47452,0,1.0,0.0
30033,90025,42147,42147,0,1.0,0.0
30034,90026,67869,67869,0,1.0,0.0
30035,90027,45151,45141,10,1.0,0.0
30036,90028,28714,28714,0,1.0,0.0
30037,90029,38617,38617,0,1.0,0.0
30038,90031,39316,39316,0,1.0,0.0
30039,90032,45786,45786,0,1.0,0.0
30040,90033,48852,48852,0,1.0,0.0
30041,90034,57964,57964,0,1.0,0.0
30042,90035,28418,28418,0,1.0,0.0
30043,90036,36865,36865,0,1.0,0.0
30044,90037,62276,62276,0,1.0,0.0
30045,90038,28917,28917,0,1.0,0.0
30046,90039,28514,28514,0,1.0,0.0
30047,90040,12520,12520,0,1.0,0.0
30048,90041,27425,27425,0,1.0,0.0
30049,90042,62430,62430,0,1.0,0.0
30050,90043,44789,44789,0,1.0,0.0
30051,90044,89779,89779,0,1.0,0.0
30052,90045,39480,39480,0,1.0,0.0
30053,90046,48581,48581,0,1.0,0.0
30054,90047,48606,48606,0,1.0,0.0
30055,90048,21397,21397,0,1.0,0.0
30056,90049,35482,33735,1747,0.951,0.049
30057,90056,7827,7827,0,1.0,0.0
30058,90057,44998,44998,0,1.0,0.0
30059,90058,3223,3223,0,1.0,0.0
30060,90059,40952,40952,0,1.0,0.0
30061,90061,26872,26872,0,1.0,0.0
30062,90062,32821,32821,0,1.0,0.0
30063,90063,55758,55758,0,1.0,0.0
30064,90064,25403,25403,0,1.0,0.0
30065,90065,45527,45527,0,1.0,0.0
30066,90066,55277,55277,0,1.0,0.0
30067,90067,2424,2424,0,1.0,0.0
30068,90068,22286,22282,4,1.0,0.0
30069,90069,20483,20483,0,1.0,0.0
30070,90071,15,15,0,1.0,0.0
30071,90073,539,539,0,1.0,0.0
30072,90077,9377,9377,0,1.0,0.0
30073,90079,0,0,0,,
30074,90089,3217,3217,0,1.0,0.0
30075,90090,0,0,0,,
30076,90094,5464,5464,0,1.0,0.0
30077,90095,3,3,0,1.0,0.0
30078,90201,101279,101279,0,1.0,0.0
30079,90210,21741,21741,0,1.0,0.0
30080,90211,8434,8434,0,1.0,0.0
30081,90212,11555,11555,0,1.0,0.0
30082,90220,49328,49328,0,1.0,0.0
30083,90221,53704,53704,0,1.0,0.0
30084,90222,31869,31869,0,1.0,0.0
30085,90230,31766,31766,0,1.0,0.0
30086,90232,15149,15149,0,1.0,0.0
30087,90240,25876,25876,0,1.0,0.0
30088,90241,42399,42399,0,1.0,0.0
30089,90242,43497,43497,0,1.0,0.0
30090,90245,16654,16654,0,1.0,0.0
30091,90247,47487,47487,0,1.0,0.0
30092,90248,9947,9947,0,1.0,0.0
30093,90249,26669,26669,0,1.0,0.0
30094,90250,93193,93193,0,1.0,0.0
30095,90254,19506,19506,0,1.0,0.0
30096,90255,75066,75066,0,1.0,0.0
30097,90260,34924,34924,0,1.0,0.0
30098,90262,69745,69745,0,1.0,0.0
30099,90263,1612,1612,0,1.0,0.0
30100,90265,18116,12929,5187,0.714,0.286
30101,90266,35135,35135,0,1.0,0.0
30102,90270,27372,27372,0,1.0,0.0
30103,90272,22986,22818,168,0.993,0.007
30104,90274,25209,25209,0,1.0,0.0
30105,90275,41804,41804,0,1.0,0.0
30106,90277,35293,35293,0,1.0,0.0
30107,90278,40071,40071,0,1.0,0.0
30108,90280,94396,94396,0,1.0,0.0
30109,90290,6368,4437,1931,0.697,0.303
30110,90291,28341,28341,0,1.0,0.0
30111,90292,21576,21576,0,1.0,0.0
30112,90293,12132,12132,0,1.0,0.0
30113,90301,36568,36568,0,1.0,0.0
30114,90302,29415,29415,0,1.0,0.0
30115,90303,26176,26176,0,1.0,0.0
30116,90304,28210,28210,0,1.0,0.0
30117,90305,14853,14853,0,1.0,0.0
30118,90401,6722,6722,0,1.0,0.0
30119,90402,12250,12250,0,1.0,0.0
30120,90403,24525,24525,0,1.0,0.0
30121,90404,21360,21360,0,1.0,0.0
30122,90405,27186,27186,0,1.0,0.0
30123,90501,43180,43180,0,1.0,0.0
30124,90502,18010,18010,0,1.0,0.0
30125,90503,44383,44383,0,1.0,0.0
30126,90504,32102,32102,0,1.0,0.0
30127,90505,36678,36678,0,1.0,0.0
30128,90506,0,0,0,,
30129,90601,31974,31974,0,1.0,0.0
30130,90602,25777,25777,0,1.0,0.0
30131,90603,20063,20063,0,1.0,0.0
30132,90604,39407,39407,0,1.0,0.0
30133,90605,40331,40331,0,1.0,0.0
30134,90606,32396,32396,0,1.0,0.0
30135,90620,45113,45113,0,1.0,0.0
30136,90621,35153,35153,0,1.0,0.0
30137,90623,15554,15554,0,1.0,0.0
30138,90630,47993,47993,0,1.0,0.0
30139,90631,67619,67619,0,1.0,0.0
30140,90638,49012,49012,0,1.0,0.0
30141,90640,62549,62549,0,1.0,0.0
30142,90650,105549,105549,0,1.0,0.0
30143,90660,62928,62928,0,1.0,0.0
30144,90670,14866,14866,0,1.0,0.0
30145,90680,29945,29945,0,1.0,0.0
30146,90701,16591,16591,0,1.0,0.0
30147,90703,49399,49399,0,1.0,0.0
30148,90704,4090,3652,438,0.893,0.107
30149,90706,76615,76615,0,1.0,0.0
30150,90710,25457,25457,0,1.0,0.0
30151,90712,31499,31499,0,1.0,0.0
30152,90713,27925,27925,0,1.0,0.0
30153,90715,20388,20388,0,1.0,0.0
30154,90716,14184,14184,0,1.0,0.0
30155,90717,21318,21318,0,1.0,0.0
30156,90720,21751,21751,0,1.0,0.0
30157,90723,54099,54099,0,1.0,0.0
30158,90731,59662,59662,0,1.0,0.0
30159,90732,21115,21115,0,1.0,0.0
30160,90740,23729,23729,0,1.0,0.0
30161,90742,831,831,0,1.0,0.0
30162,90743,456,456,0,1.0,0.0
30163,90744,53815,53815,0,1.0,0.0
30164,90745,57251,57251,0,1.0,0.0
30165,90746,25990,25990,0,1.0,0.0
30166,90747,0,0,0,,
30167,90755,11074,11074,0,1.0,0.0
30168,90802,39347,39347,0,1.0,0.0
30169,90803,32031,32031,0,1.0,0.0
30170,90804,40311,40311,0,1.0,0.0
30171,90805,93524,93524,0,1.0,0.0
30172,90806,42399,42399,0,1.0,0.0
30173,90807,31481,31481,0,1.0,0.0
30174,90808,38232,38232,0,1.0,0.0
30175,90810,36735,36735,0,1.0,0.0
30176,90813,58911,58911,0,1.0,0.0
30177,90814,19131,19131,0,1.0,0.0
30178,90815,39733,39733,0,1.0,0.0
30179,90822,117,117,0,1.0,0.0
30180,90831,0,0,0,,
30181,91001,36126,36122,4,1.0,0.0
30182,91006,31715,31715,0,1.0,0.0
30183,91007,34095,34095,0,1.0,0.0
30184,91008,1391,1391,0,1.0,0.0
30185,91010,26074,26069,5,1.0,0.0
30186,91011,20280,20269,11,0.999,0.001
30187,91016,40598,40378,220,0.995,0.005
30188,91020,8415,8415,0,1.0,0.0
30189,91024,10917,10917,0,1.0,0.0
30190,91030,25616,25616,0,1.0,0.0
30191,91040,20372,20368,4,1.0,0.0
30192,91042,27585,27473,112,0.996,0.004
30193,91046,156,156,0,1.0,0.0
30194,91101,20460,20460,0,1.0,0.0
30195,91103,27480,27480,0,1.0,0.0
30196,91104,36751,36751,0,1.0,0.0
30197,91105,11254,11254,0,1.0,0.0
30198,91106,24229,24229,0,1.0,0.0
30199,91107,32940,32930,10,1.0,0.0
30200,91108,13361,13361,0,1.0,0.0
30201,91201,22781,22781,0,1.0,0.0
30202,91202,22830,22830,0,1.0,0.0
30203,91203,13220,13220,0,1.0,0.0
30204,91204,16032,16032,0,1.0,0.0
30205,91205,37810,37810,0,1.0,0.0
30206,91206,33065,33065,0,1.0,0.0
30207,91207,10506,10506,0,1.0,0.0
30208,91208,16245,16245,0,1.0,0.0
30209,91210,328,328,0,1.0,0.0
30210,91214,30356,30060,296,0.99,0.01
30211,91301,25488,22751,2737,0.893,0.107
30212,91302,25709,23367,2342,0.909,0.091
30213,91303,26855,26855,0,1.0,0.0
30214,91304,50231,50043,188,0.996,0.004
30215,91306,45061,45061,0,1.0,0.0
30216,91307,24474,24015,459,0.981,0.019
30217,91311,36557,35655,902,0.975,0.025
30218,91316,26898,26898,0,1.0,0.0
30219,91320,44274,44224,50,0.999,0.001
30220,91321,34882,33943,939,0.973,0.027
30221,91324,27669,27669,0,1.0,0.0
30222,91325,32417,32417,0,1.0,0.0
30223,91326,33708,33708,0,1.0,0.0
30224,91330,2702,2702,0,1.0,0.0
30225,91331,103689,103689,0,1.0,0.0
30226,91335,74363,74363,0,1.0,0.0
30227,91340,34188,34188,0,1.0,0.0
30228,91342,91725,91439,286,0.997,0.003
30229,91343,60254,60254,0,1.0,0.0
30230,91344,51747,51355,392,0.992,0.008
30231,91345,18496,18496,0,1.0,0.0
30232,91350,33348,32884,464,0.986,0.014
30233,91351,32362,32096,266,0.992,0.008
30234,91352,47807,47673,134,0.997,0.003
30235,91354,28722,28444,278,0.99,0.01
30236,91355,32605,32543,62,0.998,0.002
30237,91356,29458,29458,0,1.0,0.0
30238,91360,42402,41851,551,0.987,0.013
30239,91361,20438,19340,1098,0.946,0.054
30240,91362,36045,35981,64,0.998,0.002
30241,91364,25851,25851,0,1.0,0.0
30242,91367,39499,39499,0,1.0,0.0
30243,91371,1,1,0,1.0,0.0
30244,91377,13811,13811,0,1.0,0.0
30245,91381,20158,18257,1901,0.906,0.094
30246,91384,29855,26843,3012,0.899,0.101
30247,91387,40328,39802,526,0.987,0.013
30248,91390,19786,13841,5945,0.7,0.3
30249,91401,39285,39285,0,1.0,0.0
30250,91402,69817,69817,0,1.0,0.0
30251,91403,23484,23484,0,1.0,0.0
30252,91405,51145,51145,0,1.0,0.0
30253,91406,51558,51558,0,1.0,0.0
30254,91411,24628,24628,0,1.0,0.0
30255,91423,30991,30991,0,1.0,0.0
30256,91436,14372,14372,0,1.0,0.0
30257,91501,20849,20849,0,1.0,0.0
30258,91502,11371,11371,0,1.0,0.0
30259,91504,24939,24939,0,1.0,0.0
30260,91505,30778,30778,0,1.0,0.0
30261,91506,18904,18904,0,1.0,0.0
30262,91601,37180,37180,0,1.0,0.0
30263,91602,17473,17473,0,1.0,0.0
30264,91604,29034,29034,0,1.0,0.0
30265,91605,56343,56343,0,1.0,0.0
30266,91606,44958,44958,0,1.0,0.0
30267,91607,27927,27927,0,1.0,0.0
30268,91608,0,0,0,,
30269,91701,38976,38960,16,1.0,0.0
30270,91702,59705,59377,328,0.995,0.005
30271,91706,76571,76571,0,1.0,0.0
30272,91708,3369,3183,186,0.945,0.055
30273,91709,74796,71290,3506,0.953,0.047
30274,91710,80358,80174,184,0.998,0.002
30275,91711,35705,35677,28,0.999,0.001
30276,91722,34409,34409,0,1.0,0.0
30277,91723,18275,18275,0,1.0,0.0
30278,91724,26184,26184,0,1.0,0.0
30279,91730,66925,66925,0,1.0,0.0
30280,91731,29591,29591,0,1.0,0.0
30281,91732,61386,61386,0,1.0,0.0
30282,91733,43896,43896,0,1.0,0.0
30283,91737,24740,24675,65,0.997,0.003
30284,91739,34794,34577,217,0.994,0.006
30285,91740,25356,25356,0,1.0,0.0
30286,91741,25824,25642,182,0.993,0.007
30287,91744,85040,85040,0,1.0,0.0
30288,91745,54013,54013,0,1.0,0.0
30289,91746,30485,30485,0,1.0,0.0
30290,91748,45406,45406,0,1.0,0.0
30291,91750,33249,33247,2,1.0,0.0
30292,91752,30047,30047,0,1.0,0.0
30293,91754,32742,32742,0,1.0,0.0
30294,91755,27496,27496,0,1.0,0.0
30295,91759,476,0,476,0.0,1.0
30296,91761,56913,55946,967,0.983,0.017
30297,91762,55857,55358,499,0.991,0.009
30298,91763,36375,36375,0,1.0,0.0
30299,91764,54086,54086,0,1.0,0.0
30300,91765,46457,46457,0,1.0,0.0
30301,91766,71599,71599,0,1.0,0.0
30302,91767,48068,48068,0,1.0,0.0
30303,91768,34537,34537,0,1.0,0.0
30304,91770,62097,62097,0,1.0,0.0
30305,91773,33119,32932,187,0.994,0.006
30306,91775,23988,23988,0,1.0,0.0
30307,91776,38475,38475,0,1.0,0.0
30308,91780,34332,34332,0,1.0,0.0
30309,91784,25938,25869,69,0.997,0.003
30310,91786,51165,51165,0,1.0,0.0
30311,91789,43079,43079,0,1.0,0.0
30312,91790,44907,44907,0,1.0,0.0
30313,91791,32414,32414,0,1.0,0.0
30314,91792,30854,30854,0,1.0,0.0
30315,91801,52735,52735,0,1.0,0.0
30316,91803,30322,30322,0,1.0,0.0
30317,91901,17403,12996,4407,0.747,0.253
30318,91902,17653,17419,234,0.987,0.013
30319,91905,1700,0,1700,0.0,1.0
30320,91906,3627,0,3627,0.0,1.0
30321,91910,75802,75802,0,1.0,0.0
30322,91911,82999,82999,0,1.0,0.0
30323,91913,40971,39155,1816,0.956,0.044
30324,91914,15448,15443,5,1.0,0.0
30325,91915,24659,24618,41,0.998,0.002
30326,91916,1622,0,1622,0.0,1.0
30327,91917,992,0,992,0.0,1.0
30328,91931,592,0,592,0.0,1.0
30329,91932,25718,25718,0,1.0,0.0
30330,91934,737,0,737,0.0,1.0
30331,91935,8624,3278,5346,0.38,0.62
30332,91941,31779,31779,0,1.0,0.0
30333,91942,38069,38069,0,1.0,0.0
30334,91945,25460,25460,0,1.0,0.0
30335,91948,78,0,78,0.0,1.0
30336,91950,60322,60322,0,1.0,0.0
30337,91962,1646,0,1646,0.0,1.0
30338,91963,1118,0,1118,0.0,1.0
30339,91977,58368,58368,0,1.0,0.0
30340,91978,8896,8693,203,0.977,0.023
30341,91980,165,0,165,0.0,1.0
30342,92003,4746,2171,2575,0.457,0.543
30343,92004,3881,0,3881,0.0,1.0
30344,92007,10429,10429,0,1.0,0.0
30345,92008,27649,27649,0,1.0,0.0
30346,92009,40747,40747,0,1.0,0.0
30347,92010,14382,14382,0,1.0,0.0
30348,92011,22405,22405,0,1.0,0.0
30349,92014,13154,13154,0,1.0,0.0
30350,92019,42598,41170,1428,0.966,0.034
30351,92020,57767,57767,0,1.0,0.0
30352,92021,65068,63333,1735,0.973,0.027
30353,92024,49121,48993,128,0.997,0.003
30354,92025,49978,49356,622,0.988,0.012
30355,92026,48922,44563,4359,0.911,0.089
30356,92027,53881,53281,600,0.989,0.011
30357,92028,46239,40224,6015,0.87,0.13
30358,92029,19021,17703,1318,0.931,0.069
30359,92036,3440,0,3440,0.0,1.0
30360,92037,46781,46781,0,1.0,0.0
30361,92040,41281,38745,2536,0.939,0.061
30362,92054,40375,40375,0,1.0,0.0
30363,92055,15655,10949,4706,0.699,0.301
30364,92056,51835,51835,0,1.0,0.0
30365,92057,54096,53834,262,0.995,0.005
30366,92058,42436,41478,958,0.977,0.023
30367,92059,1618,0,1618,0.0,1.0
30368,92060,218,0,218,0.0,1.0
30369,92061,2499,0,2499,0.0,1.0
30370,92064,47904,45663,2241,0.953,0.047
30371,92065,35414,25913,9501,0.732,0.268
30372,92066,378,0,378,0.0,1.0
30373,92067,9535,9278,257,0.973,0.027
30374,92069,46369,45614,755,0.984,0.016
30375,92070,1245,0,1245,0.0,1.0
30376,92071,53422,53418,4,1.0,0.0
30377,92075,12056,12056,0,1.0,0.0
30378,92078,42906,42625,281,0.993,0.007
30379,92081,27404,27404,0,1.0,0.0
30380,92082,19037,0,19037,0.0,1.0
30381,92083,36975,36975,0,1.0,0.0
30382,92084,47654,46021,1633,0.966,0.034
30383,92086,1573,0,1573,0.0,1.0
30384,92091,1048,1048,0,1.0,0.0
30385,92101,37095,37095,0,1.0,0.0
30386,92102,43267,43267,0,1.0,0.0
30387,92103,31066,31066,0,1.0,0.0
30388,92104,44414,44414,0,1.0,0.0
30389,92105,69813,69813,0,1.0,0.0
30390,92106,19330,19330,0,1.0,0.0
30391,92107,28651,28651,0,1.0,0.0
30392,92108,18858,18858,0,1.0,0.0
30393,92109,45787,45787,0,1.0,0.0
30394,92110,25341,25341,0,1.0,0.0
30395,92111,45096,45096,0,1.0,0.0
30396,92113,56066,56066,0,1.0,0.0
30397,92114,65433,65433,0,1.0,0.0
30398,92115,58560,58560,0,1.0,0.0
30399,92116,31680,31680,0,1.0,0.0
30400,92117,51332,51332,0,1.0,0.0
30401,92118,23575,23575,0,1.0,0.0
30402,92119,23057,23057,0,1.0,0.0
30403,92120,26317,26317,0,1.0,0.0
30404,92121,4179,4179,0,1.0,0.0
30405,92122,43728,43728,0,1.0,0.0
30406,92123,26823,26823,0,1.0,0.0
30407,92124,30443,30443,0,1.0,0.0
30408,92126,73343,73343,0,1.0,0.0
30409,92127,39337,38421,916,0.977,0.023
30410,92128,47490,47490,0,1.0,0.0
30411,92129,51536,51402,134,0.997,0.003
30412,92130,48940,48940,0,1.0,0.0
30413,92131,32787,32764,23,0.999,0.001
30414,92132,0,0,0,,
30415,92134,198,198,0,1.0,0.0
30416,92135,571,571,0,1.0,0.0
30417,92139,35125,35125,0,1.0,0.0
30418,92140,3435,3435,0,1.0,0.0
30419,92145,1449,881,568,0.608,0.392
30420,92147,559,559,0,1.0,0.0
30421,92154,79708,79655,53,0.999,0.001
30422,92155,550,550,0,1.0,0.0
30423,92173,29429,29179,250,0.992,0.008
30424,92201,61827,61399,428,0.993,0.007
30425,92203,25605,25151,454,0.982,0.018
30426,92210,4677,3965,712,0.848,0.152
30427,92211,24294,24139,155,0.994,0.006
30428,92220,31638,29298,2340,0.926,0.074
30429,92222,45,0,45,0.0,1.0
30430,92223,43605,42223,1382,0.968,0.032
30431,92225,24310,12036,12274,0.495,0.505
30432,92227,26234,25032,1202,0.954,0.046
30433,92230,2550,0,2550,0.0,1.0
30434,92231,39073,38531,542,0.986,0.014
30435,92233,8099,3538,4561,0.437,0.563
30436,92234,51151,51151,0,1.0,0.0
30437,92236,41083,40506,577,0.986,0.014
30438,92239,223,0,223,0.0,1.0
30439,92240,34722,33776,946,0.973,0.027
30440,92241,8803,5057,3746,0.574,0.426
30441,92242,1539,93,1446,0.06,0.94
30442,92243,48030,45757,2273,0.953,0.047
30443,92249,7334,7219,115,0.984,0.016
30444,92250,8285,6876,1409,0.83,0.17
30445,92251,21583,16165,5418,0.749,0.251
30446,92252,9647,4845,4802,0.502,0.498
30447,92253,37262,36658,604,0.984,0.016
30448,92254,12768,10793,1975,0.845,0.155
30449,92256,3588,0,3588,0.0,1.0
30450,92257,2326,0,2326,0.0,1.0
30451,92258,861,612,249,0.711,0.289
30452,92259,390,0,390,0.0,1.0
30453,92260,31753,31527,226,0.993,0.007
30454,92262,26179,25374,805,0.969,0.031
30455,92264,19383,18144,1239,0.936,0.064
30456,92266,234,0,234,0.0,1.0
30457,92267,126,0,126,0.0,1.0
30458,92268,574,0,574,0.0,1.0
30459,92270,17220,17006,214,0.988,0.012
30460,92273,1823,0,1823,0.0,1.0
30461,92274,19801,7899,11902,0.399,0.601
30462,92275,1506,0,1506,0.0,1.0
30463,92276,7585,6133,1452,0.809,0.191
30464,92277,23911,17433,6478,0.729,0.271
30465,92278,3846,3846,0,1.0,0.0
30466,92280,14,0,14,0.0,1.0
30467,92281,2432,0,2432,0.0,1.0
30468,92282,1239,0,1239,0.0,1.0
30469,92283,3158,1011,2147,0.32,0.68
30470,92284,25095,18960,6135,0.756,0.244
30471,92285,2632,0,2632,0.0,1.0
30472,92301,32725,31381,1344,0.959,0.041
30473,92304,17,0,17,0.0,1.0
30474,92305,535,0,535,0.0,1.0
30475,92307,37630,34358,3272,0.913,0.087
30476,92308,39837,36017,3820,0.904,0.096
30477,92309,763,0,763,0.0,1.0
30478,92310,8845,8845,0,1.0,0.0
30479,92311,31894,28973,2921,0.908,0.092
30480,92313,12025,12025,0,1.0,0.0
30481,92314,10162,8606,1556,0.847,0.153
30482,92315,5094,5014,80,0.984,0.016
30483,92316,30830,30830,0,1.0,0.0
30484,92320,7788,7185,603,0.923,0.077
30485,92321,1522,1310,212,0.861,0.139
30486,92322,1257,1023,234,0.814,0.186
30487,92324,56505,55676,829,0.985,0.015
30488,92325,9391,9171,220,0.977,0.023
30489,92327,632,0,632,0.0,1.0
30490,92328,445,0,445,0.0,1.0
30491,92332,65,0,65,0.0,1.0
30492,92333,472,0,472,0.0,1.0
30493,92335,95397,95397,0,1.0,0.0
30494,92336,88419,88383,36,1.0,0.0
30495,92337,37849,37849,0,1.0,0.0
30496,92338,12,0,12,0.0,1.0
30497,92339,885,0,885,0.0,1.0
30498,92341,410,0,410,0.0,1.0
30499,92342,6379,5394,985,0.846,0.154
30500,92344,20769,18904,1865,0.91,0.09
30501,92345,78715,77541,1174,0.985,0.015
30502,92346,54923,54706,217,0.996,0.004
30503,92347,1692,0,1692,0.0,1.0
30504,92352,8004,7869,135,0.983,0.017
30505,92354,21559,21297,262,0.988,0.012
30506,92356,6455,0,6455,0.0,1.0
30507,92358,707,0,707,0.0,1.0
30508,92359,8103,7538,565,0.93,0.07
30509,92363,5321,4563,758,0.858,0.142
30510,92364,90,0,90,0.0,1.0
30511,92365,2637,0,2637,0.0,1.0
30512,92368,1113,342,771,0.307,0.693
30513,92371,16763,6510,10253,0.388,0.612
30514,92372,6220,431,5789,0.069,0.931
30515,92373,33423,32038,1385,0.959,0.041
30516,92374,40267,39883,384,0.99,0.01
30517,92376,81516,81516,0,1.0,0.0
30518,92377,19989,19989,0,1.0,0.0
30519,92378,183,181,2,0.989,0.011
30520,92382,5268,4811,457,0.913,0.087
30521,92384,36,0,36,0.0,1.0
30522,92385,313,245,68,0.783,0.217
30523,92386,2270,2253,17,0.993,0.007
30524,92389,156,0,156,0.0,1.0
30525,92391,2534,2376,158,0.938,0.062
30526,92392,54858,54147,711,0.987,0.013
30527,92394,33237,33086,151,0.995,0.005
30528,92395,42400,42366,34,0.999,0.001
30529,92397,4894,4096,798,0.837,0.163
30530,92398,1379,0,1379,0.0,1.0
30531,92399,52606,50360,2246,0.957,0.043
30532,92401,1932,1932,0,1.0,0.0
30533,92404,58271,57899,372,0.994,0.006
30534,92405,28873,28873,0,1.0,0.0
30535,92407,56689,54181,2508,0.956,0.044
30536,92408,15271,15271,0,1.0,0.0
30537,92410,49410,49410,0,1.0,0.0
30538,92411,26214,26214,0,1.0,0.0
30539,92501,20970,20970,0,1.0,0.0
30540,92503,84519,84326,193,0.998,0.002
30541,92504,53778,53006,772,0.986,0.014
30542,92505,47672,47672,0,1.0,0.0
30543,92506,44001,44001,0,1.0,0.0
30544,92507,58002,57920,82,0.999,0.001
30545,92508,35000,35000,0,1.0,0.0
30546,92509,75196,75196,0,1.0,0.0
30547,92518,1162,543,619,0.467,0.533
30548,92530,50216,48417,1799,0.964,0.036
30549,92532,18644,17317,1327,0.929,0.071
30550,92536,3810,0,3810,0.0,1.0
30551,92539,4734,0,4734,0.0,1.0
30552,92543,33555,33200,355,0.989,0.011
30553,92544,44734,41188,3546,0.921,0.079
30554,92545,39457,38087,1370,0.965,0.035
30555,92548,6643,5851,792,0.881,0.119
30556,92549,3926,0,3926,0.0,1.0
30557,92551,30815,30815,0,1.0,0.0
30558,92553,73722,73722,0,1.0,0.0
30559,92555,39076,37518,1558,0.96,0.04
30560,92557,50320,49846,474,0.991,0.009
30561,92561,1661,0,1661,0.0,1.0
30562,92562,62079,58486,3593,0.942,0.058
30563,92563,53892,53596,296,0.995,0.005
30564,92567,9459,7682,1777,0.812,0.188
30565,92570,53697,46256,7441,0.861,0.139
30566,92571,52516,51982,534,0.99,0.01
30567,92582,15649,15385,264,0.983,0.017
30568,92583,30236,29318,918,0.97,0.03
30569,92584,43400,41666,1734,0.96,0.04
30570,92585,17797,17414,383,0.978,0.022
30571,92586,19815,19815,0,1.0,0.0
30572,92587,16675,16623,52,0.997,0.003
30573,92590,3660,1470,2190,0.402,0.598
30574,92591,38272,37670,602,0.984,0.016
30575,92592,72492,65396,7096,0.902,0.098
30576,92595,29851,29115,736,0.975,0.025
30577,92596,23172,21413,1759,0.924,0.076
30578,92602,22871,22871,0,1.0,0.0
30579,92603,20184,19935,249,0.988,0.012
30580,92604,26853,26853,0,1.0,0.0
30581,92606,21495,21495,0,1.0,0.0
30582,92610,11248,11244,4,1.0,0.0
30583,92612,27522,27522,0,1.0,0.0
30584,92614,24748,24748,0,1.0,0.0
30585,92617,14044,14044,0,1.0,0.0
30586,92618,16366,16179,187,0.989,0.011
30587,92620,38486,38486,0,1.0,0.0
30588,92624,7248,7248,0,1.0,0.0
30589,92625,12478,12478,0,1.0,0.0
30590,92626,49341,49341,0,1.0,0.0
30591,92627,61510,61510,0,1.0,0.0
30592,92629,25756,25756,0,1.0,0.0
30593,92630,59182,59182,0,1.0,0.0
30594,92637,16012,16012,0,1.0,0.0
30595,92646,55224,55224,0,1.0,0.0
30596,92647,57245,57245,0,1.0,0.0
30597,92648,45317,45317,0,1.0,0.0
30598,92649,32463,32463,0,1.0,0.0
30599,92651,23881,23688,193,0.992,0.008
30600,92653,29291,29291,0,1.0,0.0
30601,92655,8337,8337,0,1.0,0.0
30602,92656,49046,49046,0,1.0,0.0
30603,92657,9741,9741,0,1.0,0.0
30604,92660,34797,34797,0,1.0,0.0
30605,92661,3744,3744,0,1.0,0.0
30606,92662,2756,2756,0,1.0,0.0
30607,92663,21649,21649,0,1.0,0.0
30608,92672,34464,34464,0,1.0,0.0
30609,92673,29309,29309,0,1.0,0.0
30610,92675,34731,34683,48,0.999,0.001
30611,92676,1945,282,1663,0.145,0.855
30612,92677,63297,63297,0,1.0,0.0
30613,92678,494,363,131,0.735,0.265
30614,92679,32611,31743,868,0.973,0.027
30615,92683,89747,89747,0,1.0,0.0
30616,92688,43792,43792,0,1.0,0.0
30617,92691,47582,47582,0,1.0,0.0
30618,92692,47222,47222,0,1.0,0.0
30619,92694,21944,21684,260,0.988,0.012
30620,92701,53908,53908,0,1.0,0.0
30621,92703,65445,65445,0,1.0,0.0
30622,92704,88123,88123,0,1.0,0.0
30623,92705,44706,44706,0,1.0,0.0
30624,92706,36457,36457,0,1.0,0.0
30625,92707,59492,59492,0,1.0,0.0
30626,92708,56004,56004,0,1.0,0.0
30627,92780,57741,57741,0,1.0,0.0
30628,92782,23032,23032,0,1.0,0.0
30629,92801,62068,62068,0,1.0,0.0
30630,92802,42709,42709,0,1.0,0.0
30631,92804,85914,85914,0,1.0,0.0
30632,92805,70401,70401,0,1.0,0.0
30633,92806,37173,37173,0,1.0,0.0
30634,92807,36171,36162,9,1.0,0.0
30635,92808,20039,20039,0,1.0,0.0
30636,92821,35533,35294,239,0.993,0.007
30637,92823,3613,3460,153,0.958,0.042
30638,92831,34204,34204,0,1.0,0.0
30639,92832,24752,24752,0,1.0,0.0
30640,92833,51767,51767,0,1.0,0.0
30641,92835,24010,24010,0,1.0,0.0
30642,92840,54083,54083,0,1.0,0.0
30643,92841,32845,32845,0,1.0,0.0
30644,92843,45214,45214,0,1.0,0.0
30645,92844,24307,24307,0,1.0,0.0
30646,92845,16333,16333,0,1.0,0.0
30647,92860,27198,27198,0,1.0,0.0
30648,92861,5781,5781,0,1.0,0.0
30649,92865,19704,19704,0,1.0,0.0
30650,92866,14885,14885,0,1.0,0.0
30651,92867,44515,44508,7,1.0,0.0
30652,92868,25404,25404,0,1.0,0.0
30653,92869,37184,37181,3,1.0,0.0
30654,92870,52033,52033,0,1.0,0.0
30655,92879,46745,46704,41,0.999,0.001
30656,92880,58763,58668,95,0.998,0.002
30657,92881,30991,30659,332,0.989,0.011
30658,92882,67917,67874,43,0.999,0.001
30659,92883,29301,28586,715,0.976,0.024
30660,92886,46564,46553,11,1.0,0.0
30661,92887,20006,19758,248,0.988,0.012
30662,93001,32990,30127,2863,0.913,0.087
30663,93003,50474,50466,8,1.0,0.0
30664,93004,29149,29149,0,1.0,0.0
30665,93010,42901,42325,576,0.987,0.013
30666,93012,34617,33362,1255,0.964,0.036
30667,93013,16091,14735,1356,0.916,0.084
30668,93015,17334,15081,2253,0.87,0.13
30669,93021,36422,33936,2486,0.932,0.068
30670,93022,6106,5622,484,0.921,0.079
30671,93023,20589,16691,3898,0.811,0.189
30672,93030,59372,59362,10,1.0,0.0
30673,93033,82728,82435,293,0.996,0.004
30674,93035,27732,27732,0,1.0,0.0
30675,93036,41691,41621,70,0.998,0.002
30676,93040,2031,0,2031,0.0,1.0
30677,93041,23641,23634,7,1.0,0.0
30678,93042,56,0,56,0.0,1.0
30679,93043,333,333,0,1.0,0.0
30680,93060,32811,29877,2934,0.911,0.089
30681,93063,54366,53932,434,0.992,0.008
30682,93064,40,0,40,0.0,1.0
30683,93065,72508,71352,1156,0.984,0.016
30684,93066,3102,1266,1836,0.408,0.592
30685,93067,895,811,84,0.906,0.094
30686,93101,31683,31683,0,1.0,0.0
30687,93103,20249,20198,51,0.997,0.003
30688,93105,24815,23298,1517,0.939,0.061
30689,93108,11112,9806,1306,0.882,0.118
30690,93109,10858,10858,0,1.0,0.0
30691,93110,16829,16045,784,0.953,0.047
30692,93111,17370,16604,766,0.956,0.044
30693,93117,53217,51776,1441,0.973,0.027
30694,93201,1348,0,1348,0.0,1.0
30695,93202,4143,4143,0,1.0,0.0
30696,93203,20938,19568,1370,0.935,0.065
30697,93204,15529,15486,43,0.997,0.003
30698,93205,2113,395,1718,0.187,0.813
30699,93206,2300,0,2300,0.0,1.0
30700,93207,263,0,263,0.0,1.0
30701,93208,104,0,104,0.0,1.0
30702,93210,19504,12702,6802,0.651,0.349
30703,93212,26079,25516,563,0.978,0.022
30704,93215,55659,54372,1287,0.977,0.023
30705,93218,994,0,994,0.0,1.0
30706,93219,10194,8729,1465,0.856,0.144
30707,93220,211,150,61,0.711,0.289
30708,93221,14945,11145,3800,0.746,0.254
30709,93222,2099,0,2099,0.0,1.0
30710,93223,10604,10604,0,1.0,0.0
30711,93224,451,0,451,0.0,1.0
30712,93225,5077,3379,1698,0.666,0.334
30713,93226,282,0,282,0.0,1.0
30714,93230,65264,59035,6229,0.905,0.095
30715,93234,6987,6754,233,0.967,0.033
30716,93235,4559,4385,174,0.962,0.038
30717,93238,1490,0,1490,0.0,1.0
30718,93239,1688,0,1688,0.0,1.0
30719,93240,6056,2876,3180,0.475,0.525
30720,93241,17489,17470,19,0.999,0.001
30721,93242,3468,0,3468,0.0,1.0
30722,93243,1699,278,1421,0.164,0.836
30723,93244,534,0,534,0.0,1.0
30724,93245,37412,32201,5211,0.861,0.139
30725,93247,17423,14610,2813,0.839,0.161
30726,93249,2739,0,2739,0.0,1.0
30727,93250,13522,12826,696,0.949,0.051
30728,93251,270,0,270,0.0,1.0
30729,93252,4176,0,4176,0.0,1.0
30730,93254,811,0,811,0.0,1.0
30731,93255,614,0,614,0.0,1.0
30732,93256,5753,4391,1362,0.763,0.237
30733,93257,75004,68368,6636,0.912,0.088
30734,93258,2046,2046,0,1.0,0.0
30735,93260,200,0,200,0.0,1.0
30736,93261,3099,2867,232,0.925,0.075
30737,93262,63,0,63,0.0,1.0
30738,93263,19582,18098,1484,0.924,0.076
30739,93265,3699,0,3699,0.0,1.0
30740,93266,1587,0,1587,0.0,1.0
30741,93267,6237,3016,3221,0.484,0.516
30742,93268,16897,14985,1912,0.887,0.113
30743,93270,5837,3119,2718,0.534,0.466
30744,93271,2276,0,2276,0.0,1.0
30745,93272,3583,2543,1040,0.71,0.29
30746,93274,69721,61217,8504,0.878,0.122
30747,93276,161,0,161,0.0,1.0
30748,93277,50607,49533,1074,0.979,0.021
30749,93280,27152,25489,1663,0.939,0.061
30750,93283,2040,0,2040,0.0,1.0
30751,93285,2536,0,2536,0.0,1.0
30752,93286,9548,7465,2083,0.782,0.218
30753,93287,119,0,119,0.0,1.0
30754,93291,52849,49877,2972,0.944,0.056
30755,93292,39032,32693,6339,0.838,0.162
30756,93301,12248,12248,0,1.0,0.0
30757,93304,48731,48731,0,1.0,0.0
30758,93305,37601,37585,16,1.0,0.0
30759,93306,64587,63822,765,0.988,0.012
30760,93307,82658,79465,3193,0.961,0.039
30761,93308,52447,49480,2967,0.943,0.057
30762,93309,58409,58409,0,1.0,0.0
30763,93311,40829,39576,1253,0.969,0.031
30764,93312,56741,56726,15,1.0,0.0
30765,93313,43553,41380,2173,0.95,0.05
30766,93314,22393,18957,3436,0.847,0.153
30767,93401,28033,26160,1873,0.933,0.067
30768,93402,14318,13904,414,0.971,0.029
30769,93405,35440,33147,2293,0.935,0.065
30770,93410,0,0,0,,
30771,93420,28413,22533,5880,0.793,0.207
30772,93422,31375,27491,3884,0.876,0.124
30773,93424,1261,1009,252,0.8,0.2
30774,93426,1401,0,1401,0.0,1.0
30775,93427,5505,4837,668,0.879,0.121
30776,93428,6314,5865,449,0.929,0.071
30777,93429,154,0,154,0.0,1.0
30778,93430,2972,2541,431,0.855,0.145
30779,93432,1384,0,1384,0.0,1.0
30780,93433,13162,13162,0,1.0,0.0
30781,93434,7110,7080,30,0.996,0.004
30782,93436,54017,51509,2508,0.954,0.046
30783,93437,3338,3047,291,0.913,0.087
30784,93440,2058,0,2058,0.0,1.0
30785,93441,1530,984,546,0.643,0.357
30786,93442,10789,10327,462,0.957,0.043
30787,93444,19244,16373,2871,0.851,0.149
30788,93445,7173,7128,45,0.994,0.006
30789,93446,43714,30344,13370,0.694,0.306
30790,93449,7657,7589,68,0.991,0.009
30791,93450,740,0,740,0.0,1.0
30792,93451,3779,0,3779,0.0,1.0
30793,93452,524,0,524,0.0,1.0
30794,93453,2899,1254,1645,0.433,0.567
30795,93454,36448,34850,1598,0.956,0.044
30796,93455,41684,40327,1357,0.967,0.033
30797,93458,55431,55270,161,0.997,0.003
30798,93460,5255,3162,2093,0.602,0.398
30799,93461,1623,0,1623,0.0,1.0
30800,93463,7646,5879,1767,0.769,0.231
30801,93465,9153,5999,3154,0.655,0.345
30802,93501,5467,3236,2231,0.592,0.408
30803,93505,14038,10908,3130,0.777,0.223
30804,93510,7993,0,7993,0.0,1.0
30805,93512,277,0,277,0.0,1.0
30806,93513,1763,0,1763,0.0,1.0
30807,93514,13857,9935,3922,0.717,0.283
30808,93516,2299,0,2299,0.0,1.0
30809,93517,670,0,670,0.0,1.0
30810,93518,1146,0,1146,0.0,1.0
30811,93519,101,0,101,0.0,1.0
30812,93522,48,0,48,0.0,1.0
30813,93523,3074,0,3074,0.0,1.0
30814,93524,229,0,229,0.0,1.0
30815,93526,719,0,719,0.0,1.0
30816,93527,2387,0,2387,0.0,1.0
30817,93528,172,0,172,0.0,1.0
30818,93529,633,0,633,0.0,1.0
30819,93530,47,0,47,0.0,1.0
30820,93531,509,0,509,0.0,1.0
30821,93532,2932,0,2932,0.0,1.0
30822,93534,39341,38972,369,0.991,0.009
30823,93535,72046,68916,3130,0.957,0.043
30824,93536,70918,66673,4245,0.94,0.06
30825,93541,449,0,449,0.0,1.0
30826,93543,13033,11900,1133,0.913,0.087
30827,93544,1259,0,1259,0.0,1.0
30828,93545,2082,0,2082,0.0,1.0
30829,93546,9567,7693,1874,0.804,0.196
30830,93549,344,0,344,0.0,1.0
30831,93550,74929,73946,983,0.987,0.013
30832,93551,50798,48467,2331,0.954,0.046
30833,93552,38158,37879,279,0.993,0.007
30834,93553,2138,0,2138,0.0,1.0
30835,93554,72,0,72,0.0,1.0
30836,93555,32560,31155,1405,0.957,0.043
30837,93558,125,0,125,0.0,1.0
30838,93560,18910,16000,2910,0.846,0.154
30839,93561,34630,16540,18090,0.478,0.522
30840,93562,1818,0,1818,0.0,1.0
30841,93563,388,0,388,0.0,1.0
30842,93591,7285,6274,1011,0.861,0.139
30843,93592,64,0,64,0.0,1.0
30844,93601,1909,0,1909,0.0,1.0
30845,93602,3862,0,3862,0.0,1.0
30846,93603,222,0,222,0.0,1.0
30847,93604,674,0,674,0.0,1.0
30848,93605,175,0,175,0.0,1.0
30849,93606,1217,0,1217,0.0,1.0
30850,93608,1114,0,1114,0.0,1.0
30851,93609,5640,0,5640,0.0,1.0
30852,93610,23833,11843,11990,0.497,0.503
30853,93611,45614,45614,0,1.0,0.0
30854,93612,35351,35351,0,1.0,0.0
30855,93614,11661,0,11661,0.0,1.0
30856,93615,6042,4688,1354,0.776,0.224
30857,93616,2627,1617,1010,0.616,0.384
30858,93618,28262,21703,6559,0.768,0.232
30859,93619,28965,21703,7262,0.749,0.251
30860,93620,9591,6282,3309,0.655,0.345
30861,93621,464,0,464,0.0,1.0
30862,93622,9581,7281,2300,0.76,0.24
30863,93623,69,0,69,0.0,1.0
30864,93624,1134,0,1134,0.0,1.0
30865,93625,7313,5590,1723,0.764,0.236
30866,93626,1359,0,1359,0.0,1.0
30867,93627,123,0,123,0.0,1.0
30868,93628,327,0,327,0.0,1.0
30869,93630,19162,13487,5675,0.704,0.296
30870,93631,15941,11862,4079,0.744,0.256
30871,93633,25,0,25,0.0,1.0
30872,93634,33,0,33,0.0,1.0
30873,93635,38776,35917,2859,0.926,0.074
30874,93636,11908,8118,3790,0.682,0.318
30875,93637,37743,32605,5138,0.864,0.136
30876,93638,49068,45714,3354,0.932,0.068
30877,93640,11880,11211,669,0.944,0.056
30878,93641,595,0,595,0.0,1.0
30879,93643,3171,0,3171,0.0,1.0
30880,93644,8637,2913,5724,0.337,0.663
30881,93645,318,0,318,0.0,1.0
30882,93646,10557,9774,783,0.926,0.074
30883,93647,11874,9821,2053,0.827,0.173
30884,93648,15719,14490,1229,0.922,0.078
30885,93650,4055,4055,0,1.0,0.0
30886,93651,1674,0,1674,0.0,1.0
30887,93652,415,0,415,0.0,1.0
30888,93653,1229,0,1229,0.0,1.0
30889,93654,29776,24558,5218,0.825,0.175
30890,93656,6313,2823,3490,0.447,0.553
30891,93657,34999,25447,9552,0.727,0.273
30892,93660,4675,3983,692,0.852,0.148
30893,93662,30237,24358,5879,0.806,0.194
30894,93664,585,0,585,0.0,1.0
30895,93665,472,431,41,0.913,0.087
30896,93666,692,627,65,0.906,0.094
30897,93667,2604,0,2604,0.0,1.0
30898,93668,1118,0,1118,0.0,1.0
30899,93669,295,0,295,0.0,1.0
30900,93673,713,0,713,0.0,1.0
30901,93675,3721,0,3721,0.0,1.0
30902,93701,12529,12529,0,1.0,0.0
30903,93702,48607,48607,0,1.0,0.0
30904,93703,31868,31868,0,1.0,0.0
30905,93704,27156,27156,0,1.0,0.0
30906,93705,36703,36703,0,1.0,0.0
30907,93706,41087,32955,8132,0.802,0.198
30908,93710,30202,30202,0,1.0,0.0
30909,93711,36731,36731,0,1.0,0.0
30910,93720,45191,45191,0,1.0,0.0
30911,93721,6959,6959,0,1.0,0.0
30912,93722,76448,76266,182,0.998,0.002
30913,93723,9547,5997,3550,0.628,0.372
30914,93725,24979,19559,5420,0.783,0.217
30915,93726,40705,40705,0,1.0,0.0
30916,93727,71820,70545,1275,0.982,0.018
30917,93728,15743,15743,0,1.0,0.0
30918,93730,9941,9820,121,0.988,0.012
30919,93901,26863,26849,14,0.999,0.001
30920,93905,61087,61049,38,0.999,0.001
30921,93906,59461,59081,380,0.994,0.006
30922,93907,21726,17719,4007,0.816,0.184
30923,93908,13043,8267,4776,0.634,0.366
30924,93920,1369,0,1369,0.0,1.0
30925,93921,3281,3281,0,1.0,0.0
30926,93923,12073,7000,5073,0.58,0.42
30927,93924,6279,2370,3909,0.377,0.623
30928,93925,1671,0,1671,0.0,1.0
30929,93926,8726,8174,552,0.937,0.063
30930,93927,17547,16451,1096,0.938,0.062
30931,93928,506,0,506,0.0,1.0
30932,93930,15866,14529,1337,0.916,0.084
30933,93932,592,0,592,0.0,1.0
30934,93933,22406,22192,214,0.99,0.01
30935,93940,31615,30042,1573,0.95,0.05
30936,93943,6,6,0,1.0,0.0
30937,93950,15046,15046,0,1.0,0.0
30938,93953,4509,4067,442,0.902,0.098
30939,93954,302,0,302,0.0,1.0
30940,93955,33359,33355,4,1.0,0.0
30941,93960,27080,25943,1137,0.958,0.042
30942,93962,673,673,0,1.0,0.0
30943,94002,25992,25992,0,1.0,0.0
30944,94005,4282,4282,0,1.0,0.0
30945,94010,40737,40732,5,1.0,0.0
30946,94014,47014,47014,0,1.0,0.0
30947,94015,60927,60927,0,1.0,0.0
30948,94019,18424,15077,3347,0.818,0.182
30949,94020,1559,0,1559,0.0,1.0
30950,94021,192,0,192,0.0,1.0
30951,94022,18500,18248,252,0.986,0.014
30952,94024,22385,22352,33,0.999,0.001
30953,94025,40526,40526,0,1.0,0.0
30954,94027,7089,7045,44,0.994,0.006
30955,94028,6534,4439,2095,0.679,0.321
30956,94030,21536,21536,0,1.0,0.0
30957,94037,2913,2596,317,0.891,0.109
30958,94038,3040,3040,0,1.0,0.0
30959,94040,32996,32996,0,1.0,0.0
30960,94041,13292,13292,0,1.0,0.0
30961,94043,28358,28358,0,1.0,0.0
30962,94044,37296,37296,0,1.0,0.0
30963,94060,1554,0,1554,0.0,1.0
30964,94061,36245,36245,0,1.0,0.0
30965,94062,25876,22198,3678,0.858,0.142
30966,94063,30949,30305,644,0.979,0.021
30967,94065,11359,11359,0,1.0,0.0
30968,94066,41130,41109,21,0.999,0.001
30969,94070,29166,29166,0,1.0,0.0
30970,94074,214,0,214,0.0,1.0
30971,94080,63975,63975,0,1.0,0.0
30972,94085,21247,21247,0,1.0,0.0
30973,94086,45697,45697,0,1.0,0.0
30974,94087,54293,54293,0,1.0,0.0
30975,94089,19245,19245,0,1.0,0.0
30976,94102,31176,31176,0,1.0,0.0
30977,94103,27170,27170,0,1.0,0.0
30978,94104,406,406,0,1.0,0.0
30979,94105,5846,5846,0,1.0,0.0
30980,94107,26599,26599,0,1.0,0.0
30981,94108,13768,13768,0,1.0,0.0
30982,94109,55984,55984,0,1.0,0.0
30983,94110,69333,69333,0,1.0,0.0
30984,94111,3713,3713,0,1.0,0.0
30985,94112,79407,79407,0,1.0,0.0
30986,94114,31124,31124,0,1.0,0.0
30987,94115,33021,33021,0,1.0,0.0
30988,94116,43698,43698,0,1.0,0.0
30989,94117,39169,39169,0,1.0,0.0
30990,94118,38319,38319,0,1.0,0.0
30991,94121,41203,41203,0,1.0,0.0
30992,94122,56023,56023,0,1.0,0.0
30993,94123,23088,23088,0,1.0,0.0
30994,94124,33996,33996,0,1.0,0.0
30995,94127,19289,19289,0,1.0,0.0
30996,94128,69,69,0,1.0,0.0
30997,94129,3183,3183,0,1.0,0.0
30998,94130,2880,2880,0,1.0,0.0
30999,94131,26881,26881,0,1.0,0.0
31000,94132,28129,28129,0,1.0,0.0
31001,94133,26237,26237,0,1.0,0.0
31002,94134,40798,40798,0,1.0,0.0
31003,94158,4792,4792,0,1.0,0.0
31004,94301,16995,16995,0,1.0,0.0
31005,94303,45467,45467,0,1.0,0.0
31006,94304,3627,3355,272,0.925,0.075
31007,94305,13862,13848,14,0.999,0.001
31008,94306,26469,26469,0,1.0,0.0
31009,94401,34429,34429,0,1.0,0.0
31010,94402,23981,23981,0,1.0,0.0
31011,94403,39642,39642,0,1.0,0.0
31012,94404,33749,33749,0,1.0,0.0
31013,94501,60212,60212,0,1.0,0.0
31014,94502,13600,13600,0,1.0,0.0
31015,94503,19681,19469,212,0.989,0.011
31016,94505,13403,13246,157,0.988,0.012
31017,94506,22452,22415,37,0.998,0.002
31018,94507,14889,14765,124,0.992,0.008
31019,94508,3661,0,3661,0.0,1.0
31020,94509,62439,62256,183,0.997,0.003
31021,94510,27088,26993,95,0.996,0.004
31022,94511,2137,2137,0,1.0,0.0
31023,94512,108,0,108,0.0,1.0
31024,94513,54605,52271,2334,0.957,0.043
31025,94514,1360,781,579,0.574,0.426
31026,94515,7050,5155,1895,0.731,0.269
31027,94516,211,0,211,0.0,1.0
31028,94517,12385,10989,1396,0.887,0.113
31029,94518,26778,26778,0,1.0,0.0
31030,94519,18453,18453,0,1.0,0.0
31031,94520,37208,37206,2,1.0,0.0
31032,94521,41249,41216,33,0.999,0.001
31033,94523,33569,33569,0,1.0,0.0
31034,94525,3127,3127,0,1.0,0.0
31035,94526,31102,31099,3,1.0,0.0
31036,94528,964,964,0,1.0,0.0
31037,94530,23877,23872,5,1.0,0.0
31038,94531,40290,40250,40,0.999,0.001
31039,94533,69277,69249,28,1.0,0.0
31040,94534,36416,32720,3696,0.899,0.101
31041,94535,3793,3783,10,0.997,0.003
31042,94536,68790,68653,137,0.998,0.002
31043,94538,61148,61148,0,1.0,0.0
31044,94539,50031,48901,1130,0.977,0.023
31045,94541,61635,61635,0,1.0,0.0
31046,94542,12717,12714,3,1.0,0.0
31047,94544,73026,73021,5,1.0,0.0
31048,94545,29707,29707,0,1.0,0.0
31049,94546,42209,42209,0,1.0,0.0
31050,94547,24092,24092,0,1.0,0.0
31051,94548,412,123,289,0.299,0.701
31052,94549,26864,26615,249,0.991,0.009
31053,94550,46896,45549,1347,0.971,0.029
31054,94551,36867,36078,789,0.979,0.021
31055,94552,14454,13804,650,0.955,0.045
31056,94553,47065,46141,924,0.98,0.02
31057,94555,34143,34143,0,1.0,0.0
31058,94556,15229,15037,192,0.987,0.013
31059,94558,66830,57863,8967,0.866,0.134
31060,94559,27184,26047,1137,0.958,0.042
31061,94560,42573,42573,0,1.0,0.0
31062,94561,36515,36177,338,0.991,0.009
31063,94563,17672,17584,88,0.995,0.005
31064,94564,18287,18286,1,1.0,0.0
31065,94565,84641,84437,204,0.998,0.002
31066,94566,40884,40767,117,0.997,0.003
31067,94567,623,0,623,0.0,1.0
31068,94568,46016,45981,35,0.999,0.001
31069,94569,198,194,4,0.98,0.02
31070,94571,7911,7097,814,0.897,0.103
31071,94572,8684,8684,0,1.0,0.0
31072,94573,94,0,94,0.0,1.0
31073,94574,8742,6638,2104,0.759,0.241
31074,94575,974,974,0,1.0,0.0
31075,94576,164,89,75,0.543,0.457
31076,94577,45560,45560,0,1.0,0.0
31077,94578,38558,38558,0,1.0,0.0
31078,94579,20571,20571,0,1.0,0.0
31079,94580,27152,27152,0,1.0,0.0
31080,94582,38537,38534,3,1.0,0.0
31081,94583,34859,34533,326,0.991,0.009
31082,94585,28263,27931,332,0.988,0.012
31083,94586,925,0,925,0.0,1.0
31084,94587,69516,69512,4,1.0,0.0
31085,94588,30842,29810,1032,0.967,0.033
31086,94589,29876,29870,6,1.0,0.0
31087,94590,35420,35420,0,1.0,0.0
31088,94591,53042,52674,368,0.993,0.007
31089,94592,742,651,91,0.877,0.123
31090,94595,16425,16425,0,1.0,0.0
31091,94596,20037,20037,0,1.0,0.0
31092,94597,20277,20277,0,1.0,0.0
31093,94598,25818,25796,22,0.999,0.001
31094,94599,3021,2933,88,0.971,0.029
31095,94601,50294,50294,0,1.0,0.0
31096,94602,28329,28329,0,1.0,0.0
31097,94603,31403,31403,0,1.0,0.0
31098,94605,39016,39016,0,1.0,0.0
31099,94606,36672,36672,0,1.0,0.0
31100,94607,24978,24978,0,1.0,0.0
31101,94608,28019,28019,0,1.0,0.0
31102,94609,20596,20596,0,1.0,0.0
31103,94610,29287,29287,0,1.0,0.0
31104,94611,36565,36535,30,0.999,0.001
31105,94612,14389,14389,0,1.0,0.0
31106,94613,715,715,0,1.0,0.0
31107,94618,16046,16046,0,1.0,0.0
31108,94619,23299,23216,83,0.996,0.004
31109,94621,29870,29870,0,1.0,0.0
31110,94702,15979,15979,0,1.0,0.0
31111,94703,19846,19846,0,1.0,0.0
31112,94704,25592,25592,0,1.0,0.0
31113,94705,12762,12762,0,1.0,0.0
31114,94706,19615,19615,0,1.0,0.0
31115,94707,11710,11710,0,1.0,0.0
31116,94708,10985,10984,1,1.0,0.0
31117,94709,11806,11806,0,1.0,0.0
31118,94710,6948,6948,0,1.0,0.0
31119,94720,2964,2964,0,1.0,0.0
31120,94801,29395,29357,38,0.999,0.001
31121,94803,24904,24885,19,0.999,0.001
31122,94804,38559,38559,0,1.0,0.0
31123,94805,13648,13642,6,1.0,0.0
31124,94806,59861,59861,0,1.0,0.0
31125,94850,0,0,0,,
31126,94901,41157,41140,17,1.0,0.0
31127,94903,29040,28860,180,0.994,0.006
31128,94904,11995,11946,49,0.996,0.004
31129,94920,12474,12443,31,0.998,0.002
31130,94922,425,0,425,0.0,1.0
31131,94923,1411,0,1411,0.0,1.0
31132,94924,1638,0,1638,0.0,1.0
31133,94925,9253,9253,0,1.0,0.0
31134,94928,43170,43166,4,1.0,0.0
31135,94929,264,0,264,0.0,1.0
31136,94930,8500,8350,150,0.982,0.018
31137,94931,8470,7911,559,0.934,0.066
31138,94933,865,0,865,0.0,1.0
31139,94937,837,0,837,0.0,1.0
31140,94938,812,0,812,0.0,1.0
31141,94939,6859,6859,0,1.0,0.0
31142,94940,268,0,268,0.0,1.0
31143,94941,30496,30440,56,0.998,0.002
31144,94945,17167,15831,1336,0.922,0.078
31145,94946,699,0,699,0.0,1.0
31146,94947,24283,23130,1153,0.953,0.047
31147,94949,17202,14098,3104,0.82,0.18
31148,94950,89,0,89,0.0,1.0
31149,94951,4124,2705,1419,0.656,0.344
31150,94952,32858,26325,6533,0.801,0.199
31151,94954,37365,36049,1316,0.965,0.035
31152,94956,1756,0,1756,0.0,1.0
31153,94957,1332,1332,0,1.0,0.0
31154,94960,15740,15740,0,1.0,0.0
31155,94963,569,0,569,0.0,1.0
31156,94964,5094,5094,0,1.0,0.0
31157,94965,10847,10317,530,0.951,0.049
31158,94970,683,0,683,0.0,1.0
31159,94971,337,0,337,0.0,1.0
31160,94972,52,0,52,0.0,1.0
31161,94973,1429,1119,310,0.783,0.217
31162,95002,2077,2064,13,0.994,0.006
31163,95003,23974,21589,2385,0.901,0.099
31164,95004,3918,0,3918,0.0,1.0
31165,95005,6311,5534,777,0.877,0.123
31166,95006,8979,4210,4769,0.469,0.531
31167,95007,676,676,0,1.0,0.0
31168,95008,45260,45260,0,1.0,0.0
31169,95010,9137,9137,0,1.0,0.0
31170,95012,10320,9305,1015,0.902,0.098
31171,95013,80,39,41,0.488,0.512
31172,95014,60717,60279,438,0.993,0.007
31173,95017,834,0,834,0.0,1.0
31174,95018,7778,6703,1075,0.862,0.138
31175,95019,7727,7727,0,1.0,0.0
31176,95020,57349,51277,6072,0.894,0.106
31177,95023,48841,41783,7058,0.855,0.145
31178,95030,12791,12425,366,0.971,0.029
31179,95032,25089,24735,354,0.986,0.014
31180,95033,9372,2739,6633,0.292,0.708
31181,95035,66943,66483,460,0.993,0.007
31182,95037,45579,41654,3925,0.914,0.086
31183,95039,1377,0,1377,0.0,1.0
31184,95041,160,160,0,1.0,0.0
31185,95043,639,0,639,0.0,1.0
31186,95045,4046,5,4041,0.001,0.999
31187,95046,6417,5482,935,0.854,0.146
31188,95050,35923,35923,0,1.0,0.0
31189,95051,54327,54327,0,1.0,0.0
31190,95053,2206,2206,0,1.0,0.0
31191,95054,23364,23364,0,1.0,0.0
31192,95060,46377,42475,3902,0.916,0.084
31193,95062,36079,36079,0,1.0,0.0
31194,95064,7331,7331,0,1.0,0.0
31195,95065,8113,6381,1732,0.787,0.213
31196,95066,14749,12816,1933,0.869,0.131
31197,95070,30617,30019,598,0.98,0.02
31198,95073,10154,8481,1673,0.835,0.165
31199,95075,331,214,117,0.647,0.353
31200,95076,82474,69804,12670,0.846,0.154
31201,95110,18730,18730,0,1.0,0.0
31202,95111,58466,58466,0,1.0,0.0
31203,95112,55927,55927,0,1.0,0.0
31204,95113,893,893,0,1.0,0.0
31205,95116,51496,51496,0,1.0,0.0
31206,95117,30067,30067,0,1.0,0.0
31207,95118,31932,31932,0,1.0,0.0
31208,95119,9970,9936,34,0.997,0.003
31209,95120,37457,36392,1065,0.972,0.028
31210,95121,37469,37469,0,1.0,0.0
31211,95122,56545,56545,0,1.0,0.0
31212,95123,62228,62228,0,1.0,0.0
31213,95124,47082,47082,0,1.0,0.0
31214,95125,51939,51939,0,1.0,0.0
31215,95126,31049,31049,0,1.0,0.0
31216,95127,61325,60705,620,0.99,0.01
31217,95128,34836,34836,0,1.0,0.0
31218,95129,38720,38720,0,1.0,0.0
31219,95130,13911,13911,0,1.0,0.0
31220,95131,28565,28565,0,1.0,0.0
31221,95132,40299,39890,409,0.99,0.01
31222,95133,25401,25401,0,1.0,0.0
31223,95134,15268,15268,0,1.0,0.0
31224,95135,20120,19863,257,0.987,0.013
31225,95136,42989,42989,0,1.0,0.0
31226,95138,18889,18807,82,0.996,0.004
31227,95139,6748,6748,0,1.0,0.0
31228,95140,191,0,191,0.0,1.0
31229,95148,45528,45085,443,0.99,0.01
31230,95202,6521,6521,0,1.0,0.0
31231,95203,15696,15696,0,1.0,0.0
31232,95204,27786,27786,0,1.0,0.0
31233,95205,38069,38069,0,1.0,0.0
31234,95206,65004,63595,1409,0.978,0.022
31235,95207,47965,47965,0,1.0,0.0
31236,95209,39488,39418,70,0.998,0.002
31237,95210,39009,38979,30,0.999,0.001
31238,95211,1545,1545,0,1.0,0.0
31239,95212,25239,24259,980,0.961,0.039
31240,95215,23224,17270,5954,0.744,0.256
31241,95219,27884,27583,301,0.989,0.011
31242,95220,7273,2092,5181,0.288,0.712
31243,95222,5292,3751,1541,0.709,0.291
31244,95223,4612,0,4612,0.0,1.0
31245,95224,429,0,429,0.0,1.0
31246,95225,672,0,672,0.0,1.0
31247,95226,84,0,84,0.0,1.0
31248,95227,941,0,941,0.0,1.0
31249,95228,3976,0,3976,0.0,1.0
31250,95230,718,0,718,0.0,1.0
31251,95231,4374,3719,655,0.85,0.15
31252,95232,304,0,304,0.0,1.0
31253,95233,436,0,436,0.0,1.0
31254,95234,70,0,70,0.0,1.0
31255,95236,4223,0,4223,0.0,1.0
31256,95237,3167,0,3167,0.0,1.0
31257,95240,47172,41938,5234,0.889,0.111
31258,95242,25393,21917,3476,0.863,0.137
31259,95245,2277,0,2277,0.0,1.0
31260,95246,1615,0,1615,0.0,1.0
31261,95247,4368,0,4368,0.0,1.0
31262,95248,301,0,301,0.0,1.0
31263,95249,4042,0,4042,0.0,1.0
31264,95250,78,0,78,0.0,1.0
31265,95251,767,0,767,0.0,1.0
31266,95252,13460,7457,6003,0.554,0.446
31267,95254,480,0,480,0.0,1.0
31268,95255,2042,0,2042,0.0,1.0
31269,95257,413,0,413,0.0,1.0
31270,95258,4018,3487,531,0.868,0.132
31271,95301,37073,33767,3306,0.911,0.089
31272,95303,912,0,912,0.0,1.0
31273,95304,15706,7495,8211,0.477,0.523
31274,95305,245,0,245,0.0,1.0
31275,95306,970,0,970,0.0,1.0
31276,95307,42753,39486,3267,0.924,0.076
31277,95310,1882,272,1610,0.145,0.855
31278,95311,2197,0,2197,0.0,1.0
31279,95312,268,0,268,0.0,1.0
31280,95313,1386,0,1386,0.0,1.0
31281,95314,0,0,0,,
31282,95315,13018,11445,1573,0.879,0.121
31283,95316,6573,4363,2210,0.664,0.336
31284,95317,817,0,817,0.0,1.0
31285,95318,541,0,541,0.0,1.0
31286,95319,1749,1749,0,1.0,0.0
31287,95320,12819,7157,5662,0.558,0.442
31288,95321,3736,0,3736,0.0,1.0
31289,95322,8942,5521,3421,0.617,0.383
31290,95323,1260,588,672,0.467,0.533
31291,95324,7324,4852,2472,0.662,0.338
31292,95325,81,0,81,0.0,1.0
31293,95326,9581,6626,2955,0.692,0.308
31294,95327,9806,3926,5880,0.4,0.6
31295,95328,3993,3993,0,1.0,0.0
31296,95329,2460,0,2460,0.0,1.0
31297,95330,17853,17269,584,0.967,0.033
31298,95333,2942,14,2928,0.005,0.995
31299,95334,15457,13268,2189,0.858,0.142
31300,95335,541,0,541,0.0,1.0
31301,95336,42675,40160,2515,0.941,0.059
31302,95337,31557,29251,2306,0.927,0.073
31303,95338,11062,0,11062,0.0,1.0
31304,95340,33931,33015,916,0.973,0.027
31305,95341,32967,29321,3646,0.889,0.111
31306,95345,708,0,708,0.0,1.0
31307,95346,1272,700,572,0.55,0.45
31308,95348,30805,29450,1355,0.956,0.044
31309,95350,51046,51046,0,1.0,0.0
31310,95351,46458,46403,55,0.999,0.001
31311,95354,25394,25394,0,1.0,0.0
31312,95355,58311,58302,9,1.0,0.0
31313,95356,30918,30041,877,0.972,0.028
31314,95357,11559,9082,2477,0.786,0.214
31315,95358,31668,25366,6302,0.801,0.199
31316,95360,11712,10223,1489,0.873,0.127
31317,95361,31610,23747,7863,0.751,0.249
31318,95363,25237,20781,4456,0.823,0.177
31319,95364,53,0,53,0.0,1.0
31320,95365,4985,4509,476,0.905,0.095
31321,95366,16575,14288,2287,0.862,0.138
31322,95367,23173,23149,24,0.999,0.001
31323,95368,13614,13612,2,1.0,0.0
31324,95369,1099,0,1099,0.0,1.0
31325,95370,26803,18871,7932,0.704,0.296
31326,95372,1963,1766,197,0.9,0.1
31327,95374,2030,0,2030,0.0,1.0
31328,95375,106,0,106,0.0,1.0
31329,95376,49859,49859,0,1.0,0.0
31330,95377,30902,30215,687,0.978,0.022
31331,95379,3898,0,3898,0.0,1.0
31332,95380,41201,35215,5986,0.855,0.145
31333,95382,36176,35789,387,0.989,0.011
31334,95383,3937,2720,1217,0.691,0.309
31335,95385,429,0,429,0.0,1.0
31336,95386,9877,8516,1361,0.862,0.138
31337,95387,636,0,636,0.0,1.0
31338,95388,13074,11416,1658,0.873,0.127
31339,95389,1272,0,1272,0.0,1.0
31340,95391,9959,9616,343,0.966,0.034
31341,95401,36981,35195,1786,0.952,0.048
31342,95403,45164,44184,980,0.978,0.022
31343,95404,39761,34309,5452,0.863,0.137
31344,95405,21399,21397,2,1.0,0.0
31345,95407,39352,37441,1911,0.951,0.049
31346,95409,27187,26400,787,0.971,0.029
31347,95410,950,0,950,0.0,1.0
31348,95412,401,0,401,0.0,1.0
31349,95415,1592,0,1592,0.0,1.0
31350,95417,297,0,297,0.0,1.0
31351,95420,374,0,374,0.0,1.0
31352,95421,1592,0,1592,0.0,1.0
31353,95422,15585,14873,712,0.954,0.046
31354,95423,3747,2411,1336,0.643,0.357
31355,95425,10841,9166,1675,0.845,0.155
31356,95426,2147,0,2147,0.0,1.0
31357,95427,459,0,459,0.0,1.0
31358,95428,2516,0,2516,0.0,1.0
31359,95429,70,0,70,0.0,1.0
31360,95430,44,0,44,0.0,1.0
31361,95431,631,631,0,1.0,0.0
31362,95432,426,0,426,0.0,1.0
31363,95435,82,0,82,0.0,1.0
31364,95436,5418,3153,2265,0.582,0.418
31365,95437,14799,10348,4451,0.699,0.301
31366,95439,675,250,425,0.37,0.63
31367,95441,2014,699,1315,0.347,0.653
31368,95442,3178,1794,1384,0.565,0.435
31369,95443,233,189,44,0.811,0.189
31370,95444,748,710,38,0.949,0.051
31371,95445,2093,0,2093,0.0,1.0
31372,95446,4750,3389,1361,0.713,0.287
31373,95448,16852,11863,4989,0.704,0.296
31374,95449,1507,0,1507,0.0,1.0
31375,95450,387,0,387,0.0,1.0
31376,95451,11213,6083,5130,0.542,0.458
31377,95452,1393,779,614,0.559,0.441
31378,95453,11256,7728,3528,0.687,0.313
31379,95454,2556,0,2556,0.0,1.0
31380,95456,795,0,795,0.0,1.0
31381,95457,2893,1071,1822,0.37,0.63
31382,95458,3104,2620,484,0.844,0.156
31383,95459,504,0,504,0.0,1.0
31384,95460,2285,0,2285,0.0,1.0
31385,95461,3413,0,3413,0.0,1.0
31386,95462,1417,1013,404,0.715,0.285
31387,95463,169,0,169,0.0,1.0
31388,95464,2673,2627,46,0.983,0.017
31389,95465,2083,0,2083,0.0,1.0
31390,95466,946,0,946,0.0,1.0
31391,95467,5498,4647,851,0.845,0.155
31392,95468,1258,0,1258,0.0,1.0
31393,95469,1767,0,1767,0.0,1.0
31394,95470,6032,2827,3205,0.469,0.531
31395,95471,522,341,181,0.653,0.347
31396,95472,28255,17998,10257,0.637,0.363
31397,95476,35394,30253,5141,0.855,0.145
31398,95482,31808,26882,4926,0.845,0.155
31399,95485,2557,1008,1549,0.394,0.606
31400,95486,62,62,0,1.0,0.0
31401,95488,280,0,280,0.0,1.0
31402,95490,13264,8053,5211,0.607,0.393
31403,95492,28532,26919,1613,0.943,0.057
31404,95493,198,0,198,0.0,1.0
31405,95494,139,0,139,0.0,1.0
31406,95497,1305,0,1305,0.0,1.0
31407,95501,23976,23965,11,1.0,0.0
31408,95503,24152,19290,4862,0.799,0.201
31409,95511,360,0,360,0.0,1.0
31410,95514,254,0,254,0.0,1.0
31411,95519,17432,14386,3046,0.825,0.175
31412,95521,20199,18306,1893,0.906,0.094
31413,95524,1787,728,1059,0.407,0.593
31414,95525,1733,0,1733,0.0,1.0
31415,95526,378,0,378,0.0,1.0
31416,95527,627,0,627,0.0,1.0
31417,95528,1139,0,1139,0.0,1.0
31418,95531,24528,18976,5552,0.774,0.226
31419,95536,2849,0,2849,0.0,1.0
31420,95537,276,276,0,1.0,0.0
31421,95540,13657,12721,936,0.931,0.069
31422,95542,2533,0,2533,0.0,1.0
31423,95543,765,0,765,0.0,1.0
31424,95545,153,0,153,0.0,1.0
31425,95546,3494,0,3494,0.0,1.0
31426,95547,1222,363,859,0.297,0.703
31427,95548,1373,0,1373,0.0,1.0
31428,95549,805,0,805,0.0,1.0
31429,95550,128,0,128,0.0,1.0
31430,95551,1739,0,1739,0.0,1.0
31431,95552,697,0,697,0.0,1.0
31432,95553,1062,0,1062,0.0,1.0
31433,95554,533,0,533,0.0,1.0
31434,95555,410,0,410,0.0,1.0
31435,95556,605,0,605,0.0,1.0
31436,95558,425,0,425,0.0,1.0
31437,95559,182,0,182,0.0,1.0
31438,95560,1648,0,1648,0.0,1.0
31439,95562,3450,3229,221,0.936,0.064
31440,95563,652,0,652,0.0,1.0
31441,95564,462,447,15,0.968,0.032
31442,95565,1071,850,221,0.794,0.206
31443,95567,1930,0,1930,0.0,1.0
31444,95568,136,0,136,0.0,1.0
31445,95569,361,0,361,0.0,1.0
31446,95570,2579,0,2579,0.0,1.0
31447,95571,271,0,271,0.0,1.0
31448,95573,1744,0,1744,0.0,1.0
31449,95585,508,0,508,0.0,1.0
31450,95587,201,0,201,0.0,1.0
31451,95589,1612,0,1612,0.0,1.0
31452,95595,262,0,262,0.0,1.0
31453,95601,198,0,198,0.0,1.0
31454,95602,17509,12848,4661,0.734,0.266
31455,95603,27844,24964,2880,0.897,0.103
31456,95604,75,48,27,0.64,0.36
31457,95605,14179,14084,95,0.993,0.007
31458,95606,196,0,196,0.0,1.0
31459,95607,431,0,431,0.0,1.0
31460,95608,59418,59418,0,1.0,0.0
31461,95610,44147,44147,0,1.0,0.0
31462,95612,1239,0,1239,0.0,1.0
31463,95614,3833,0,3833,0.0,1.0
31464,95615,834,0,834,0.0,1.0
31465,95616,47032,46005,1027,0.978,0.022
31466,95618,27281,26789,492,0.982,0.018
31467,95619,4842,4564,278,0.943,0.057
31468,95620,20553,18445,2108,0.897,0.103
31469,95621,39819,39819,0,1.0,0.0
31470,95623,3806,1016,2790,0.267,0.733
31471,95624,61989,59621,2368,0.962,0.038
31472,95625,155,77,78,0.497,0.503
31473,95626,5975,4573,1402,0.765,0.235
31474,95627,3513,2789,724,0.794,0.206
31475,95628,40196,40196,0,1.0,0.0
31476,95629,832,0,832,0.0,1.0
31477,95630,72180,72180,0,1.0,0.0
31478,95631,6076,0,6076,0.0,1.0
31479,95632,29269,24895,4374,0.851,0.149
31480,95633,3349,0,3349,0.0,1.0
31481,95634,3232,0,3232,0.0,1.0
31482,95635,1262,0,1262,0.0,1.0
31483,95636,1101,0,1101,0.0,1.0
31484,95637,370,0,370,0.0,1.0
31485,95638,2255,109,2146,0.048,0.952
31486,95639,283,0,283,0.0,1.0
31487,95640,11353,7820,3533,0.689,0.311
31488,95641,1986,0,1986,0.0,1.0
31489,95642,7164,4732,2432,0.661,0.339
31490,95645,2037,0,2037,0.0,1.0
31491,95646,158,0,158,0.0,1.0
31492,95648,47354,42964,4390,0.907,0.093
31493,95650,12447,9453,2994,0.759,0.241
31494,95651,637,0,637,0.0,1.0
31495,95652,739,739,0,1.0,0.0
31496,95653,527,488,39,0.926,0.074
31497,95655,4314,3831,483,0.888,0.112
31498,95658,6285,1734,4551,0.276,0.724
31499,95659,702,0,702,0.0,1.0
31500,95660,30714,30714,0,1.0,0.0
31501,95661,29791,29791,0,1.0,0.0
31502,95662,31558,31558,0,1.0,0.0
31503,95663,2377,1054,1323,0.443,0.557
31504,95664,1380,0,1380,0.0,1.0
31505,95665,4426,0,4426,0.0,1.0
31506,95666,5336,0,5336,0.0,1.0
31507,95667,36726,17481,19245,0.476,0.524
31508,95668,815,0,815,0.0,1.0
31509,95669,2443,0,2443,0.0,1.0
31510,95670,52973,52973,0,1.0,0.0
31511,95672,4773,2391,2382,0.501,0.499
31512,95673,15455,15343,112,0.993,0.007
31513,95674,935,0,935,0.0,1.0
31514,95675,381,0,381,0.0,1.0
31515,95677,23333,23333,0,1.0,0.0
31516,95678,41192,41192,0,1.0,0.0
31517,95679,55,0,55,0.0,1.0
31518,95680,146,0,146,0.0,1.0
31519,95681,1226,0,1226,0.0,1.0
31520,95682,29114,22045,7069,0.757,0.243
31521,95683,6180,5376,804,0.87,0.13
31522,95684,3422,0,3422,0.0,1.0
31523,95685,4680,2523,2157,0.539,0.461
31524,95686,1405,0,1405,0.0,1.0
31525,95687,65096,64144,952,0.985,0.015
31526,95688,34379,28920,5459,0.841,0.159
31527,95689,1244,0,1244,0.0,1.0
31528,95690,2533,0,2533,0.0,1.0
31529,95691,34737,34181,556,0.984,0.016
31530,95692,4769,3434,1335,0.72,0.28
31531,95693,6758,0,6758,0.0,1.0
31532,95694,9156,7082,2074,0.773,0.227
31533,95695,37946,34047,3899,0.897,0.103
31534,95697,425,0,425,0.0,1.0
31535,95698,236,0,236,0.0,1.0
31536,95699,154,0,154,0.0,1.0
31537,95701,983,0,983,0.0,1.0
31538,95703,897,676,221,0.754,0.246
31539,95709,4772,2399,2373,0.503,0.497
31540,95713,9495,3010,6485,0.317,0.683
31541,95714,382,0,382,0.0,1.0
31542,95715,115,0,115,0.0,1.0
31543,95717,231,0,231,0.0,1.0
31544,95720,157,0,157,0.0,1.0
31545,95721,37,0,37,0.0,1.0
31546,95722,4585,2314,2271,0.505,0.495
31547,95724,27,0,27,0.0,1.0
31548,95726,8842,4550,4292,0.515,0.485
31549,95728,386,0,386,0.0,1.0
31550,95735,68,0,68,0.0,1.0
31551,95736,240,240,0,1.0,0.0
31552,95742,7749,6533,1216,0.843,0.157
31553,95746,21460,20670,790,0.963,0.037
31554,95747,51870,50869,1001,0.981,0.019
31555,95757,40222,36875,3347,0.917,0.083
31556,95758,60435,60435,0,1.0,0.0
31557,95762,38797,36676,2121,0.945,0.055
31558,95765,33974,33819,155,0.995,0.005
31559,95776,21902,21466,436,0.98,0.02
31560,95811,7595,7595,0,1.0,0.0
31561,95814,9922,9922,0,1.0,0.0
31562,95815,24680,24680,0,1.0,0.0
31563,95816,15579,15579,0,1.0,0.0
31564,95817,13534,13534,0,1.0,0.0
31565,95818,19811,19811,0,1.0,0.0
31566,95819,17141,17141,0,1.0,0.0
31567,95820,34480,34480,0,1.0,0.0
31568,95821,33550,33550,0,1.0,0.0
31569,95822,42347,42347,0,1.0,0.0
31570,95823,73985,73983,2,1.0,0.0
31571,95824,30221,30221,0,1.0,0.0
31572,95825,31084,31084,0,1.0,0.0
31573,95826,36628,36493,135,0.996,0.004
31574,95827,20269,20248,21,0.999,0.001
31575,95828,57862,57844,18,1.0,0.0
31576,95829,24755,23790,965,0.961,0.039
31577,95830,934,245,689,0.262,0.738
31578,95831,41321,41321,0,1.0,0.0
31579,95832,11924,11784,140,0.988,0.012
31580,95833,37293,37293,0,1.0,0.0
31581,95834,25899,25899,0,1.0,0.0
31582,95835,35936,35931,5,1.0,0.0
31583,95837,315,0,315,0.0,1.0
31584,95838,36764,36764,0,1.0,0.0
31585,95841,19448,19448,0,1.0,0.0
31586,95842,31806,31806,0,1.0,0.0
31587,95843,45048,45048,0,1.0,0.0
31588,95864,22447,22447,0,1.0,0.0
31589,95901,31314,25141,6173,0.803,0.197
31590,95903,1732,0,1732,0.0,1.0
31591,95910,86,0,86,0.0,1.0
31592,95912,4685,2652,2033,0.566,0.434
31593,95914,578,0,578,0.0,1.0
31594,95915,44,0,44,0.0,1.0
31595,95916,1441,0,1441,0.0,1.0
31596,95917,3155,136,3019,0.043,0.957
31597,95918,2339,0,2339,0.0,1.0
31598,95919,1378,0,1378,0.0,1.0
31599,95920,274,0,274,0.0,1.0
31600,95922,687,0,687,0.0,1.0
31601,95923,58,0,58,0.0,1.0
31602,95925,295,0,295,0.0,1.0
31603,95926,37725,37725,0,1.0,0.0
31604,95928,36511,32687,3824,0.895,0.105
31605,95930,69,0,69,0.0,1.0
31606,95932,7718,6791,927,0.88,0.12
31607,95934,274,0,274,0.0,1.0
31608,95935,631,0,631,0.0,1.0
31609,95936,352,0,352,0.0,1.0
31610,95937,1491,0,1491,0.0,1.0
31611,95938,3787,0,3787,0.0,1.0
31612,95939,604,0,604,0.0,1.0
31613,95941,563,0,563,0.0,1.0
31614,95942,1301,0,1301,0.0,1.0
31615,95943,879,0,879,0.0,1.0
31616,95944,46,0,46,0.0,1.0
31617,95945,25199,18568,6631,0.737,0.263
31618,95946,9790,6982,2808,0.713,0.287
31619,95947,1899,0,1899,0.0,1.0
31620,95948,10810,8257,2553,0.764,0.236
31621,95949,19741,9105,10636,0.461,0.539
31622,95950,569,0,569,0.0,1.0
31623,95951,2601,0,2601,0.0,1.0
31624,95953,10718,8547,2171,0.797,0.203
31625,95954,12251,9399,2852,0.767,0.233
31626,95955,1517,0,1517,0.0,1.0
31627,95956,401,0,401,0.0,1.0
31628,95957,761,0,761,0.0,1.0
31629,95959,17838,6635,11203,0.372,0.628
31630,95960,796,0,796,0.0,1.0
31631,95961,26510,24659,1851,0.93,0.07
31632,95962,1567,0,1567,0.0,1.0
31633,95963,15493,9282,6211,0.599,0.401
31634,95965,20384,14401,5983,0.706,0.294
31635,95966,30643,21424,9219,0.699,0.301
31636,95968,1412,1297,115,0.919,0.081
31637,95969,27549,25326,2223,0.919,0.081
31638,95970,530,0,530,0.0,1.0
31639,95971,5970,2674,3296,0.448,0.552
31640,95973,31957,27764,4193,0.869,0.131
31641,95974,8,0,8,0.0,1.0
31642,95975,1769,114,1655,0.064,0.936
31643,95977,1678,0,1678,0.0,1.0
31644,95978,143,0,143,0.0,1.0
31645,95979,597,0,597,0.0,1.0
31646,95981,97,0,97,0.0,1.0
31647,95982,3221,0,3221,0.0,1.0
31648,95983,428,0,428,0.0,1.0
31649,95984,120,0,120,0.0,1.0
31650,95986,162,0,162,0.0,1.0
31651,95987,5992,5181,811,0.865,0.135
31652,95988,8857,7346,1511,0.829,0.171
31653,95991,40593,39295,1298,0.968,0.032
31654,95993,36067,32876,3191,0.912,0.088
31655,96001,33865,29134,4731,0.86,0.14
31656,96002,33298,31227,2071,0.938,0.062
31657,96003,44461,35450,9011,0.797,0.203
31658,96006,557,0,557,0.0,1.0
31659,96007,22841,12335,10506,0.54,0.46
31660,96008,1231,0,1231,0.0,1.0
31661,96009,569,0,569,0.0,1.0
31662,96010,239,0,239,0.0,1.0
31663,96011,218,0,218,0.0,1.0
31664,96013,4212,3171,1041,0.753,0.247
31665,96014,211,0,211,0.0,1.0
31666,96015,465,0,465,0.0,1.0
31667,96016,366,0,366,0.0,1.0
31668,96017,171,0,171,0.0,1.0
31669,96019,10082,9585,497,0.951,0.049
31670,96020,2416,0,2416,0.0,1.0
31671,96021,16097,8553,7544,0.531,0.469
31672,96022,15768,4419,11349,0.28,0.72
31673,96023,1240,0,1240,0.0,1.0
31674,96024,1145,0,1145,0.0,1.0
31675,96025,2310,0,2310,0.0,1.0
31676,96027,2227,0,2227,0.0,1.0
31677,96028,1464,0,1464,0.0,1.0
31678,96029,124,0,124,0.0,1.0
31679,96031,158,0,158,0.0,1.0
31680,96032,2407,0,2407,0.0,1.0
31681,96033,432,0,432,0.0,1.0
31682,96034,294,0,294,0.0,1.0
31683,96035,3324,1174,2150,0.353,0.647
31684,96037,308,0,308,0.0,1.0
31685,96038,589,0,589,0.0,1.0
31686,96039,1251,0,1251,0.0,1.0
31687,96040,341,0,341,0.0,1.0
31688,96041,2747,0,2747,0.0,1.0
31689,96044,1022,0,1022,0.0,1.0
31690,96046,304,0,304,0.0,1.0
31691,96047,1004,0,1004,0.0,1.0
31692,96048,736,0,736,0.0,1.0
31693,96049,95,0,95,0.0,1.0
31694,96050,414,0,414,0.0,1.0
31695,96051,1139,0,1139,0.0,1.0
31696,96052,1460,0,1460,0.0,1.0
31697,96054,366,0,366,0.0,1.0
31698,96055,3935,2239,1696,0.569,0.431
31699,96056,1642,0,1642,0.0,1.0
31700,96057,1355,0,1355,0.0,1.0
31701,96058,798,0,798,0.0,1.0
31702,96059,688,0,688,0.0,1.0
31703,96061,36,0,36,0.0,1.0
31704,96062,1105,0,1105,0.0,1.0
31705,96063,125,0,125,0.0,1.0
31706,96064,4574,0,4574,0.0,1.0
31707,96065,357,0,357,0.0,1.0
31708,96067,7165,4940,2225,0.689,0.311
31709,96068,183,0,183,0.0,1.0
31710,96069,982,0,982,0.0,1.0
31711,96071,125,0,125,0.0,1.0
31712,96073,4082,0,4082,0.0,1.0
31713,96074,260,0,260,0.0,1.0
31714,96075,369,0,369,0.0,1.0
31715,96076,166,0,166,0.0,1.0
31716,96080,28764,18434,10330,0.641,0.359
31717,96084,625,0,625,0.0,1.0
31718,96085,85,0,85,0.0,1.0
31719,96086,338,0,338,0.0,1.0
31720,96087,600,0,600,0.0,1.0
31721,96088,4506,0,4506,0.0,1.0
31722,96090,421,387,34,0.919,0.081
31723,96091,699,0,699,0.0,1.0
31724,96092,496,0,496,0.0,1.0
31725,96093,4133,0,4133,0.0,1.0
31726,96094,6630,2806,3824,0.423,0.577
31727,96096,695,0,695,0.0,1.0
31728,96097,10031,7598,2433,0.757,0.243
31729,96101,5490,2910,2580,0.53,0.47
31730,96103,1725,0,1725,0.0,1.0
31731,96104,748,0,748,0.0,1.0
31732,96105,527,0,527,0.0,1.0
31733,96106,479,0,479,0.0,1.0
31734,96107,1269,0,1269,0.0,1.0
31735,96108,122,0,122,0.0,1.0
31736,96109,2197,0,2197,0.0,1.0
31737,96110,166,0,166,0.0,1.0
31738,96111,160,9,151,0.056,0.944
31739,96112,214,0,214,0.0,1.0
31740,96113,1000,0,1000,0.0,1.0
31741,96114,3220,0,3220,0.0,1.0
31742,96115,145,0,145,0.0,1.0
31743,96116,233,0,233,0.0,1.0
31744,96117,405,0,405,0.0,1.0
31745,96118,1627,0,1627,0.0,1.0
31746,96119,90,0,90,0.0,1.0
31747,96120,957,0,957,0.0,1.0
31748,96121,368,0,368,0.0,1.0
31749,96122,3883,2523,1360,0.65,0.35
31750,96123,48,0,48,0.0,1.0
31751,96124,326,0,326,0.0,1.0
31752,96125,258,0,258,0.0,1.0
31753,96126,215,0,215,0.0,1.0
31754,96128,752,0,752,0.0,1.0
31755,96129,261,0,261,0.0,1.0
31756,96130,23150,10285,12865,0.444,0.556
31757,96132,119,0,119,0.0,1.0
31758,96133,110,0,110,0.0,1.0
31759,96134,2512,0,2512,0.0,1.0
31760,96135,128,0,128,0.0,1.0
31761,96136,104,0,104,0.0,1.0
31762,96137,3297,0,3297,0.0,1.0
31763,96140,1170,443,727,0.379,0.621
31764,96141,744,0,744,0.0,1.0
31765,96142,1037,0,1037,0.0,1.0
31766,96143,4414,4262,152,0.966,0.034
31767,96145,3161,0,3161,0.0,1.0
31768,96146,1366,0,1366,0.0,1.0
31769,96148,788,316,472,0.401,0.599
31770,96150,29792,27109,2683,0.91,0.09
31771,96155,8,0,8,0.0,1.0
31772,96161,18451,12139,6312,0.658,0.342
31773,96701,40281,40270,11,1.0,0.0
31774,96703,2368,2034,334,0.859,0.141
31775,96704,6505,2844,3661,0.437,0.563
31776,96705,2319,2295,24,0.99,0.01
31777,96706,62730,62730,0,1.0,0.0
31778,96707,38817,38685,132,0.997,0.003
31779,96708,10220,6753,3467,0.661,0.339
31780,96710,613,0,613,0.0,1.0
31781,96712,7352,6309,1043,0.858,0.142
31782,96713,1990,0,1990,0.0,1.0
31783,96714,1390,446,944,0.321,0.679
31784,96716,2823,2727,96,0.966,0.034
31785,96717,5555,4976,579,0.896,0.104
31786,96719,1692,1262,430,0.746,0.254
31787,96720,46165,40549,5616,0.878,0.122
31788,96722,2484,2207,277,0.888,0.112
31789,96725,3592,1365,2227,0.38,0.62
31790,96726,661,78,583,0.118,0.882
31791,96727,4878,2667,2211,0.547,0.453
31792,96728,610,0,610,0.0,1.0
31793,96729,1303,0,1303,0.0,1.0
31794,96730,1541,1208,333,0.784,0.216
31795,96731,3292,2505,787,0.761,0.239
31796,96732,24816,24807,9,1.0,0.0
31797,96734,50746,50732,14,1.0,0.0
31798,96737,4552,0,4552,0.0,1.0
31799,96738,6609,4089,2520,0.619,0.381
31800,96740,33321,27139,6182,0.814,0.186
31801,96741,5929,5192,737,0.876,0.124
31802,96742,90,0,90,0.0,1.0
31803,96743,12160,6960,5200,0.572,0.428
31804,96744,54247,53237,1010,0.981,0.019
31805,96746,18319,16565,1754,0.904,0.096
31806,96747,749,0,749,0.0,1.0
31807,96748,4503,0,4503,0.0,1.0
31808,96749,17047,13706,3341,0.804,0.196
31809,96750,3793,1599,2194,0.422,0.578
31810,96751,175,175,0,1.0,0.0
31811,96752,3680,3518,162,0.956,0.044
31812,96753,26892,25819,1073,0.96,0.04
31813,96754,4084,2611,1473,0.639,0.361
31814,96755,3575,2335,1240,0.653,0.347
31815,96756,5190,4137,1053,0.797,0.203
31816,96757,758,0,758,0.0,1.0
31817,96759,457,0,457,0.0,1.0
31818,96760,3001,193,2808,0.064,0.936
31819,96761,22156,21331,825,0.963,0.037
31820,96762,6419,6382,37,0.994,0.006
31821,96763,3135,3066,69,0.978,0.022
31822,96764,799,0,799,0.0,1.0
31823,96765,553,489,64,0.884,0.116
31824,96766,14683,14272,411,0.972,0.028
31825,96768,17668,15604,2064,0.883,0.117
31826,96769,464,0,464,0.0,1.0
31827,96770,691,0,691,0.0,1.0
31828,96771,8339,0,8339,0.0,1.0
31829,96772,2304,0,2304,0.0,1.0
31830,96773,210,0,210,0.0,1.0
31831,96774,342,0,342,0.0,1.0
31832,96776,1490,0,1490,0.0,1.0
31833,96777,1479,0,1479,0.0,1.0
31834,96778,14409,8808,5601,0.611,0.389
31835,96779,3088,3081,7,0.998,0.002
31836,96780,557,0,557,0.0,1.0
31837,96781,1670,1172,498,0.702,0.298
31838,96782,40496,40496,0,1.0,0.0
31839,96783,2060,0,2060,0.0,1.0
31840,96785,2646,0,2646,0.0,1.0
31841,96786,40859,40822,37,0.999,0.001
31842,96789,54129,54103,26,1.0,0.0
31843,96790,8065,3771,4294,0.468,0.532
31844,96791,8014,7461,553,0.931,0.069
31845,96792,48519,47731,788,0.984,0.016
31846,96793,29549,28046,1503,0.949,0.051
31847,96795,10034,9661,373,0.963,0.037
31848,96796,1881,1795,86,0.954,0.046
31849,96797,72289,71696,593,0.992,0.008
31850,96813,22881,22881,0,1.0,0.0
31851,96814,18721,18721,0,1.0,0.0
31852,96815,31470,31470,0,1.0,0.0
31853,96816,49368,48709,659,0.987,0.013
31854,96817,54628,54628,0,1.0,0.0
31855,96818,50586,50586,0,1.0,0.0
31856,96819,49492,48704,788,0.984,0.016
31857,96821,19856,19856,0,1.0,0.0
31858,96822,45007,45007,0,1.0,0.0
31859,96825,30263,30258,5,1.0,0.0
31860,96826,30842,30842,0,1.0,0.0
31861,96850,0,0,0,,
31862,96853,462,462,0,1.0,0.0
31863,96857,2522,2522,0,1.0,0.0
31864,96859,156,156,0,1.0,0.0
31865,96860,1124,1124,0,1.0,0.0
31866,96863,52,52,0,1.0,0.0
31867,97001,229,0,229,0.0,1.0
31868,97002,5623,1779,3844,0.316,0.684
31869,97004,4388,472,3916,0.108,0.892
31870,97005,24906,24906,0,1.0,0.0
31871,97006,63036,63036,0,1.0,0.0
31872,97007,66954,65544,1410,0.979,0.021
31873,97008,28969,28969,0,1.0,0.0
31874,97009,7762,2252,5510,0.29,0.71
31875,97011,582,340,242,0.584,0.416
31876,97013,22688,17105,5583,0.754,0.246
31877,97014,1288,0,1288,0.0,1.0
31878,97015,19521,19521,0,1.0,0.0
31879,97016,6083,0,6083,0.0,1.0
31880,97017,2922,0,2922,0.0,1.0
31881,97018,1952,1950,2,0.999,0.001
31882,97019,3161,226,2935,0.071,0.929
31883,97020,791,0,791,0.0,1.0
31884,97021,1089,0,1089,0.0,1.0
31885,97022,3722,400,3322,0.107,0.893
31886,97023,9832,3438,6394,0.35,0.65
31887,97024,10242,10232,10,0.999,0.001
31888,97026,3815,2634,1181,0.69,0.31
31889,97027,12131,12131,0,1.0,0.0
31890,97028,217,0,217,0.0,1.0
31891,97029,285,0,285,0.0,1.0
31892,97030,36693,36693,0,1.0,0.0
31893,97031,18375,10687,7688,0.582,0.418
31894,97032,5043,3482,1561,0.69,0.31
31895,97033,60,0,60,0.0,1.0
31896,97034,18905,18905,0,1.0,0.0
31897,97035,23912,23912,0,1.0,0.0
31898,97037,849,0,849,0.0,1.0
31899,97038,15113,8752,6361,0.579,0.421
31900,97039,472,0,472,0.0,1.0
31901,97040,1244,0,1244,0.0,1.0
31902,97041,2817,0,2817,0.0,1.0
31903,97042,2923,0,2923,0.0,1.0
31904,97045,51359,39793,11566,0.775,0.225
31905,97048,6691,2354,4337,0.352,0.648
31906,97049,1899,1028,871,0.541,0.459
31907,97050,272,0,272,0.0,1.0
31908,97051,15957,14336,1621,0.898,0.102
31909,97053,3247,1299,1948,0.4,0.6
31910,97054,1579,249,1330,0.158,0.842
31911,97055,17350,10631,6719,0.613,0.387
31912,97056,11497,7691,3806,0.669,0.331
31913,97057,36,0,36,0.0,1.0
31914,97058,19838,16876,2962,0.851,0.149
31915,97060,21226,20286,940,0.956,0.044
31916,97062,27434,26430,1004,0.963,0.037
31917,97063,1074,0,1074,0.0,1.0
31918,97064,3464,0,3464,0.0,1.0
31919,97065,676,0,676,0.0,1.0
31920,97067,2138,1593,545,0.745,0.255
31921,97068,28305,26378,1927,0.932,0.068
31922,97070,20957,19658,1299,0.938,0.062
31923,97071,28803,25600,3203,0.889,0.111
31924,97080,40888,39640,1248,0.969,0.031
31925,97086,26010,25996,14,0.999,0.001
31926,97089,11986,9402,2584,0.784,0.216
31927,97101,3794,0,3794,0.0,1.0
31928,97102,205,0,205,0.0,1.0
31929,97103,16859,9914,6945,0.588,0.412
31930,97106,4550,0,4550,0.0,1.0
31931,97107,1530,1183,347,0.773,0.227
31932,97108,490,0,490,0.0,1.0
31933,97109,577,0,577,0.0,1.0
31934,97110,1284,0,1284,0.0,1.0
31935,97111,3156,2033,1123,0.644,0.356
31936,97112,1901,0,1901,0.0,1.0
31937,97113,14155,11861,2294,0.838,0.162
31938,97114,4762,2750,2012,0.577,0.423
31939,97115,4139,3460,679,0.836,0.164
31940,97116,24104,21629,2475,0.897,0.103
31941,97117,679,0,679,0.0,1.0
31942,97118,775,0,775,0.0,1.0
31943,97119,4420,111,4309,0.025,0.975
31944,97121,1383,1045,338,0.756,0.244
31945,97122,460,0,460,0.0,1.0
31946,97123,44537,40258,4279,0.904,0.096
31947,97124,48349,46202,2147,0.956,0.044
31948,97125,157,0,157,0.0,1.0
31949,97127,3740,3740,0,1.0,0.0
31950,97128,36141,32480,3661,0.899,0.101
31951,97130,710,0,710,0.0,1.0
31952,97131,2498,0,2498,0.0,1.0
31953,97132,28278,23541,4737,0.832,0.168
31954,97133,4000,0,4000,0.0,1.0
31955,97134,175,0,175,0.0,1.0
31956,97135,861,0,861,0.0,1.0
31957,97136,1761,0,1761,0.0,1.0
31958,97137,1307,0,1307,0.0,1.0
31959,97138,10021,8093,1928,0.808,0.192
31960,97140,23474,18785,4689,0.8,0.2
31961,97141,13140,6492,6648,0.494,0.506
31962,97144,195,0,195,0.0,1.0
31963,97145,441,0,441,0.0,1.0
31964,97146,5905,3552,2353,0.602,0.398
31965,97147,408,0,408,0.0,1.0
31966,97148,3406,1145,2261,0.336,0.664
31967,97149,574,0,574,0.0,1.0
31968,97201,15484,15484,0,1.0,0.0
31969,97202,38762,38762,0,1.0,0.0
31970,97203,31042,31041,1,1.0,0.0
31971,97204,1036,1036,0,1.0,0.0
31972,97205,7688,7688,0,1.0,0.0
31973,97206,47596,47596,0,1.0,0.0
31974,97208,0,0,0,,
31975,97209,14950,14950,0,1.0,0.0
31976,97210,10887,10587,300,0.972,0.028
31977,97211,31254,31254,0,1.0,0.0
31978,97212,24126,24126,0,1.0,0.0
31979,97213,29219,29219,0,1.0,0.0
31980,97214,23813,23813,0,1.0,0.0
31981,97215,16375,16375,0,1.0,0.0
31982,97216,15594,15594,0,1.0,0.0
31983,97217,31438,31438,0,1.0,0.0
31984,97218,14561,14561,0,1.0,0.0
31985,97219,38709,38709,0,1.0,0.0
31986,97220,28495,28495,0,1.0,0.0
31987,97221,11630,11630,0,1.0,0.0
31988,97222,34979,34979,0,1.0,0.0
31989,97223,46699,46699,0,1.0,0.0
31990,97224,31122,31122,0,1.0,0.0
31991,97225,24176,24176,0,1.0,0.0
31992,97227,3847,3847,0,1.0,0.0
31993,97229,58217,57111,1106,0.981,0.019
31994,97230,39752,39752,0,1.0,0.0
31995,97231,4280,671,3609,0.157,0.843
31996,97232,11472,11472,0,1.0,0.0
31997,97233,39367,39367,0,1.0,0.0
31998,97236,36852,36852,0,1.0,0.0
31999,97239,14150,14150,0,1.0,0.0
32000,97266,33300,33300,0,1.0,0.0
32001,97267,30839,30839,0,1.0,0.0
32002,97301,53518,53518,0,1.0,0.0
32003,97302,37131,36170,961,0.974,0.026
32004,97303,38663,37987,676,0.983,0.017
32005,97304,28454,26026,2428,0.915,0.085
32006,97305,40176,37158,3018,0.925,0.075
32007,97306,27360,24439,2921,0.893,0.107
32008,97317,24355,19576,4779,0.804,0.196
32009,97321,24928,21371,3557,0.857,0.143
32010,97322,34039,31231,2808,0.918,0.082
32011,97324,1126,0,1126,0.0,1.0
32012,97325,6614,3682,2932,0.557,0.443
32013,97326,961,0,961,0.0,1.0
32014,97327,2871,0,2871,0.0,1.0
32015,97329,90,0,90,0.0,1.0
32016,97330,41472,36616,4856,0.883,0.117
32017,97331,2408,2408,0,1.0,0.0
32018,97333,21377,18337,3040,0.858,0.142
32019,97338,20045,15340,4705,0.765,0.235
32020,97341,2325,804,1521,0.346,0.654
32021,97342,267,0,267,0.0,1.0
32022,97343,434,0,434,0.0,1.0
32023,97344,1076,0,1076,0.0,1.0
32024,97345,574,134,440,0.233,0.767
32025,97346,883,0,883,0.0,1.0
32026,97347,1878,0,1878,0.0,1.0
32027,97348,1625,0,1625,0.0,1.0
32028,97350,182,0,182,0.0,1.0
32029,97351,10307,8876,1431,0.861,0.139
32030,97352,5604,3100,2504,0.553,0.447
32031,97355,28613,19744,8869,0.69,0.31
32032,97357,253,0,253,0.0,1.0
32033,97358,2576,0,2576,0.0,1.0
32034,97360,2249,0,2249,0.0,1.0
32035,97361,11258,9291,1967,0.825,0.175
32036,97362,4338,3390,948,0.781,0.219
32037,97364,446,446,0,1.0,0.0
32038,97365,10744,9792,952,0.911,0.089
32039,97366,1460,1271,189,0.871,0.129
32040,97367,9416,8503,913,0.903,0.097
32041,97368,3435,162,3273,0.047,0.953
32042,97369,193,0,193,0.0,1.0
32043,97370,8271,5072,3199,0.613,0.387
32044,97371,730,0,730,0.0,1.0
32045,97373,178,178,0,1.0,0.0
32046,97374,5266,0,5266,0.0,1.0
32047,97375,1252,0,1252,0.0,1.0
32048,97376,1301,178,1123,0.137,0.863
32049,97377,917,0,917,0.0,1.0
32050,97378,8882,6481,2401,0.73,0.27
32051,97380,2449,0,2449,0.0,1.0
32052,97381,14711,9614,5097,0.654,0.346
32053,97383,9587,7610,1977,0.794,0.206
32054,97384,23,0,23,0.0,1.0
32055,97385,3257,2681,576,0.823,0.177
32056,97386,13567,9435,4132,0.695,0.305
32057,97388,888,611,277,0.688,0.312
32058,97389,1676,1295,381,0.773,0.227
32059,97390,555,0,555,0.0,1.0
32060,97391,5344,3582,1762,0.67,0.33
32061,97392,5191,1768,3423,0.341,0.659
32062,97394,4643,3124,1519,0.673,0.327
32063,97396,3154,1987,1167,0.63,0.37
32064,97401,40521,40521,0,1.0,0.0
32065,97402,50342,46475,3867,0.923,0.077
32066,97403,11622,11610,12,0.999,0.001
32067,97404,32255,32205,50,0.998,0.002
32068,97405,44645,39674,4971,0.889,0.111
32069,97406,105,0,105,0.0,1.0
32070,97408,11711,10345,1366,0.883,0.117
32071,97410,759,0,759,0.0,1.0
32072,97411,6953,3119,3834,0.449,0.551
32073,97412,521,0,521,0.0,1.0
32074,97413,915,0,915,0.0,1.0
32075,97414,273,0,273,0.0,1.0
32076,97415,14051,10915,3136,0.777,0.223
32077,97416,937,0,937,0.0,1.0
32078,97417,2439,0,2439,0.0,1.0
32079,97419,1066,0,1066,0.0,1.0
32080,97420,27473,21355,6118,0.777,0.223
32081,97423,6809,4359,2450,0.64,0.36
32082,97424,17594,11007,6587,0.626,0.374
32083,97426,9716,6320,3396,0.65,0.35
32084,97429,684,0,684,0.0,1.0
32085,97430,385,0,385,0.0,1.0
32086,97431,2335,0,2335,0.0,1.0
32087,97434,928,0,928,0.0,1.0
32088,97435,2349,0,2349,0.0,1.0
32089,97436,841,0,841,0.0,1.0
32090,97437,2572,331,2241,0.129,0.871
32091,97438,1191,0,1191,0.0,1.0
32092,97439,14343,10177,4166,0.71,0.29
32093,97441,260,212,48,0.815,0.185
32094,97442,2232,0,2232,0.0,1.0
32095,97443,2232,0,2232,0.0,1.0
32096,97444,5181,2787,2394,0.538,0.462
32097,97446,4812,3637,1175,0.756,0.244
32098,97447,794,0,794,0.0,1.0
32099,97448,12244,5982,6262,0.489,0.511
32100,97449,1959,0,1959,0.0,1.0
32101,97450,671,0,671,0.0,1.0
32102,97451,387,0,387,0.0,1.0
32103,97452,1420,0,1420,0.0,1.0
32104,97453,897,0,897,0.0,1.0
32105,97454,1337,0,1337,0.0,1.0
32106,97455,2538,0,2538,0.0,1.0
32107,97456,2985,0,2985,0.0,1.0
32108,97457,10208,7291,2917,0.714,0.286
32109,97458,4733,0,4733,0.0,1.0
32110,97459,14096,10031,4065,0.712,0.288
32111,97461,683,0,683,0.0,1.0
32112,97462,3938,1222,2716,0.31,0.69
32113,97463,3877,3214,663,0.829,0.171
32114,97465,2145,0,2145,0.0,1.0
32115,97466,816,0,816,0.0,1.0
32116,97467,5339,4275,1064,0.801,0.199
32117,97469,2596,1201,1395,0.463,0.537
32118,97470,19985,16307,3678,0.816,0.184
32119,97471,29100,18658,10442,0.641,0.359
32120,97473,328,0,328,0.0,1.0
32121,97476,217,0,217,0.0,1.0
32122,97477,36874,36422,452,0.988,0.012
32123,97478,37011,30153,6858,0.815,0.185
32124,97479,9505,7431,2074,0.782,0.218
32125,97480,379,0,379,0.0,1.0
32126,97481,679,0,679,0.0,1.0
32127,97484,235,0,235,0.0,1.0
32128,97486,714,0,714,0.0,1.0
32129,97487,8449,5648,2801,0.668,0.332
32130,97488,1011,0,1011,0.0,1.0
32131,97489,868,0,868,0.0,1.0
32132,97490,326,0,326,0.0,1.0
32133,97492,597,0,597,0.0,1.0
32134,97493,323,0,323,0.0,1.0
32135,97494,49,6,43,0.122,0.878
32136,97495,1450,1299,151,0.896,0.104
32137,97496,7634,5430,2204,0.711,0.289
32138,97497,1523,0,1523,0.0,1.0
32139,97498,1814,257,1557,0.142,0.858
32140,97499,1957,0,1957,0.0,1.0
32141,97501,42117,38509,3608,0.914,0.086
32142,97502,27694,21134,6560,0.763,0.237
32143,97503,10528,8467,2061,0.804,0.196
32144,97504,44444,43028,1416,0.968,0.032
32145,97520,24469,20995,3474,0.858,0.142
32146,97522,658,0,658,0.0,1.0
32147,97523,6264,0,6264,0.0,1.0
32148,97524,14459,8526,5933,0.59,0.41
32149,97525,4601,1978,2623,0.43,0.57
32150,97526,34205,23144,11061,0.677,0.323
32151,97527,33713,22255,11458,0.66,0.34
32152,97530,6916,2527,4389,0.365,0.635
32153,97531,522,0,522,0.0,1.0
32154,97532,2378,583,1795,0.245,0.755
32155,97534,756,0,756,0.0,1.0
32156,97535,5047,4898,149,0.97,0.03
32157,97536,965,0,965,0.0,1.0
32158,97537,6918,2275,4643,0.329,0.671
32159,97538,2063,0,2063,0.0,1.0
32160,97539,3329,3033,296,0.911,0.089
32161,97540,7930,6282,1648,0.792,0.208
32162,97541,1478,346,1132,0.234,0.766
32163,97543,736,0,736,0.0,1.0
32164,97544,2206,0,2206,0.0,1.0
32165,97601,22459,17973,4486,0.8,0.2
32166,97603,29525,23461,6064,0.795,0.205
32167,97604,28,0,28,0.0,1.0
32168,97620,111,0,111,0.0,1.0
32169,97621,320,0,320,0.0,1.0
32170,97622,558,0,558,0.0,1.0
32171,97623,2310,0,2310,0.0,1.0
32172,97624,3500,0,3500,0.0,1.0
32173,97625,199,0,199,0.0,1.0
32174,97626,88,0,88,0.0,1.0
32175,97627,780,0,780,0.0,1.0
32176,97630,5096,2895,2201,0.568,0.432
32177,97632,1466,0,1466,0.0,1.0
32178,97633,1361,0,1361,0.0,1.0
32179,97634,212,0,212,0.0,1.0
32180,97635,289,0,289,0.0,1.0
32181,97636,387,0,387,0.0,1.0
32182,97637,76,0,76,0.0,1.0
32183,97638,507,0,507,0.0,1.0
32184,97639,570,0,570,0.0,1.0
32185,97640,99,0,99,0.0,1.0
32186,97641,1313,0,1313,0.0,1.0
32187,97701,58993,46636,12357,0.791,0.209
32188,97702,40583,37158,3425,0.916,0.084
32189,97707,5814,0,5814,0.0,1.0
32190,97710,120,0,120,0.0,1.0
32191,97711,61,0,61,0.0,1.0
32192,97712,38,0,38,0.0,1.0
32193,97720,4530,2481,2049,0.548,0.452
32194,97721,271,0,271,0.0,1.0
32195,97722,91,0,91,0.0,1.0
32196,97730,252,0,252,0.0,1.0
32197,97731,278,0,278,0.0,1.0
32198,97732,139,0,139,0.0,1.0
32199,97733,770,0,770,0.0,1.0
32200,97734,2786,0,2786,0.0,1.0
32201,97735,165,0,165,0.0,1.0
32202,97736,73,0,73,0.0,1.0
32203,97737,496,0,496,0.0,1.0
32204,97738,1941,1650,291,0.85,0.15
32205,97739,11018,2651,8367,0.241,0.759
32206,97741,11912,8010,3902,0.672,0.328
32207,97750,386,0,386,0.0,1.0
32208,97751,129,0,129,0.0,1.0
32209,97752,44,0,44,0.0,1.0
32210,97753,2016,0,2016,0.0,1.0
32211,97754,18574,10905,7669,0.587,0.413
32212,97756,33554,26313,7241,0.784,0.216
32213,97758,101,0,101,0.0,1.0
32214,97759,6294,0,6294,0.0,1.0
32215,97760,6757,1372,5385,0.203,0.797
32216,97761,3987,0,3987,0.0,1.0
32217,97801,21521,17216,4305,0.8,0.2
32218,97810,815,0,815,0.0,1.0
32219,97812,851,0,851,0.0,1.0
32220,97813,1302,0,1302,0.0,1.0
32221,97814,12382,9518,2864,0.769,0.231
32222,97817,38,0,38,0.0,1.0
32223,97818,4159,3362,797,0.808,0.192
32224,97819,29,0,29,0.0,1.0
32225,97820,1095,0,1095,0.0,1.0
32226,97823,948,0,948,0.0,1.0
32227,97824,1661,0,1661,0.0,1.0
32228,97825,244,0,244,0.0,1.0
32229,97826,1085,0,1085,0.0,1.0
32230,97827,2628,0,2628,0.0,1.0
32231,97828,3124,0,3124,0.0,1.0
32232,97830,748,0,748,0.0,1.0
32233,97833,895,0,895,0.0,1.0
32234,97834,986,0,986,0.0,1.0
32235,97835,361,0,361,0.0,1.0
32236,97836,1983,0,1983,0.0,1.0
32237,97837,95,0,95,0.0,1.0
32238,97838,25346,20207,5139,0.797,0.203
32239,97839,475,0,475,0.0,1.0
32240,97840,98,0,98,0.0,1.0
32241,97841,476,0,476,0.0,1.0
32242,97842,153,0,153,0.0,1.0
32243,97843,647,0,647,0.0,1.0
32244,97844,3806,2686,1120,0.706,0.294
32245,97845,2652,0,2652,0.0,1.0
32246,97846,1891,0,1891,0.0,1.0
32247,97848,195,0,195,0.0,1.0
32248,97850,16955,14909,2046,0.879,0.121
32249,97856,366,0,366,0.0,1.0
32250,97857,457,0,457,0.0,1.0
32251,97859,123,0,123,0.0,1.0
32252,97862,11666,8825,2841,0.756,0.244
32253,97864,262,0,262,0.0,1.0
32254,97865,1160,0,1160,0.0,1.0
32255,97867,763,0,763,0.0,1.0
32256,97868,1991,0,1991,0.0,1.0
32257,97869,1135,0,1135,0.0,1.0
32258,97870,573,0,573,0.0,1.0
32259,97873,228,0,228,0.0,1.0
32260,97874,349,0,349,0.0,1.0
32261,97875,2610,2041,569,0.782,0.218
32262,97876,837,0,837,0.0,1.0
32263,97877,283,0,283,0.0,1.0
32264,97880,272,0,272,0.0,1.0
32265,97882,7760,5542,2218,0.714,0.286
32266,97883,2473,0,2473,0.0,1.0
32267,97884,157,0,157,0.0,1.0
32268,97885,1383,0,1383,0.0,1.0
32269,97886,1140,0,1140,0.0,1.0
32270,97901,692,0,692,0.0,1.0
32271,97903,109,0,109,0.0,1.0
32272,97904,176,0,176,0.0,1.0
32273,97905,133,0,133,0.0,1.0
32274,97906,249,0,249,0.0,1.0
32275,97907,560,0,560,0.0,1.0
32276,97908,56,0,56,0.0,1.0
32277,97909,51,0,51,0.0,1.0
32278,97910,641,0,641,0.0,1.0
32279,97911,109,0,109,0.0,1.0
32280,97913,5531,3475,2056,0.628,0.372
32281,97914,19205,12677,6528,0.66,0.34
32282,97918,4537,0,4537,0.0,1.0
32283,97920,60,0,60,0.0,1.0
32284,98001,31911,31911,0,1.0,0.0
32285,98002,31647,31647,0,1.0,0.0
32286,98003,44151,44151,0,1.0,0.0
32287,98004,27946,27946,0,1.0,0.0
32288,98005,17714,17714,0,1.0,0.0
32289,98006,36364,36312,52,0.999,0.001
32290,98007,24889,24889,0,1.0,0.0
32291,98008,24411,24411,0,1.0,0.0
32292,98010,5025,4006,1019,0.797,0.203
32293,98011,29212,29212,0,1.0,0.0
32294,98012,51136,51136,0,1.0,0.0
32295,98014,6765,2763,4002,0.408,0.592
32296,98019,10725,6629,4096,0.618,0.382
32297,98020,18304,18304,0,1.0,0.0
32298,98021,26722,26722,0,1.0,0.0
32299,98022,20987,11814,9173,0.563,0.437
32300,98023,47510,47510,0,1.0,0.0
32301,98024,5650,3095,2555,0.548,0.452
32302,98026,35921,35921,0,1.0,0.0
32303,98027,26141,20951,5190,0.801,0.199
32304,98028,20419,20419,0,1.0,0.0
32305,98029,24348,23989,359,0.985,0.015
32306,98030,33769,33769,0,1.0,0.0
32307,98031,36581,36581,0,1.0,0.0
32308,98032,33853,33853,0,1.0,0.0
32309,98033,34338,34338,0,1.0,0.0
32310,98034,40407,40407,0,1.0,0.0
32311,98036,36000,36000,0,1.0,0.0
32312,98037,26889,26889,0,1.0,0.0
32313,98038,31171,26166,5005,0.839,0.161
32314,98039,2971,2971,0,1.0,0.0
32315,98040,22699,22699,0,1.0,0.0
32316,98042,43673,42763,910,0.979,0.021
32317,98043,19943,19943,0,1.0,0.0
32318,98045,13888,9117,4771,0.656,0.344
32319,98047,6339,6339,0,1.0,0.0
32320,98050,322,0,322,0.0,1.0
32321,98051,3270,416,2854,0.127,0.873
32322,98052,58442,58442,0,1.0,0.0
32323,98053,18784,17990,794,0.958,0.042
32324,98055,21904,21904,0,1.0,0.0
32325,98056,32489,32489,0,1.0,0.0
32326,98057,10613,10613,0,1.0,0.0
32327,98058,41938,40285,1653,0.961,0.039
32328,98059,34463,33878,585,0.983,0.017
32329,98065,12699,11306,1393,0.89,0.11
32330,98068,403,0,403,0.0,1.0
32331,98070,10624,0,10624,0.0,1.0
32332,98072,22312,21898,414,0.981,0.019
32333,98074,25748,25746,2,1.0,0.0
32334,98075,20715,20715,0,1.0,0.0
32335,98077,13585,12156,1429,0.895,0.105
32336,98087,29976,29976,0,1.0,0.0
32337,98092,39816,34173,5643,0.858,0.142
32338,98101,10238,10238,0,1.0,0.0
32339,98102,20756,20756,0,1.0,0.0
32340,98103,45911,45911,0,1.0,0.0
32341,98104,13095,13095,0,1.0,0.0
32342,98105,43924,43924,0,1.0,0.0
32343,98106,22873,22873,0,1.0,0.0
32344,98107,21147,21147,0,1.0,0.0
32345,98108,22374,22374,0,1.0,0.0
32346,98109,20715,20715,0,1.0,0.0
32347,98110,23025,20364,2661,0.884,0.116
32348,98112,21077,21077,0,1.0,0.0
32349,98115,46206,46206,0,1.0,0.0
32350,98116,22241,22241,0,1.0,0.0
32351,98117,31365,31365,0,1.0,0.0
32352,98118,42731,42731,0,1.0,0.0
32353,98119,21039,21039,0,1.0,0.0
32354,98121,12628,12628,0,1.0,0.0
32355,98122,31454,31454,0,1.0,0.0
32356,98125,37081,37081,0,1.0,0.0
32357,98126,20698,20698,0,1.0,0.0
32358,98133,44555,44555,0,1.0,0.0
32359,98134,644,644,0,1.0,0.0
32360,98136,14770,14770,0,1.0,0.0
32361,98144,26881,26881,0,1.0,0.0
32362,98146,25922,25922,0,1.0,0.0
32363,98148,10010,10010,0,1.0,0.0
32364,98154,0,0,0,,
32365,98155,32778,32778,0,1.0,0.0
32366,98158,0,0,0,,
32367,98164,141,141,0,1.0,0.0
32368,98166,20301,20301,0,1.0,0.0
32369,98168,33734,33734,0,1.0,0.0
32370,98174,0,0,0,,
32371,98177,19030,19030,0,1.0,0.0
32372,98178,24092,24092,0,1.0,0.0
32373,98188,23111,23111,0,1.0,0.0
32374,98195,0,0,0,,
32375,98198,34584,34584,0,1.0,0.0
32376,98199,19686,19686,0,1.0,0.0
32377,98201,29582,29541,41,0.999,0.001
32378,98203,34354,34354,0,1.0,0.0
32379,98204,39380,39380,0,1.0,0.0
32380,98205,12283,12083,200,0.984,0.016
32381,98207,758,758,0,1.0,0.0
32382,98208,51802,51757,45,0.999,0.001
32383,98220,634,0,634,0.0,1.0
32384,98221,20429,16712,3717,0.818,0.182
32385,98222,33,0,33,0.0,1.0
32386,98223,40815,20823,19992,0.51,0.49
32387,98224,294,0,294,0.0,1.0
32388,98225,46172,46088,84,0.998,0.002
32389,98226,41235,27839,13396,0.675,0.325
32390,98229,30321,27813,2508,0.917,0.083
32391,98230,15710,12737,2973,0.811,0.189
32392,98232,3920,0,3920,0.0,1.0
32393,98233,14871,12894,1977,0.867,0.133
32394,98235,103,103,0,1.0,0.0
32395,98236,5635,0,5635,0.0,1.0
32396,98237,4025,0,4025,0.0,1.0
32397,98238,85,0,85,0.0,1.0
32398,98239,6646,19,6627,0.003,0.997
32399,98240,3061,0,3061,0.0,1.0
32400,98241,2129,0,2129,0.0,1.0
32401,98243,507,0,507,0.0,1.0
32402,98244,3001,0,3001,0.0,1.0
32403,98245,3651,0,3651,0.0,1.0
32404,98247,9072,3880,5192,0.428,0.572
32405,98248,22361,12808,9553,0.573,0.427
32406,98249,4561,0,4561,0.0,1.0
32407,98250,7664,0,7664,0.0,1.0
32408,98251,4567,2940,1627,0.644,0.356
32409,98252,8777,5079,3698,0.579,0.421
32410,98253,1837,0,1837,0.0,1.0
32411,98255,245,0,245,0.0,1.0
32412,98256,420,0,420,0.0,1.0
32413,98257,4134,3297,837,0.798,0.202
32414,98258,30524,26248,4276,0.86,0.14
32415,98260,5278,0,5278,0.0,1.0
32416,98261,2383,0,2383,0.0,1.0
32417,98262,964,0,964,0.0,1.0
32418,98263,76,0,76,0.0,1.0
32419,98264,18893,14458,4435,0.765,0.235
32420,98266,3642,3025,617,0.831,0.169
32421,98267,534,0,534,0.0,1.0
32422,98270,45899,45727,172,0.996,0.004
32423,98271,27184,20872,6312,0.768,0.232
32424,98272,27942,19932,8010,0.713,0.287
32425,98273,28717,23721,4996,0.826,0.174
32426,98274,16613,12732,3881,0.766,0.234
32427,98275,20256,20256,0,1.0,0.0
32428,98276,450,450,0,1.0,0.0
32429,98277,37823,31921,5902,0.844,0.156
32430,98278,1065,1064,1,0.999,0.001
32431,98279,608,0,608,0.0,1.0
32432,98280,480,0,480,0.0,1.0
32433,98281,1314,0,1314,0.0,1.0
32434,98282,15661,8686,6975,0.555,0.445
32435,98283,434,0,434,0.0,1.0
32436,98284,24331,13516,10815,0.556,0.444
32437,98286,240,0,240,0.0,1.0
32438,98288,333,0,333,0.0,1.0
32439,98290,32714,17918,14796,0.548,0.452
32440,98292,20987,10706,10281,0.51,0.49
32441,98294,6595,5042,1553,0.765,0.235
32442,98295,2409,0,2409,0.0,1.0
32443,98296,27956,25204,2752,0.902,0.098
32444,98297,106,0,106,0.0,1.0
32445,98303,1037,0,1037,0.0,1.0
32446,98304,759,0,759,0.0,1.0
32447,98305,358,0,358,0.0,1.0
32448,98310,18703,18703,0,1.0,0.0
32449,98311,25880,25880,0,1.0,0.0
32450,98312,30203,23414,6789,0.775,0.225
32451,98314,3329,3329,0,1.0,0.0
32452,98315,6054,6053,1,1.0,0.0
32453,98320,1250,0,1250,0.0,1.0
32454,98321,15152,10860,4292,0.717,0.283
32455,98323,702,0,702,0.0,1.0
32456,98325,1848,371,1477,0.201,0.799
32457,98326,1412,0,1412,0.0,1.0
32458,98327,8267,8202,65,0.992,0.008
32459,98328,10433,2801,7632,0.268,0.732
32460,98329,10545,7337,3208,0.696,0.304
32461,98330,149,0,149,0.0,1.0
32462,98331,6261,3940,2321,0.629,0.371
32463,98332,15855,15620,235,0.985,0.015
32464,98333,3633,3633,0,1.0,0.0
32465,98335,24925,24925,0,1.0,0.0
32466,98336,970,0,970,0.0,1.0
32467,98337,6697,6697,0,1.0,0.0
32468,98338,24098,14286,9812,0.593,0.407
32469,98339,3326,2773,553,0.834,0.166
32470,98340,2537,0,2537,0.0,1.0
32471,98342,1370,1370,0,1.0,0.0
32472,98345,554,554,0,1.0,0.0
32473,98346,9297,5287,4010,0.569,0.431
32474,98349,4614,0,4614,0.0,1.0
32475,98350,460,0,460,0.0,1.0
32476,98351,1115,0,1115,0.0,1.0
32477,98353,4,0,4,0.0,1.0
32478,98354,6976,6976,0,1.0,0.0
32479,98355,628,0,628,0.0,1.0
32480,98356,2149,0,2149,0.0,1.0
32481,98357,1414,0,1414,0.0,1.0
32482,98358,897,0,897,0.0,1.0
32483,98359,4887,1175,3712,0.24,0.76
32484,98360,12221,9303,2918,0.761,0.239
32485,98361,1158,0,1158,0.0,1.0
32486,98362,22230,15570,6660,0.7,0.3
32487,98363,13343,7531,5812,0.564,0.436
32488,98364,45,0,45,0.0,1.0
32489,98365,4528,0,4528,0.0,1.0
32490,98366,34258,33224,1034,0.97,0.03
32491,98367,27693,17867,9826,0.645,0.355
32492,98368,14724,9561,5163,0.649,0.351
32493,98370,29528,23755,5773,0.804,0.196
32494,98371,20468,20468,0,1.0,0.0
32495,98372,22475,22475,0,1.0,0.0
32496,98373,22246,22246,0,1.0,0.0
32497,98374,37360,37148,212,0.994,0.006
32498,98375,26863,26863,0,1.0,0.0
32499,98376,1998,0,1998,0.0,1.0
32500,98377,1922,0,1922,0.0,1.0
32501,98380,4173,571,3602,0.137,0.863
32502,98381,371,0,371,0.0,1.0
32503,98382,26856,19048,7808,0.709,0.291
32504,98383,19727,17752,1975,0.9,0.1
32505,98385,459,429,30,0.935,0.065
32506,98387,43173,42265,908,0.979,0.021
32507,98388,7508,5985,1523,0.797,0.203
32508,98390,10461,10416,45,0.996,0.004
32509,98391,44309,42550,1759,0.96,0.04
32510,98392,2994,2951,43,0.986,0.014
32511,98394,1107,0,1107,0.0,1.0
32512,98396,662,0,662,0.0,1.0
32513,98402,6356,6356,0,1.0,0.0
32514,98403,7713,7713,0,1.0,0.0
32515,98404,32086,32086,0,1.0,0.0
32516,98405,22851,22851,0,1.0,0.0
32517,98406,21610,21610,0,1.0,0.0
32518,98407,19885,19885,0,1.0,0.0
32519,98408,18830,18830,0,1.0,0.0
32520,98409,22989,22989,0,1.0,0.0
32521,98416,1014,1014,0,1.0,0.0
32522,98418,10069,10069,0,1.0,0.0
32523,98421,1308,1308,0,1.0,0.0
32524,98422,20151,20151,0,1.0,0.0
32525,98424,10140,10140,0,1.0,0.0
32526,98430,13,13,0,1.0,0.0
32527,98433,14584,14292,292,0.98,0.02
32528,98438,366,366,0,1.0,0.0
32529,98439,4839,4839,0,1.0,0.0
32530,98443,5371,5371,0,1.0,0.0
32531,98444,33956,33956,0,1.0,0.0
32532,98445,29661,29661,0,1.0,0.0
32533,98446,10173,10173,0,1.0,0.0
32534,98447,842,842,0,1.0,0.0
32535,98465,6340,6340,0,1.0,0.0
32536,98466,26944,26944,0,1.0,0.0
32537,98467,14728,14728,0,1.0,0.0
32538,98498,27546,27546,0,1.0,0.0
32539,98499,29750,29750,0,1.0,0.0
32540,98501,38133,35678,2455,0.936,0.064
32541,98502,30491,24894,5597,0.816,0.184
32542,98503,36611,36611,0,1.0,0.0
32543,98506,18199,15170,3029,0.834,0.166
32544,98512,28130,18567,9563,0.66,0.34
32545,98513,31975,29064,2911,0.909,0.091
32546,98516,20166,16633,3533,0.825,0.175
32547,98520,23814,19067,4747,0.801,0.199
32548,98524,3232,0,3232,0.0,1.0
32549,98526,398,0,398,0.0,1.0
32550,98527,324,0,324,0.0,1.0
32551,98528,9983,3331,6652,0.334,0.666
32552,98530,565,0,565,0.0,1.0
32553,98531,24121,20143,3978,0.835,0.165
32554,98532,23596,10314,13282,0.437,0.563
32555,98533,609,0,609,0.0,1.0
32556,98535,445,0,445,0.0,1.0
32557,98536,211,0,211,0.0,1.0
32558,98537,2129,1597,532,0.75,0.25
32559,98538,304,0,304,0.0,1.0
32560,98541,10101,4032,6069,0.399,0.601
32561,98542,656,0,656,0.0,1.0
32562,98544,73,0,73,0.0,1.0
32563,98546,2909,0,2909,0.0,1.0
32564,98547,1436,0,1436,0.0,1.0
32565,98548,2193,0,2193,0.0,1.0
32566,98550,11382,8414,2968,0.739,0.261
32567,98552,508,0,508,0.0,1.0
32568,98555,599,0,599,0.0,1.0
32569,98557,3225,0,3225,0.0,1.0
32570,98558,192,192,0,1.0,0.0
32571,98559,93,0,93,0.0,1.0
32572,98560,142,0,142,0.0,1.0
32573,98562,195,0,195,0.0,1.0
32574,98563,8001,5144,2857,0.643,0.357
32575,98564,2459,0,2459,0.0,1.0
32576,98565,618,431,187,0.697,0.303
32577,98568,2519,0,2519,0.0,1.0
32578,98569,5784,5218,566,0.902,0.098
32579,98570,3889,0,3889,0.0,1.0
32580,98571,483,0,483,0.0,1.0
32581,98572,797,0,797,0.0,1.0
32582,98575,228,0,228,0.0,1.0
32583,98576,4667,0,4667,0.0,1.0
32584,98577,6338,2548,3790,0.402,0.598
32585,98579,12870,8483,4387,0.659,0.341
32586,98580,11099,1935,9164,0.174,0.826
32587,98581,424,0,424,0.0,1.0
32588,98582,611,0,611,0.0,1.0
32589,98583,124,124,0,1.0,0.0
32590,98584,36630,18705,17925,0.511,0.489
32591,98585,655,0,655,0.0,1.0
32592,98586,1944,1534,410,0.789,0.211
32593,98587,942,0,942,0.0,1.0
32594,98588,1829,0,1829,0.0,1.0
32595,98589,7320,146,7174,0.02,0.98
32596,98590,356,0,356,0.0,1.0
32597,98591,3952,0,3952,0.0,1.0
32598,98592,1764,0,1764,0.0,1.0
32599,98593,1113,0,1113,0.0,1.0
32600,98595,2917,0,2917,0.0,1.0
32601,98596,6524,0,6524,0.0,1.0
32602,98597,21557,12871,8686,0.597,0.403
32603,98601,2982,0,2982,0.0,1.0
32604,98602,200,0,200,0.0,1.0
32605,98603,1017,0,1017,0.0,1.0
32606,98604,34232,20773,13459,0.607,0.393
32607,98605,1225,712,513,0.581,0.419
32608,98606,9027,1104,7923,0.122,0.878
32609,98607,27899,24150,3749,0.866,0.134
32610,98610,2871,0,2871,0.0,1.0
32611,98611,9133,2315,6818,0.253,0.747
32612,98612,2704,0,2704,0.0,1.0
32613,98613,400,0,400,0.0,1.0
32614,98614,353,0,353,0.0,1.0
32615,98616,150,0,150,0.0,1.0
32616,98617,1042,789,253,0.757,0.243
32617,98619,457,0,457,0.0,1.0
32618,98620,7123,3329,3794,0.467,0.533
32619,98621,276,0,276,0.0,1.0
32620,98624,1532,0,1532,0.0,1.0
32621,98625,6133,3310,2823,0.54,0.46
32622,98626,24523,17384,7139,0.709,0.291
32623,98628,385,0,385,0.0,1.0
32624,98629,8364,2759,5605,0.33,0.67
32625,98631,3243,184,3059,0.057,0.943
32626,98632,49205,44413,4792,0.903,0.097
32627,98635,1735,0,1735,0.0,1.0
32628,98638,1525,0,1525,0.0,1.0
32629,98639,847,0,847,0.0,1.0
32630,98640,4380,3104,1276,0.709,0.291
32631,98641,5,0,5,0.0,1.0
32632,98642,15696,8618,7078,0.549,0.451
32633,98643,362,0,362,0.0,1.0
32634,98644,473,0,473,0.0,1.0
32635,98645,1429,0,1429,0.0,1.0
32636,98647,404,0,404,0.0,1.0
32637,98648,3100,0,3100,0.0,1.0
32638,98649,895,0,895,0.0,1.0
32639,98650,959,0,959,0.0,1.0
32640,98651,939,0,939,0.0,1.0
32641,98660,11858,11538,320,0.973,0.027
32642,98661,41740,41740,0,1.0,0.0
32643,98662,31644,31241,403,0.987,0.013
32644,98663,14115,14115,0,1.0,0.0
32645,98664,21771,21771,0,1.0,0.0
32646,98665,24057,24024,33,0.999,0.001
32647,98670,113,0,113,0.0,1.0
32648,98671,21220,14384,6836,0.678,0.322
32649,98672,6146,3254,2892,0.529,0.471
32650,98673,404,0,404,0.0,1.0
32651,98674,12029,5863,6166,0.487,0.513
32652,98675,6713,0,6713,0.0,1.0
32653,98682,52893,49964,2929,0.945,0.055
32654,98683,30832,30832,0,1.0,0.0
32655,98684,26968,26968,0,1.0,0.0
32656,98685,26217,26047,170,0.994,0.006
32657,98686,17385,16552,833,0.952,0.048
32658,98801,40977,38057,2920,0.929,0.071
32659,98802,28719,27030,1689,0.941,0.059
32660,98811,71,0,71,0.0,1.0
32661,98812,4899,0,4899,0.0,1.0
32662,98813,3176,0,3176,0.0,1.0
32663,98814,466,0,466,0.0,1.0
32664,98815,7233,4544,2689,0.628,0.372
32665,98816,6394,3389,3005,0.53,0.47
32666,98817,366,318,48,0.869,0.131
32667,98819,258,0,258,0.0,1.0
32668,98821,519,181,338,0.349,0.651
32669,98822,1953,0,1953,0.0,1.0
32670,98823,11055,6956,4099,0.629,0.371
32671,98824,181,0,181,0.0,1.0
32672,98826,6504,3282,3222,0.505,0.495
32673,98827,312,0,312,0.0,1.0
32674,98828,2146,958,1188,0.446,0.554
32675,98829,564,0,564,0.0,1.0
32676,98830,494,0,494,0.0,1.0
32677,98831,3708,1997,1711,0.539,0.461
32678,98832,320,0,320,0.0,1.0
32679,98833,150,0,150,0.0,1.0
32680,98834,239,0,239,0.0,1.0
32681,98836,584,2,582,0.003,0.997
32682,98837,39722,32978,6744,0.83,0.17
32683,98840,4851,2650,2201,0.546,0.454
32684,98841,9197,5579,3618,0.607,0.393
32685,98843,1817,0,1817,0.0,1.0
32686,98844,4740,0,4740,0.0,1.0
32687,98845,128,0,128,0.0,1.0
32688,98846,1173,0,1173,0.0,1.0
32689,98847,1920,0,1920,0.0,1.0
32690,98848,11518,6986,4532,0.607,0.393
32691,98849,1078,0,1078,0.0,1.0
32692,98850,1543,1180,363,0.765,0.235
32693,98851,4014,0,4014,0.0,1.0
32694,98852,104,0,104,0.0,1.0
32695,98853,23,0,23,0.0,1.0
32696,98855,5863,0,5863,0.0,1.0
32697,98856,2464,0,2464,0.0,1.0
32698,98857,4082,2679,1403,0.656,0.344
32699,98858,1521,0,1521,0.0,1.0
32700,98859,238,0,238,0.0,1.0
32701,98860,259,0,259,0.0,1.0
32702,98862,2218,0,2218,0.0,1.0
32703,98901,30169,25970,4199,0.861,0.139
32704,98902,46322,46322,0,1.0,0.0
32705,98903,14517,10656,3861,0.734,0.266
32706,98908,35240,28799,6441,0.817,0.183
32707,98921,516,516,0,1.0,0.0
32708,98922,5468,1824,3644,0.334,0.666
32709,98923,1434,0,1434,0.0,1.0
32710,98925,689,0,689,0.0,1.0
32711,98926,30239,20987,9252,0.694,0.306
32712,98929,0,0,0,,
32713,98930,15252,11551,3701,0.757,0.243
32714,98932,5032,3048,1984,0.606,0.394
32715,98933,1267,0,1267,0.0,1.0
32716,98934,1117,0,1117,0.0,1.0
32717,98935,4190,2534,1656,0.605,0.395
32718,98936,5872,3266,2606,0.556,0.444
32719,98937,4112,1712,2400,0.416,0.584
32720,98938,2177,292,1885,0.134,0.866
32721,98939,167,154,13,0.922,0.078
32722,98940,760,215,545,0.283,0.717
32723,98941,919,873,46,0.95,0.05
32724,98942,16973,12576,4397,0.741,0.259
32725,98943,660,627,33,0.95,0.05
32726,98944,22014,16981,5033,0.771,0.229
32727,98946,495,0,495,0.0,1.0
32728,98947,2902,0,2902,0.0,1.0
32729,98948,13225,10490,2735,0.793,0.207
32730,98950,177,0,177,0.0,1.0
32731,98951,13739,7686,6053,0.559,0.441
32732,98952,2330,0,2330,0.0,1.0
32733,98953,6681,3506,3175,0.525,0.475
32734,99001,6151,6109,42,0.993,0.007
32735,99003,4848,0,4848,0.0,1.0
32736,99004,18376,12443,5933,0.677,0.323
32737,99005,8574,4072,4502,0.475,0.525
32738,99006,11946,3463,8483,0.29,0.71
32739,99008,641,0,641,0.0,1.0
32740,99009,3947,0,3947,0.0,1.0
32741,99011,2776,2776,0,1.0,0.0
32742,99012,1064,0,1064,0.0,1.0
32743,99013,1785,0,1785,0.0,1.0
32744,99016,12480,11108,1372,0.89,0.11
32745,99017,161,0,161,0.0,1.0
32746,99018,282,0,282,0.0,1.0
32747,99019,9502,8486,1016,0.893,0.107
32748,99020,82,0,82,0.0,1.0
32749,99021,9174,6749,2425,0.736,0.264
32750,99022,8820,5107,3713,0.579,0.421
32751,99023,529,0,529,0.0,1.0
32752,99025,5232,2085,3147,0.399,0.601
32753,99026,9042,5048,3994,0.558,0.442
32754,99027,6101,4919,1182,0.806,0.194
32755,99029,1289,0,1289,0.0,1.0
32756,99030,1032,0,1032,0.0,1.0
32757,99031,1137,0,1137,0.0,1.0
32758,99032,691,0,691,0.0,1.0
32759,99033,895,0,895,0.0,1.0
32760,99034,209,0,209,0.0,1.0
32761,99036,1448,0,1448,0.0,1.0
32762,99037,12973,12878,95,0.993,0.007
32763,99039,87,0,87,0.0,1.0
32764,99040,734,0,734,0.0,1.0
32765,99101,1453,0,1453,0.0,1.0
32766,99102,500,0,500,0.0,1.0
32767,99103,497,0,497,0.0,1.0
32768,99105,61,0,61,0.0,1.0
32769,99109,5109,0,5109,0.0,1.0
32770,99110,1667,0,1667,0.0,1.0
32771,99111,4047,2720,1327,0.672,0.328
32772,99113,761,0,761,0.0,1.0
32773,99114,12018,4966,7052,0.413,0.587
32774,99115,1143,0,1143,0.0,1.0
32775,99116,1439,0,1439,0.0,1.0
32776,99117,485,0,485,0.0,1.0
32777,99118,931,0,931,0.0,1.0
32778,99119,1204,0,1204,0.0,1.0
32779,99121,145,0,145,0.0,1.0
32780,99122,3773,0,3773,0.0,1.0
32781,99123,1058,0,1058,0.0,1.0
32782,99124,240,0,240,0.0,1.0
32783,99125,527,0,527,0.0,1.0
32784,99126,877,0,877,0.0,1.0
32785,99128,321,0,321,0.0,1.0
32786,99129,793,0,793,0.0,1.0
32787,99130,828,0,828,0.0,1.0
32788,99131,170,0,170,0.0,1.0
32789,99133,1493,0,1493,0.0,1.0
32790,99134,643,0,643,0.0,1.0
32791,99135,255,0,255,0.0,1.0
32792,99136,29,0,29,0.0,1.0
32793,99137,343,0,343,0.0,1.0
32794,99138,1209,0,1209,0.0,1.0
32795,99139,1301,0,1301,0.0,1.0
32796,99140,475,0,475,0.0,1.0
32797,99141,5240,0,5240,0.0,1.0
32798,99143,650,0,650,0.0,1.0
32799,99144,43,0,43,0.0,1.0
32800,99146,56,0,56,0.0,1.0
32801,99147,190,0,190,0.0,1.0
32802,99148,2106,0,2106,0.0,1.0
32803,99149,208,0,208,0.0,1.0
32804,99150,380,0,380,0.0,1.0
32805,99151,164,0,164,0.0,1.0
32806,99152,197,0,197,0.0,1.0
32807,99153,467,0,467,0.0,1.0
32808,99154,20,0,20,0.0,1.0
32809,99155,1350,0,1350,0.0,1.0
32810,99156,8114,2196,5918,0.271,0.729
32811,99157,697,0,697,0.0,1.0
32812,99158,603,0,603,0.0,1.0
32813,99159,1375,0,1375,0.0,1.0
32814,99160,149,0,149,0.0,1.0
32815,99161,1400,0,1400,0.0,1.0
32816,99163,31404,29729,1675,0.947,0.053
32817,99164,0,0,0,,
32818,99166,3222,0,3222,0.0,1.0
32819,99167,625,0,625,0.0,1.0
32820,99169,2459,0,2459,0.0,1.0
32821,99170,1072,0,1072,0.0,1.0
32822,99171,959,0,959,0.0,1.0
32823,99173,1532,0,1532,0.0,1.0
32824,99174,44,0,44,0.0,1.0
32825,99176,145,0,145,0.0,1.0
32826,99179,437,0,437,0.0,1.0
32827,99180,939,0,939,0.0,1.0
32828,99181,1901,0,1901,0.0,1.0
32829,99185,1295,0,1295,0.0,1.0
32830,99201,13342,13342,0,1.0,0.0
32831,99202,21580,21580,0,1.0,0.0
32832,99203,20192,20192,0,1.0,0.0
32833,99204,6681,6681,0,1.0,0.0
32834,99205,42137,42137,0,1.0,0.0
32835,99206,34802,34009,793,0.977,0.023
32836,99207,30854,30854,0,1.0,0.0
32837,99208,49193,47374,1819,0.963,0.037
32838,99212,19197,19084,113,0.994,0.006
32839,99216,24362,24022,340,0.986,0.014
32840,99217,17423,14026,3397,0.805,0.195
32841,99218,15531,15514,17,0.999,0.001
32842,99223,29273,26399,2874,0.902,0.098
32843,99224,18289,10426,7863,0.57,0.43
32844,99301,68191,63665,4526,0.934,0.066
32845,99320,9201,4301,4900,0.467,0.533
32846,99321,531,0,531,0.0,1.0
32847,99322,217,0,217,0.0,1.0
32848,99323,3684,1735,1949,0.471,0.529
32849,99324,9202,9185,17,0.998,0.002
32850,99326,4956,4076,880,0.822,0.178
32851,99328,3733,2681,1052,0.718,0.282
32852,99329,160,0,160,0.0,1.0
32853,99330,907,0,907,0.0,1.0
32854,99333,50,0,50,0.0,1.0
32855,99335,340,0,340,0.0,1.0
32856,99336,48753,48750,3,1.0,0.0
32857,99337,29845,27077,2768,0.907,0.093
32858,99338,11555,9768,1787,0.845,0.155
32859,99341,884,0,884,0.0,1.0
32860,99343,3040,0,3040,0.0,1.0
32861,99344,16817,11207,5610,0.666,0.334
32862,99345,213,0,213,0.0,1.0
32863,99346,352,0,352,0.0,1.0
32864,99347,2293,0,2293,0.0,1.0
32865,99348,1364,0,1364,0.0,1.0
32866,99349,8483,4988,3495,0.588,0.412
32867,99350,12979,6910,6069,0.532,0.468
32868,99352,26975,26400,575,0.979,0.021
32869,99353,13306,12086,1220,0.908,0.092
32870,99354,21343,21333,10,1.0,0.0
32871,99356,294,0,294,0.0,1.0
32872,99357,4323,0,4323,0.0,1.0
32873,99359,158,0,158,0.0,1.0
32874,99360,1350,0,1350,0.0,1.0
32875,99361,1902,0,1902,0.0,1.0
32876,99362,41056,37795,3261,0.921,0.079
32877,99363,216,0,216,0.0,1.0
32878,99371,311,0,311,0.0,1.0
32879,99401,273,0,273,0.0,1.0
32880,99402,1875,1328,547,0.708,0.292
32881,99403,19548,18856,692,0.965,0.035
32882,99501,17603,17603,0,1.0,0.0
32883,99502,24168,24143,25,0.999,0.001
32884,99503,14563,14553,10,0.999,0.001
32885,99504,40914,40914,0,1.0,0.0
32886,99505,6174,5927,247,0.96,0.04
32887,99506,7749,7094,655,0.915,0.085
32888,99507,37850,37437,413,0.989,0.011
32889,99508,35857,35857,0,1.0,0.0
32890,99510,353,0,353,0.0,1.0
32891,99513,0,0,0,,
32892,99515,22441,22284,157,0.993,0.007
32893,99516,20095,18561,1534,0.924,0.076
32894,99517,16645,16645,0,1.0,0.0
32895,99518,10225,10225,0,1.0,0.0
32896,99519,1316,0,1316,0.0,1.0
32897,99540,320,0,320,0.0,1.0
32898,99546,326,0,326,0.0,1.0
32899,99547,61,0,61,0.0,1.0
32900,99548,73,0,73,0.0,1.0
32901,99549,102,0,102,0.0,1.0
32902,99550,197,0,197,0.0,1.0
32903,99551,627,0,627,0.0,1.0
32904,99552,346,0,346,0.0,1.0
32905,99553,1027,0,1027,0.0,1.0
32906,99554,677,0,677,0.0,1.0
32907,99555,221,0,221,0.0,1.0
32908,99556,2510,0,2510,0.0,1.0
32909,99557,726,0,726,0.0,1.0
32910,99558,85,0,85,0.0,1.0
32911,99559,7632,4434,3198,0.581,0.419
32912,99561,418,0,418,0.0,1.0
32913,99563,938,0,938,0.0,1.0
32914,99564,91,0,91,0.0,1.0
32915,99565,78,0,78,0.0,1.0
32916,99566,192,0,192,0.0,1.0
32917,99567,9211,7087,2124,0.769,0.231
32918,99568,279,0,279,0.0,1.0
32919,99569,64,0,64,0.0,1.0
32920,99571,160,0,160,0.0,1.0
32921,99572,296,0,296,0.0,1.0
32922,99573,1115,0,1115,0.0,1.0
32923,99574,2348,0,2348,0.0,1.0
32924,99575,105,0,105,0.0,1.0
32925,99576,2603,0,2603,0.0,1.0
32926,99577,25771,21481,4290,0.834,0.166
32927,99578,296,0,296,0.0,1.0
32928,99579,109,0,109,0.0,1.0
32929,99580,115,0,115,0.0,1.0
32930,99581,762,0,762,0.0,1.0
32931,99583,35,0,35,0.0,1.0
32932,99585,417,0,417,0.0,1.0
32933,99586,605,0,605,0.0,1.0
32934,99587,2250,0,2250,0.0,1.0
32935,99588,980,0,980,0.0,1.0
32936,99589,243,0,243,0.0,1.0
32937,99590,194,0,194,0.0,1.0
32938,99591,102,0,102,0.0,1.0
32939,99602,178,0,178,0.0,1.0
32940,99603,9840,0,9840,0.0,1.0
32941,99604,1093,0,1093,0.0,1.0
32942,99605,211,0,211,0.0,1.0
32943,99606,469,0,469,0.0,1.0
32944,99607,216,0,216,0.0,1.0
32945,99609,569,0,569,0.0,1.0
32946,99610,2167,0,2167,0.0,1.0
32947,99611,15122,4921,10201,0.325,0.675
32948,99612,938,0,938,0.0,1.0
32949,99613,434,0,434,0.0,1.0
32950,99614,639,0,639,0.0,1.0
32951,99615,12899,9335,3564,0.724,0.276
32952,99620,577,0,577,0.0,1.0
32953,99621,723,0,723,0.0,1.0
32954,99622,321,0,321,0.0,1.0
32955,99624,90,0,90,0.0,1.0
32956,99625,72,0,72,0.0,1.0
32957,99626,282,0,282,0.0,1.0
32958,99627,406,0,406,0.0,1.0
32959,99628,443,0,443,0.0,1.0
32960,99630,191,0,191,0.0,1.0
32961,99631,228,0,228,0.0,1.0
32962,99632,813,0,813,0.0,1.0
32963,99633,544,0,544,0.0,1.0
32964,99634,354,0,354,0.0,1.0
32965,99636,510,0,510,0.0,1.0
32966,99637,590,0,590,0.0,1.0
32967,99638,18,0,18,0.0,1.0
32968,99639,1131,0,1131,0.0,1.0
32969,99640,174,0,174,0.0,1.0
32970,99641,496,0,496,0.0,1.0
32971,99643,218,0,218,0.0,1.0
32972,99644,175,0,175,0.0,1.0
32973,99645,25176,13036,12140,0.518,0.482
32974,99647,44,0,44,0.0,1.0
32975,99648,113,0,113,0.0,1.0
32976,99649,80,0,80,0.0,1.0
32977,99650,568,0,568,0.0,1.0
32978,99651,61,0,61,0.0,1.0
32979,99652,3703,0,3703,0.0,1.0
32980,99653,159,0,159,0.0,1.0
32981,99654,52168,31200,20968,0.598,0.402
32982,99655,669,0,669,0.0,1.0
32983,99656,25,0,25,0.0,1.0
32984,99657,329,0,329,0.0,1.0
32985,99658,616,0,616,0.0,1.0
32986,99659,401,0,401,0.0,1.0
32987,99660,479,0,479,0.0,1.0
32988,99661,978,0,978,0.0,1.0
32989,99662,480,0,480,0.0,1.0
32990,99663,414,0,414,0.0,1.0
32991,99664,4932,0,4932,0.0,1.0
32992,99665,83,0,83,0.0,1.0
32993,99666,189,0,189,0.0,1.0
32994,99667,65,0,65,0.0,1.0
32995,99668,86,0,86,0.0,1.0
32996,99669,14191,6526,7665,0.46,0.54
32997,99670,79,0,79,0.0,1.0
32998,99671,556,0,556,0.0,1.0
32999,99672,3704,0,3704,0.0,1.0
33000,99674,1444,0,1444,0.0,1.0
33001,99676,1546,0,1546,0.0,1.0
33002,99677,88,0,88,0.0,1.0
33003,99678,891,0,891,0.0,1.0
33004,99679,373,0,373,0.0,1.0
33005,99680,408,0,408,0.0,1.0
33006,99681,325,0,325,0.0,1.0
33007,99682,373,0,373,0.0,1.0
33008,99683,524,0,524,0.0,1.0
33009,99684,688,0,688,0.0,1.0
33010,99685,4224,0,4224,0.0,1.0
33011,99686,4005,0,4005,0.0,1.0
33012,99688,2759,0,2759,0.0,1.0
33013,99689,662,0,662,0.0,1.0
33014,99690,280,0,280,0.0,1.0
33015,99691,95,0,95,0.0,1.0
33016,99692,152,0,152,0.0,1.0
33017,99693,248,0,248,0.0,1.0
33018,99694,1512,0,1512,0.0,1.0
33019,99695,7,0,7,0.0,1.0
33020,99701,19019,18834,185,0.99,0.01
33021,99702,2647,2305,342,0.871,0.129
33022,99703,7065,7065,0,1.0,0.0
33023,99704,24,0,24,0.0,1.0
33024,99705,22544,17564,4980,0.779,0.221
33025,99706,13,0,13,0.0,1.0
33026,99709,29830,16642,13188,0.558,0.442
33027,99712,13866,3796,10070,0.274,0.726
33028,99714,1385,0,1385,0.0,1.0
33029,99720,208,0,208,0.0,1.0
33030,99721,324,0,324,0.0,1.0
33031,99722,152,0,152,0.0,1.0
33032,99723,4213,3835,378,0.91,0.09
33033,99724,84,0,84,0.0,1.0
33034,99726,30,0,30,0.0,1.0
33035,99727,416,0,416,0.0,1.0
33036,99729,231,0,231,0.0,1.0
33037,99730,144,0,144,0.0,1.0
33038,99732,10,0,10,0.0,1.0
33039,99733,104,0,104,0.0,1.0
33040,99734,845,0,845,0.0,1.0
33041,99736,122,0,122,0.0,1.0
33042,99737,5011,0,5011,0.0,1.0
33043,99738,187,0,187,0.0,1.0
33044,99739,330,0,330,0.0,1.0
33045,99740,585,0,585,0.0,1.0
33046,99741,470,0,470,0.0,1.0
33047,99742,681,0,681,0.0,1.0
33048,99743,1069,0,1069,0.0,1.0
33049,99744,226,0,226,0.0,1.0
33050,99745,78,0,78,0.0,1.0
33051,99746,277,0,277,0.0,1.0
33052,99747,239,0,239,0.0,1.0
33053,99748,190,0,190,0.0,1.0
33054,99749,363,0,363,0.0,1.0
33055,99750,374,0,374,0.0,1.0
33056,99751,151,0,151,0.0,1.0
33057,99752,3553,3200,353,0.901,0.099
33058,99753,332,0,332,0.0,1.0
33059,99754,96,0,96,0.0,1.0
33060,99755,217,0,217,0.0,1.0
33061,99756,119,0,119,0.0,1.0
33062,99757,17,0,17,0.0,1.0
33063,99758,210,0,210,0.0,1.0
33064,99759,189,0,189,0.0,1.0
33065,99760,785,0,785,0.0,1.0
33066,99761,514,0,514,0.0,1.0
33067,99762,4038,3222,816,0.798,0.202
33068,99763,668,0,668,0.0,1.0
33069,99764,290,0,290,0.0,1.0
33070,99765,264,0,264,0.0,1.0
33071,99766,678,0,678,0.0,1.0
33072,99767,24,0,24,0.0,1.0
33073,99768,175,0,175,0.0,1.0
33074,99769,671,0,671,0.0,1.0
33075,99770,841,0,841,0.0,1.0
33076,99771,251,0,251,0.0,1.0
33077,99772,567,0,567,0.0,1.0
33078,99773,262,0,262,0.0,1.0
33079,99774,78,0,78,0.0,1.0
33080,99775,1251,1251,0,1.0,0.0
33081,99776,124,0,124,0.0,1.0
33082,99777,246,0,246,0.0,1.0
33083,99778,254,0,254,0.0,1.0
33084,99780,1535,0,1535,0.0,1.0
33085,99781,167,0,167,0.0,1.0
33086,99782,556,0,556,0.0,1.0
33087,99783,145,0,145,0.0,1.0
33088,99784,190,0,190,0.0,1.0
33089,99785,388,0,388,0.0,1.0
33090,99786,259,0,259,0.0,1.0
33091,99788,69,0,69,0.0,1.0
33092,99789,402,0,402,0.0,1.0
33093,99790,20,0,20,0.0,1.0
33094,99791,237,0,237,0.0,1.0
33095,99801,29164,22591,6573,0.775,0.225
33096,99820,479,0,479,0.0,1.0
33097,99824,2111,1946,165,0.922,0.078
33098,99825,120,0,120,0.0,1.0
33099,99826,442,0,442,0.0,1.0
33100,99827,2602,0,2602,0.0,1.0
33101,99829,777,0,777,0.0,1.0
33102,99830,561,0,561,0.0,1.0
33103,99832,104,0,104,0.0,1.0
33104,99833,3202,0,3202,0.0,1.0
33105,99835,8880,7027,1853,0.791,0.209
33106,99836,52,0,52,0.0,1.0
33107,99840,968,0,968,0.0,1.0
33108,99841,133,0,133,0.0,1.0
33109,99901,13508,10352,3156,0.766,0.234
33110,99903,31,0,31,0.0,1.0
33111,99918,231,0,231,0.0,1.0
33112,99919,531,0,531,0.0,1.0
33113,99921,1920,0,1920,0.0,1.0
33114,99922,384,0,384,0.0,1.0
33115,99923,87,0,87,0.0,1.0
33116,99925,819,0,819,0.0,1.0
33117,99926,1460,0,1460,0.0,1.0
33118,99927,94,0,94,0.0,1.0
33119,99929,2338,0,2338,0.0,1.0
